ID,Флаг дозвона,Флаг продажи,Расходы,PV,NPV
0,1,0,104,0,-104
1,0,0,7,0,-7
2,1,0,9,0,-9
3,1,0,44,0,-44
4,1,1,1546,1698,152
5,0,0,29,0,-29
6,0,0,191,0,-191
7,1,1,400,1413,1013
8,1,0,10,0,-10
9,1,0,38,0,-38
10,1,1,293,1768,1475
11,0,0,90,0,-90
12,0,0,34,0,-34
13,0,0,58,0,-58
14,1,1,219,1519,1300
15,0,0,114,0,-114
16,1,1,715,1378,663
17,1,1,163,1639,1476
18,0,0,21,0,-21
19,0,0,189,0,-189
20,1,1,573,1425,852
21,0,0,14,0,-14
22,1,1,1016,1307,291
23,1,1,525,1310,785
24,0,0,61,0,-61
25,1,1,1577,1774,197
26,0,0,68,0,-68
27,1,1,65,1396,1331
28,0,0,27,0,-27
29,1,0,43,0,-43
30,0,0,16,0,-16
31,1,1,1607,1421,-186
32,0,0,102,0,-102
33,0,0,20,0,-20
34,1,1,1059,1723,664
35,1,0,115,0,-115
36,0,0,45,0,-45
37,1,1,810,1784,974
38,1,1,33,1342,1309
39,1,0,84,0,-84
40,0,0,8,0,-8
41,0,0,68,0,-68
42,1,1,1062,1835,773
43,1,0,3,0,-3
44,1,1,110,1251,1141
45,0,0,4,0,-4
46,1,1,182,1805,1623
47,1,0,15,0,-15
48,0,0,0,0,0
49,1,1,1033,1268,235
50,0,0,145,0,-145
51,1,0,88,0,-88
52,0,0,84,0,-84
53,0,0,64,0,-64
54,1,0,13,0,-13
55,1,1,79,1820,1741
56,1,0,13,0,-13
57,1,0,31,0,-31
58,0,0,37,0,-37
59,0,0,20,0,-20
60,0,0,19,0,-19
61,0,0,22,0,-22
62,0,0,71,0,-71
63,0,0,242,0,-242
64,1,0,94,0,-94
65,0,0,44,0,-44
66,0,0,11,0,-11
67,0,0,72,0,-72
68,1,1,229,1587,1358
69,0,0,11,0,-11
70,1,0,19,0,-19
71,0,0,150,0,-150
72,0,0,30,0,-30
73,1,0,35,0,-35
74,0,0,30,0,-30
75,0,0,115,0,-115
76,0,0,20,0,-20
77,1,0,34,0,-34
78,1,0,12,0,-12
79,1,0,19,0,-19
80,0,0,25,0,-25
81,0,0,83,0,-83
82,0,0,144,0,-144
83,1,1,510,1392,882
84,1,1,39,1339,1300
85,1,1,368,1299,931
86,1,0,98,0,-98
87,0,0,57,0,-57
88,1,0,26,0,-26
89,1,0,1,0,-1
90,1,0,115,0,-115
91,1,0,23,0,-23
92,1,1,60,1585,1525
93,1,0,103,0,-103
94,0,0,136,0,-136
95,1,0,1,0,-1
96,1,1,85,2314,2229
97,1,0,60,0,-60
98,1,0,12,0,-12
99,1,1,1537,1596,59
100,1,1,662,1263,601
101,0,0,12,0,-12
102,1,0,39,0,-39
103,1,1,1090,1705,615
104,1,0,1,0,-1
105,1,0,41,0,-41
106,1,0,6,0,-6
107,1,0,10,0,-10
108,0,0,105,0,-105
109,0,0,15,0,-15
110,1,0,50,0,-50
111,0,0,32,0,-32
112,1,0,5,0,-5
113,0,0,26,0,-26
114,0,0,1,0,-1
115,1,0,178,0,-178
116,0,0,14,0,-14
117,1,0,4,0,-4
118,1,1,124,1656,1532
119,1,1,170,1546,1376
120,0,0,81,0,-81
121,1,1,518,2442,1924
122,1,1,106,4611,4505
123,1,1,1134,1927,793
124,0,0,3,0,-3
125,1,1,698,1289,591
126,1,1,132,1678,1546
127,1,0,128,0,-128
128,0,0,191,0,-191
129,1,0,49,0,-49
130,0,0,16,0,-16
131,1,0,115,0,-115
132,0,0,6,0,-6
133,0,0,48,0,-48
134,0,0,44,0,-44
135,0,0,167,0,-167
136,1,1,582,1683,1101
137,1,1,212,1596,1384
138,0,0,84,0,-84
139,1,0,63,0,-63
140,0,0,84,0,-84
141,1,1,235,1716,1481
142,1,1,282,1263,981
143,1,1,248,1548,1300
144,1,0,57,0,-57
145,0,0,15,0,-15
146,1,1,324,1372,1048
147,1,1,232,1943,1711
148,0,0,122,0,-122
149,1,1,71,1500,1429
150,0,0,28,0,-28
151,1,1,183,2049,1866
152,1,0,97,0,-97
153,1,1,470,1381,911
154,1,1,180,1354,1174
155,1,0,78,0,-78
156,0,0,6,0,-6
157,1,1,709,1938,1229
158,1,1,43,1358,1315
159,0,0,32,0,-32
160,1,1,119,1521,1402
161,1,0,31,0,-31
162,0,0,76,0,-76
163,0,0,38,0,-38
164,0,0,67,0,-67
165,1,0,70,0,-70
166,0,0,95,0,-95
167,1,0,10,0,-10
168,1,0,92,0,-92
169,1,1,193,1845,1652
170,0,0,26,0,-26
171,1,1,846,2191,1345
172,0,0,3,0,-3
173,0,0,85,0,-85
174,0,0,76,0,-76
175,1,0,101,0,-101
176,1,0,77,0,-77
177,1,0,166,0,-166
178,1,1,871,1513,642
179,0,0,101,0,-101
180,1,0,83,0,-83
181,0,0,158,0,-158
182,1,0,7,0,-7
183,1,0,187,0,-187
184,1,1,926,1368,442
185,1,1,921,1680,759
186,0,0,25,0,-25
187,0,0,96,0,-96
188,1,0,35,0,-35
189,0,0,11,0,-11
190,1,0,160,0,-160
191,1,1,146,1437,1291
192,1,0,24,0,-24
193,0,0,27,0,-27
194,1,1,138,2292,2154
195,1,0,1,0,-1
196,0,0,84,0,-84
197,0,0,0,0,0
198,1,1,534,1435,901
199,1,0,56,0,-56
200,0,0,18,0,-18
201,1,0,48,0,-48
202,1,0,19,0,-19
203,1,1,40,1266,1226
204,0,0,113,0,-113
205,0,0,19,0,-19
206,0,0,35,0,-35
207,1,0,186,0,-186
208,1,1,928,1721,793
209,0,0,1,0,-1
210,1,0,37,0,-37
211,0,0,8,0,-8
212,0,0,42,0,-42
213,0,0,46,0,-46
214,0,0,15,0,-15
215,1,0,20,0,-20
216,1,1,129,1352,1223
217,1,1,326,1741,1415
218,1,1,1598,1508,-90
219,1,1,1033,1412,379
220,1,0,112,0,-112
221,0,0,99,0,-99
222,1,0,39,0,-39
223,1,0,78,0,-78
224,1,0,171,0,-171
225,0,0,10,0,-10
226,1,1,235,1284,1049
227,1,1,219,2027,1808
228,1,0,94,0,-94
229,0,0,143,0,-143
230,1,0,80,0,-80
231,1,0,63,0,-63
232,1,0,47,0,-47
233,1,1,252,1420,1168
234,1,0,150,0,-150
235,0,0,81,0,-81
236,1,1,462,1253,791
237,1,1,294,1698,1404
238,1,1,641,1617,976
239,1,0,82,0,-82
240,0,0,113,0,-113
241,1,1,486,1318,832
242,1,1,58,1321,1263
243,0,0,7,0,-7
244,0,0,18,0,-18
245,1,1,188,2612,2424
246,1,1,532,1705,1173
247,1,1,492,1244,752
248,1,0,27,0,-27
249,0,0,185,0,-185
250,0,0,9,0,-9
251,1,1,381,1267,886
252,1,1,1196,1280,84
253,1,0,20,0,-20
254,1,1,446,1340,894
255,0,0,33,0,-33
256,0,0,28,0,-28
257,0,0,80,0,-80
258,1,0,19,0,-19
259,1,0,281,0,-281
260,0,0,41,0,-41
261,1,1,386,1351,965
262,1,0,173,0,-173
263,1,1,157,1599,1442
264,0,0,47,0,-47
265,1,0,1,0,-1
266,1,0,17,0,-17
267,1,1,232,1622,1390
268,1,1,848,1914,1066
269,1,1,931,1527,596
270,1,0,15,0,-15
271,1,0,5,0,-5
272,0,0,9,0,-9
273,0,0,68,0,-68
274,0,0,22,0,-22
275,0,0,12,0,-12
276,0,0,126,0,-126
277,1,1,432,1522,1090
278,0,0,24,0,-24
279,1,1,359,1855,1496
280,1,0,82,0,-82
281,1,0,55,0,-55
282,0,0,55,0,-55
283,1,0,148,0,-148
284,0,0,25,0,-25
285,1,0,95,0,-95
286,1,1,66,1758,1692
287,1,0,102,0,-102
288,1,1,1160,1342,182
289,1,0,48,0,-48
290,1,0,19,0,-19
291,0,0,74,0,-74
292,1,1,79,1249,1170
293,1,0,28,0,-28
294,1,1,224,1440,1216
295,0,0,18,0,-18
296,0,0,23,0,-23
297,0,0,25,0,-25
298,1,1,2001,1342,-659
299,1,1,534,1798,1264
300,0,0,47,0,-47
301,1,1,680,1396,716
302,0,0,32,0,-32
303,1,1,35,1365,1330
304,1,1,338,1332,994
305,1,0,73,0,-73
306,1,0,141,0,-141
307,0,0,16,0,-16
308,1,0,71,0,-71
309,0,0,92,0,-92
310,1,0,28,0,-28
311,0,0,5,0,-5
312,0,0,144,0,-144
313,0,0,26,0,-26
314,1,0,33,0,-33
315,0,0,53,0,-53
316,0,0,134,0,-134
317,0,0,7,0,-7
318,0,0,41,0,-41
319,0,0,71,0,-71
320,1,1,326,1442,1116
321,1,0,45,0,-45
322,1,0,23,0,-23
323,0,0,43,0,-43
324,0,0,61,0,-61
325,1,1,385,1240,855
326,0,0,88,0,-88
327,1,0,131,0,-131
328,0,0,19,0,-19
329,1,1,671,1306,635
330,1,1,42,1449,1407
331,0,0,196,0,-196
332,0,0,9,0,-9
333,0,0,5,0,-5
334,1,0,3,0,-3
335,1,0,92,0,-92
336,1,0,44,0,-44
337,1,0,0,0,0
338,1,0,24,0,-24
339,1,1,1535,1291,-244
340,1,1,1132,1815,683
341,0,0,10,0,-10
342,1,0,56,0,-56
343,1,0,62,0,-62
344,1,0,145,0,-145
345,0,0,12,0,-12
346,1,0,48,0,-48
347,1,1,258,1252,994
348,1,1,48,1240,1192
349,1,0,7,0,-7
350,1,0,31,0,-31
351,1,1,372,1246,874
352,1,0,0,0,0
353,1,0,3,0,-3
354,1,0,5,0,-5
355,1,1,507,1280,773
356,1,0,120,0,-120
357,0,0,5,0,-5
358,1,1,1400,1477,77
359,1,0,226,0,-226
360,0,0,51,0,-51
361,0,0,10,0,-10
362,0,0,36,0,-36
363,1,0,55,0,-55
364,1,1,289,2073,1784
365,0,0,10,0,-10
366,0,0,39,0,-39
367,1,1,446,1394,948
368,0,0,58,0,-58
369,0,0,16,0,-16
370,0,0,87,0,-87
371,1,0,21,0,-21
372,1,1,189,1264,1075
373,1,0,19,0,-19
374,1,1,45,1429,1384
375,1,0,42,0,-42
376,0,0,78,0,-78
377,1,0,86,0,-86
378,0,0,9,0,-9
379,1,1,274,1404,1130
380,0,0,26,0,-26
381,1,1,2548,1754,-794
382,1,1,602,1515,913
383,1,1,55,1497,1442
384,0,0,75,0,-75
385,0,0,9,0,-9
386,1,0,24,0,-24
387,0,0,2,0,-2
388,1,0,73,0,-73
389,0,0,29,0,-29
390,0,0,15,0,-15
391,0,0,5,0,-5
392,0,0,74,0,-74
393,0,0,29,0,-29
394,1,0,104,0,-104
395,1,0,9,0,-9
396,0,0,0,0,0
397,0,0,33,0,-33
398,1,0,180,0,-180
399,0,0,80,0,-80
400,1,1,883,1911,1028
401,1,1,252,1543,1291
402,0,0,45,0,-45
403,0,0,50,0,-50
404,0,0,12,0,-12
405,0,0,23,0,-23
406,0,0,20,0,-20
407,1,0,16,0,-16
408,1,1,1258,1411,153
409,1,1,194,1730,1536
410,0,0,50,0,-50
411,1,0,124,0,-124
412,1,0,23,0,-23
413,1,0,85,0,-85
414,0,0,27,0,-27
415,0,0,64,0,-64
416,1,1,1643,1548,-95
417,0,0,74,0,-74
418,1,0,9,0,-9
419,1,0,146,0,-146
420,1,1,1208,1703,495
421,1,1,944,1449,505
422,0,0,41,0,-41
423,0,0,4,0,-4
424,0,0,46,0,-46
425,0,0,62,0,-62
426,1,1,410,1244,834
427,0,0,67,0,-67
428,1,1,934,1710,776
429,0,0,10,0,-10
430,1,0,121,0,-121
431,1,1,390,1717,1327
432,1,0,8,0,-8
433,0,0,40,0,-40
434,0,0,149,0,-149
435,1,1,342,1340,998
436,1,1,691,1718,1027
437,1,1,985,1386,401
438,1,1,1286,1245,-41
439,1,0,52,0,-52
440,0,0,26,0,-26
441,1,1,309,1236,927
442,1,1,651,1279,628
443,1,0,88,0,-88
444,1,1,490,1385,895
445,0,0,67,0,-67
446,1,0,22,0,-22
447,0,0,39,0,-39
448,0,0,25,0,-25
449,1,1,475,1452,977
450,1,1,226,1661,1435
451,1,0,85,0,-85
452,0,0,2,0,-2
453,1,1,501,1391,890
454,0,0,10,0,-10
455,1,0,37,0,-37
456,1,0,53,0,-53
457,1,1,293,1413,1120
458,0,0,7,0,-7
459,0,0,8,0,-8
460,1,0,21,0,-21
461,0,0,3,0,-3
462,1,0,95,0,-95
463,0,0,4,0,-4
464,1,1,156,1301,1145
465,0,0,14,0,-14
466,0,0,135,0,-135
467,1,1,309,2405,2096
468,1,0,52,0,-52
469,0,0,48,0,-48
470,1,1,198,1624,1426
471,1,1,68,1247,1179
472,1,0,17,0,-17
473,0,0,85,0,-85
474,1,0,16,0,-16
475,1,1,646,1728,1082
476,1,1,275,1370,1095
477,1,0,3,0,-3
478,0,0,4,0,-4
479,1,0,21,0,-21
480,0,0,4,0,-4
481,1,0,106,0,-106
482,1,1,989,1268,279
483,1,1,80,1606,1526
484,1,1,249,1246,997
485,0,0,12,0,-12
486,1,1,429,1240,811
487,0,0,57,0,-57
488,1,1,60,1321,1261
489,1,1,200,1263,1063
490,1,1,171,2908,2737
491,0,0,50,0,-50
492,0,0,95,0,-95
493,0,0,56,0,-56
494,1,0,27,0,-27
495,1,0,0,0,0
496,1,0,54,0,-54
497,0,0,3,0,-3
498,1,0,31,0,-31
499,0,0,2,0,-2
500,1,0,61,0,-61
501,0,0,39,0,-39
502,1,1,1152,4485,3333
503,0,0,54,0,-54
504,1,0,36,0,-36
505,0,0,96,0,-96
506,0,0,11,0,-11
507,1,0,75,0,-75
508,1,0,92,0,-92
509,0,0,25,0,-25
510,1,0,165,0,-165
511,0,0,43,0,-43
512,1,0,64,0,-64
513,1,1,110,1320,1210
514,1,0,13,0,-13
515,1,1,238,1399,1161
516,0,0,14,0,-14
517,1,0,31,0,-31
518,1,1,1011,1645,634
519,0,0,7,0,-7
520,1,1,171,1502,1331
521,0,0,1,0,-1
522,1,0,26,0,-26
523,0,0,36,0,-36
524,0,0,120,0,-120
525,1,0,17,0,-17
526,0,0,38,0,-38
527,1,0,83,0,-83
528,0,0,2,0,-2
529,1,0,85,0,-85
530,1,0,1,0,-1
531,0,0,12,0,-12
532,1,1,92,1892,1800
533,1,0,105,0,-105
534,0,0,14,0,-14
535,1,0,1,0,-1
536,1,1,80,1770,1690
537,0,0,28,0,-28
538,0,0,56,0,-56
539,1,0,54,0,-54
540,1,0,14,0,-14
541,1,0,9,0,-9
542,0,0,3,0,-3
543,0,0,15,0,-15
544,0,0,32,0,-32
545,0,0,0,0,0
546,1,1,1516,1344,-172
547,0,0,56,0,-56
548,1,0,25,0,-25
549,0,0,64,0,-64
550,1,1,208,1454,1246
551,1,0,3,0,-3
552,1,0,88,0,-88
553,0,0,27,0,-27
554,1,0,36,0,-36
555,1,0,127,0,-127
556,1,0,39,0,-39
557,1,1,67,2652,2585
558,0,0,23,0,-23
559,1,0,1,0,-1
560,0,0,12,0,-12
561,1,0,104,0,-104
562,1,0,53,0,-53
563,0,0,89,0,-89
564,1,1,364,3238,2874
565,0,0,2,0,-2
566,1,0,21,0,-21
567,1,1,173,1594,1421
568,1,1,228,1928,1700
569,1,0,52,0,-52
570,1,0,2,0,-2
571,1,0,153,0,-153
572,1,1,576,1512,936
573,0,0,72,0,-72
574,1,1,1220,1255,35
575,0,0,20,0,-20
576,1,0,86,0,-86
577,0,0,45,0,-45
578,0,0,57,0,-57
579,0,0,20,0,-20
580,0,0,49,0,-49
581,1,1,558,1836,1278
582,0,0,6,0,-6
583,0,0,102,0,-102
584,1,1,840,1293,453
585,1,0,4,0,-4
586,0,0,62,0,-62
587,1,0,9,0,-9
588,0,0,66,0,-66
589,1,1,274,1242,968
590,1,0,15,0,-15
591,1,0,45,0,-45
592,1,1,93,2377,2284
593,1,0,7,0,-7
594,0,0,70,0,-70
595,1,0,150,0,-150
596,1,0,25,0,-25
597,1,1,51,1255,1204
598,1,1,911,1238,327
599,1,1,591,1456,865
600,1,0,60,0,-60
601,0,0,26,0,-26
602,1,1,297,1389,1092
603,0,0,9,0,-9
604,0,0,105,0,-105
605,1,0,45,0,-45
606,0,0,103,0,-103
607,0,0,57,0,-57
608,1,1,57,1354,1297
609,1,1,1328,1413,85
610,1,1,268,1578,1310
611,1,0,14,0,-14
612,1,1,1039,1368,329
613,0,0,5,0,-5
614,1,0,198,0,-198
615,0,0,45,0,-45
616,1,1,153,2551,2398
617,0,0,7,0,-7
618,1,1,817,1242,425
619,1,1,717,1325,608
620,1,1,262,1474,1212
621,0,0,49,0,-49
622,1,0,33,0,-33
623,1,0,30,0,-30
624,0,0,33,0,-33
625,0,0,25,0,-25
626,0,0,101,0,-101
627,0,0,60,0,-60
628,1,1,5,3032,3027
629,1,0,152,0,-152
630,0,0,0,0,0
631,0,0,71,0,-71
632,1,0,64,0,-64
633,0,0,74,0,-74
634,1,1,186,1313,1127
635,1,1,177,1238,1061
636,1,1,743,2384,1641
637,1,1,351,5772,5421
638,0,0,17,0,-17
639,1,0,55,0,-55
640,1,0,2,0,-2
641,1,1,115,3594,3479
642,0,0,8,0,-8
643,0,0,50,0,-50
644,0,0,94,0,-94
645,0,0,88,0,-88
646,0,0,227,0,-227
647,1,1,253,1772,1519
648,1,1,422,3013,2591
649,1,0,71,0,-71
650,1,1,21,1404,1383
651,0,0,14,0,-14
652,1,0,40,0,-40
653,0,0,129,0,-129
654,1,1,434,1742,1308
655,0,0,7,0,-7
656,0,0,61,0,-61
657,0,0,21,0,-21
658,0,0,8,0,-8
659,1,0,70,0,-70
660,1,1,579,3367,2788
661,1,1,715,1406,691
662,0,0,14,0,-14
663,1,1,559,1303,744
664,1,1,281,1321,1040
665,1,0,127,0,-127
666,1,1,1500,1305,-195
667,1,1,47,1481,1434
668,1,1,343,1724,1381
669,1,0,80,0,-80
670,0,0,94,0,-94
671,0,0,42,0,-42
672,0,0,78,0,-78
673,1,1,159,1413,1254
674,1,1,380,1576,1196
675,0,0,47,0,-47
676,1,1,499,1345,846
677,0,0,51,0,-51
678,0,0,5,0,-5
679,1,0,33,0,-33
680,1,0,149,0,-149
681,0,0,48,0,-48
682,1,0,58,0,-58
683,1,0,0,0,0
684,0,0,15,0,-15
685,0,0,58,0,-58
686,1,1,1021,1799,778
687,1,1,415,1236,821
688,0,0,77,0,-77
689,0,0,29,0,-29
690,1,0,0,0,0
691,0,0,95,0,-95
692,0,0,21,0,-21
693,1,1,499,1298,799
694,1,1,892,1965,1073
695,0,0,47,0,-47
696,0,0,17,0,-17
697,0,0,13,0,-13
698,0,0,7,0,-7
699,0,0,183,0,-183
700,0,0,110,0,-110
701,0,0,65,0,-65
702,1,1,561,1284,723
703,1,1,278,1858,1580
704,1,0,15,0,-15
705,1,0,22,0,-22
706,1,1,495,1237,742
707,0,0,5,0,-5
708,1,1,129,1396,1267
709,0,0,43,0,-43
710,1,1,410,1577,1167
711,0,0,97,0,-97
712,1,1,951,2469,1518
713,1,1,1290,1560,270
714,1,1,776,1856,1080
715,1,0,34,0,-34
716,1,0,34,0,-34
717,1,0,17,0,-17
718,1,0,58,0,-58
719,1,1,1015,1239,224
720,1,1,480,1493,1013
721,1,1,660,1758,1098
722,1,0,55,0,-55
723,1,0,43,0,-43
724,0,0,33,0,-33
725,1,1,187,1525,1338
726,1,1,841,1549,708
727,0,0,2,0,-2
728,0,0,123,0,-123
729,1,0,6,0,-6
730,0,0,2,0,-2
731,1,1,331,1919,1588
732,0,0,1,0,-1
733,1,1,3073,1765,-1308
734,0,0,20,0,-20
735,0,0,21,0,-21
736,1,1,110,1305,1195
737,1,0,75,0,-75
738,1,1,455,1676,1221
739,0,0,28,0,-28
740,1,0,45,0,-45
741,1,1,981,1408,427
742,0,0,79,0,-79
743,1,0,20,0,-20
744,1,1,328,2510,2182
745,0,0,24,0,-24
746,1,0,38,0,-38
747,0,0,2,0,-2
748,1,1,233,1583,1350
749,1,1,1197,1261,64
750,0,0,15,0,-15
751,0,0,2,0,-2
752,1,1,915,1259,344
753,0,0,42,0,-42
754,0,0,29,0,-29
755,1,0,73,0,-73
756,1,0,62,0,-62
757,1,0,30,0,-30
758,0,0,73,0,-73
759,1,0,19,0,-19
760,1,0,25,0,-25
761,0,0,10,0,-10
762,0,0,20,0,-20
763,0,0,58,0,-58
764,0,0,77,0,-77
765,0,0,31,0,-31
766,1,0,42,0,-42
767,0,0,27,0,-27
768,0,0,40,0,-40
769,0,0,24,0,-24
770,0,0,3,0,-3
771,0,0,96,0,-96
772,0,0,38,0,-38
773,1,1,194,1653,1459
774,1,0,8,0,-8
775,0,0,3,0,-3
776,1,1,544,1925,1381
777,1,0,59,0,-59
778,0,0,5,0,-5
779,1,1,275,1372,1097
780,1,0,5,0,-5
781,1,0,34,0,-34
782,1,1,156,2006,1850
783,1,1,463,1255,792
784,0,0,12,0,-12
785,1,1,411,1263,852
786,1,0,86,0,-86
787,1,0,40,0,-40
788,1,0,43,0,-43
789,1,0,20,0,-20
790,1,0,6,0,-6
791,0,0,61,0,-61
792,0,0,0,0,0
793,0,0,133,0,-133
794,0,0,71,0,-71
795,1,1,413,2034,1621
796,1,1,232,1376,1144
797,0,0,114,0,-114
798,1,1,277,2042,1765
799,0,0,17,0,-17
800,1,1,268,1255,987
801,1,0,87,0,-87
802,1,0,51,0,-51
803,1,1,81,1250,1169
804,1,0,21,0,-21
805,1,1,245,2175,1930
806,1,0,24,0,-24
807,1,1,598,1263,665
808,1,0,18,0,-18
809,0,0,7,0,-7
810,1,0,324,0,-324
811,1,0,95,0,-95
812,0,0,75,0,-75
813,0,0,2,0,-2
814,1,0,13,0,-13
815,1,1,1367,1350,-17
816,0,0,91,0,-91
817,1,0,359,0,-359
818,1,0,1,0,-1
819,1,0,62,0,-62
820,1,0,4,0,-4
821,1,1,511,1369,858
822,0,0,57,0,-57
823,1,0,101,0,-101
824,0,0,35,0,-35
825,1,1,486,1239,753
826,1,0,1,0,-1
827,0,0,87,0,-87
828,1,1,633,1914,1281
829,0,0,96,0,-96
830,1,0,18,0,-18
831,1,0,54,0,-54
832,0,0,7,0,-7
833,1,1,1245,1246,1
834,0,0,88,0,-88
835,0,0,22,0,-22
836,0,0,7,0,-7
837,0,0,39,0,-39
838,0,0,56,0,-56
839,1,0,9,0,-9
840,0,0,0,0,0
841,1,1,17,1419,1402
842,1,1,268,1808,1540
843,0,0,12,0,-12
844,1,0,102,0,-102
845,0,0,28,0,-28
846,0,0,42,0,-42
847,1,0,26,0,-26
848,0,0,142,0,-142
849,1,0,3,0,-3
850,1,1,175,1267,1092
851,1,0,14,0,-14
852,1,0,40,0,-40
853,1,0,117,0,-117
854,1,0,18,0,-18
855,0,0,147,0,-147
856,1,0,26,0,-26
857,1,1,795,1657,862
858,1,1,359,1260,901
859,1,0,14,0,-14
860,1,1,704,1280,576
861,0,0,32,0,-32
862,1,1,1506,1281,-225
863,0,0,84,0,-84
864,1,0,105,0,-105
865,0,0,28,0,-28
866,0,0,4,0,-4
867,0,0,16,0,-16
868,1,0,1,0,-1
869,0,0,83,0,-83
870,0,0,67,0,-67
871,1,0,8,0,-8
872,0,0,4,0,-4
873,1,1,40,1269,1229
874,1,1,871,3181,2310
875,0,0,12,0,-12
876,1,0,52,0,-52
877,0,0,23,0,-23
878,0,0,65,0,-65
879,1,1,17,1306,1289
880,1,0,11,0,-11
881,1,1,721,1311,590
882,1,0,56,0,-56
883,1,0,65,0,-65
884,1,0,35,0,-35
885,1,1,223,1777,1554
886,0,0,51,0,-51
887,1,1,2725,1390,-1335
888,1,1,1847,1905,58
889,0,0,297,0,-297
890,0,0,36,0,-36
891,0,0,26,0,-26
892,0,0,10,0,-10
893,0,0,102,0,-102
894,0,0,71,0,-71
895,1,1,144,1613,1469
896,1,1,252,2049,1797
897,1,1,115,1255,1140
898,0,0,29,0,-29
899,1,1,529,1487,958
900,0,0,154,0,-154
901,1,0,184,0,-184
902,0,0,105,0,-105
903,1,0,96,0,-96
904,0,0,79,0,-79
905,1,1,451,1275,824
906,1,0,1,0,-1
907,0,0,3,0,-3
908,0,0,48,0,-48
909,0,0,149,0,-149
910,1,0,29,0,-29
911,0,0,147,0,-147
912,1,1,1719,1319,-400
913,0,0,85,0,-85
914,1,0,27,0,-27
915,1,0,8,0,-8
916,1,1,957,1988,1031
917,1,0,45,0,-45
918,0,0,15,0,-15
919,1,1,134,1340,1206
920,1,1,128,1284,1156
921,0,0,74,0,-74
922,1,1,691,1437,746
923,0,0,13,0,-13
924,1,1,2220,1276,-944
925,1,1,456,3177,2721
926,0,0,12,0,-12
927,0,0,109,0,-109
928,1,1,1270,1405,135
929,1,0,66,0,-66
930,1,0,34,0,-34
931,1,1,275,1558,1283
932,1,1,336,1410,1074
933,1,1,948,2013,1065
934,0,0,6,0,-6
935,0,0,164,0,-164
936,1,1,132,1344,1212
937,1,0,105,0,-105
938,1,1,227,1529,1302
939,0,0,43,0,-43
940,1,0,201,0,-201
941,0,0,107,0,-107
942,0,0,91,0,-91
943,1,1,441,1251,810
944,1,1,629,1504,875
945,0,0,1,0,-1
946,0,0,107,0,-107
947,1,0,108,0,-108
948,1,1,1145,1452,307
949,0,0,44,0,-44
950,1,0,89,0,-89
951,0,0,147,0,-147
952,1,0,33,0,-33
953,0,0,8,0,-8
954,1,1,270,1292,1022
955,0,0,138,0,-138
956,0,0,94,0,-94
957,0,0,26,0,-26
958,1,1,61,1326,1265
959,0,0,103,0,-103
960,0,0,15,0,-15
961,0,0,19,0,-19
962,1,0,14,0,-14
963,1,1,613,1512,899
964,1,0,52,0,-52
965,0,0,48,0,-48
966,1,0,31,0,-31
967,1,1,213,1280,1067
968,0,0,4,0,-4
969,1,0,6,0,-6
970,1,1,237,1692,1455
971,1,1,42,1405,1363
972,1,1,986,1465,479
973,0,0,18,0,-18
974,0,0,95,0,-95
975,1,1,74,1688,1614
976,1,0,2,0,-2
977,0,0,99,0,-99
978,1,1,1592,1308,-284
979,0,0,19,0,-19
980,1,0,2,0,-2
981,1,1,363,1852,1489
982,1,0,67,0,-67
983,1,0,133,0,-133
984,1,1,104,1466,1362
985,1,1,235,1575,1340
986,1,0,6,0,-6
987,1,0,5,0,-5
988,0,0,20,0,-20
989,0,0,17,0,-17
990,1,1,715,1475,760
991,0,0,1,0,-1
992,0,0,69,0,-69
993,0,0,24,0,-24
994,0,0,59,0,-59
995,1,0,33,0,-33
996,1,1,2028,1401,-627
997,0,0,102,0,-102
998,0,0,53,0,-53
999,1,0,83,0,-83
1000,1,1,810,1434,624
1001,1,1,1464,2940,1476
1002,1,0,57,0,-57
1003,0,0,45,0,-45
1004,1,0,2,0,-2
1005,0,0,56,0,-56
1006,1,0,31,0,-31
1007,0,0,51,0,-51
1008,1,1,129,1239,1110
1009,1,0,3,0,-3
1010,0,0,1,0,-1
1011,1,0,84,0,-84
1012,1,1,402,1543,1141
1013,1,1,793,1375,582
1014,0,0,59,0,-59
1015,1,1,286,1301,1015
1016,1,0,15,0,-15
1017,1,0,57,0,-57
1018,0,0,35,0,-35
1019,1,1,100,1328,1228
1020,1,0,21,0,-21
1021,1,0,75,0,-75
1022,1,1,105,1427,1322
1023,0,0,68,0,-68
1024,1,1,240,1246,1006
1025,1,0,14,0,-14
1026,0,0,36,0,-36
1027,1,0,100,0,-100
1028,1,1,711,1629,918
1029,1,0,27,0,-27
1030,1,1,697,1388,691
1031,1,1,315,1496,1181
1032,1,1,497,1242,745
1033,1,1,858,1462,604
1034,1,1,813,1248,435
1035,1,1,137,1486,1349
1036,1,0,25,0,-25
1037,1,1,609,3089,2480
1038,1,0,74,0,-74
1039,1,1,625,1387,762
1040,0,0,31,0,-31
1041,1,0,31,0,-31
1042,1,1,338,1516,1178
1043,1,1,1169,1244,75
1044,0,0,14,0,-14
1045,0,0,2,0,-2
1046,1,1,202,1254,1052
1047,0,0,1,0,-1
1048,1,0,48,0,-48
1049,1,0,37,0,-37
1050,1,0,19,0,-19
1051,0,0,41,0,-41
1052,0,0,63,0,-63
1053,0,0,32,0,-32
1054,1,0,15,0,-15
1055,1,0,134,0,-134
1056,1,1,304,1396,1092
1057,1,1,100,2289,2189
1058,0,0,17,0,-17
1059,0,0,24,0,-24
1060,1,0,29,0,-29
1061,1,0,30,0,-30
1062,1,1,480,1361,881
1063,1,1,378,1355,977
1064,1,0,83,0,-83
1065,1,1,619,1646,1027
1066,0,0,22,0,-22
1067,0,0,72,0,-72
1068,1,1,1168,1393,225
1069,1,0,79,0,-79
1070,0,0,121,0,-121
1071,0,0,29,0,-29
1072,1,0,74,0,-74
1073,1,0,94,0,-94
1074,0,0,15,0,-15
1075,1,0,22,0,-22
1076,1,0,58,0,-58
1077,1,1,225,1484,1259
1078,1,1,593,1325,732
1079,0,0,47,0,-47
1080,1,0,51,0,-51
1081,1,0,0,0,0
1082,0,0,3,0,-3
1083,1,0,6,0,-6
1084,0,0,2,0,-2
1085,1,0,63,0,-63
1086,1,1,198,1242,1044
1087,1,1,698,1285,587
1088,0,0,6,0,-6
1089,0,0,122,0,-122
1090,0,0,4,0,-4
1091,0,0,35,0,-35
1092,1,1,160,1379,1219
1093,1,0,12,0,-12
1094,1,1,430,1313,883
1095,0,0,47,0,-47
1096,0,0,39,0,-39
1097,0,0,13,0,-13
1098,1,1,692,1415,723
1099,0,0,8,0,-8
1100,0,0,78,0,-78
1101,0,0,5,0,-5
1102,1,0,9,0,-9
1103,0,0,53,0,-53
1104,0,0,70,0,-70
1105,0,0,128,0,-128
1106,0,0,14,0,-14
1107,1,0,3,0,-3
1108,1,1,763,1279,516
1109,0,0,52,0,-52
1110,1,0,0,0,0
1111,0,0,41,0,-41
1112,0,0,1,0,-1
1113,1,0,24,0,-24
1114,1,0,7,0,-7
1115,0,0,20,0,-20
1116,1,1,2873,1426,-1447
1117,0,0,65,0,-65
1118,1,1,10,1310,1300
1119,1,0,91,0,-91
1120,1,0,31,0,-31
1121,1,1,229,1421,1192
1122,1,1,264,1699,1435
1123,1,0,21,0,-21
1124,1,0,3,0,-3
1125,1,0,96,0,-96
1126,1,1,221,1268,1047
1127,1,0,7,0,-7
1128,1,0,147,0,-147
1129,1,0,3,0,-3
1130,0,0,40,0,-40
1131,1,0,60,0,-60
1132,1,1,164,1611,1447
1133,1,0,80,0,-80
1134,1,1,431,1867,1436
1135,0,0,31,0,-31
1136,1,0,101,0,-101
1137,0,0,89,0,-89
1138,1,0,29,0,-29
1139,0,0,15,0,-15
1140,0,0,20,0,-20
1141,0,0,70,0,-70
1142,0,0,44,0,-44
1143,0,0,18,0,-18
1144,0,0,96,0,-96
1145,1,1,283,1326,1043
1146,0,0,2,0,-2
1147,1,1,61,1568,1507
1148,0,0,36,0,-36
1149,1,1,486,1428,942
1150,0,0,32,0,-32
1151,1,0,19,0,-19
1152,1,0,3,0,-3
1153,1,0,137,0,-137
1154,1,0,2,0,-2
1155,0,0,12,0,-12
1156,0,0,9,0,-9
1157,0,0,50,0,-50
1158,1,1,239,1294,1055
1159,0,0,13,0,-13
1160,1,0,107,0,-107
1161,0,0,13,0,-13
1162,0,0,82,0,-82
1163,0,0,36,0,-36
1164,1,0,10,0,-10
1165,0,0,10,0,-10
1166,1,1,103,2216,2113
1167,0,0,31,0,-31
1168,0,0,68,0,-68
1169,0,0,20,0,-20
1170,0,0,49,0,-49
1171,1,0,161,0,-161
1172,0,0,64,0,-64
1173,1,1,1748,2301,553
1174,0,0,6,0,-6
1175,0,0,28,0,-28
1176,1,1,872,1570,698
1177,0,0,36,0,-36
1178,1,0,0,0,0
1179,0,0,20,0,-20
1180,0,0,25,0,-25
1181,1,0,6,0,-6
1182,1,0,13,0,-13
1183,1,1,253,1630,1377
1184,0,0,161,0,-161
1185,0,0,11,0,-11
1186,1,1,889,1480,591
1187,1,0,53,0,-53
1188,0,0,173,0,-173
1189,0,0,13,0,-13
1190,0,0,40,0,-40
1191,0,0,9,0,-9
1192,0,0,333,0,-333
1193,1,1,328,1384,1056
1194,0,0,8,0,-8
1195,1,1,251,1335,1084
1196,0,0,96,0,-96
1197,1,1,546,1327,781
1198,1,0,287,0,-287
1199,1,1,246,1480,1234
1200,1,0,19,0,-19
1201,1,0,100,0,-100
1202,0,0,81,0,-81
1203,0,0,28,0,-28
1204,1,0,25,0,-25
1205,0,0,4,0,-4
1206,1,0,16,0,-16
1207,1,0,24,0,-24
1208,0,0,7,0,-7
1209,1,0,100,0,-100
1210,1,0,13,0,-13
1211,1,0,1,0,-1
1212,0,0,41,0,-41
1213,1,0,10,0,-10
1214,1,0,53,0,-53
1215,0,0,103,0,-103
1216,1,1,289,1489,1200
1217,0,0,39,0,-39
1218,0,0,29,0,-29
1219,0,0,57,0,-57
1220,1,0,11,0,-11
1221,1,1,127,1483,1356
1222,1,1,1272,1307,35
1223,1,0,46,0,-46
1224,1,0,226,0,-226
1225,1,1,1392,1467,75
1226,1,1,89,1976,1887
1227,1,1,173,1461,1288
1228,0,0,0,0,0
1229,1,1,1795,1359,-436
1230,0,0,3,0,-3
1231,1,0,25,0,-25
1232,1,0,25,0,-25
1233,1,0,55,0,-55
1234,1,1,27,1240,1213
1235,0,0,7,0,-7
1236,1,1,141,1400,1259
1237,1,1,103,1296,1193
1238,1,0,22,0,-22
1239,1,1,361,1532,1171
1240,0,0,0,0,0
1241,1,1,221,1689,1468
1242,1,0,10,0,-10
1243,1,0,40,0,-40
1244,1,0,72,0,-72
1245,1,1,407,1448,1041
1246,0,0,82,0,-82
1247,1,0,62,0,-62
1248,0,0,92,0,-92
1249,1,0,2,0,-2
1250,1,1,861,1517,656
1251,1,0,3,0,-3
1252,1,1,55,1337,1282
1253,0,0,64,0,-64
1254,1,0,108,0,-108
1255,1,1,267,1545,1278
1256,1,1,129,1495,1366
1257,0,0,122,0,-122
1258,1,0,11,0,-11
1259,1,1,1287,1894,607
1260,1,1,588,1891,1303
1261,1,1,137,1407,1270
1262,1,0,25,0,-25
1263,1,0,5,0,-5
1264,0,0,87,0,-87
1265,1,0,65,0,-65
1266,0,0,22,0,-22
1267,0,0,16,0,-16
1268,1,1,175,1357,1182
1269,1,0,101,0,-101
1270,0,0,50,0,-50
1271,0,0,6,0,-6
1272,0,0,27,0,-27
1273,0,0,18,0,-18
1274,0,0,18,0,-18
1275,0,0,51,0,-51
1276,1,1,152,1286,1134
1277,1,0,27,0,-27
1278,1,0,122,0,-122
1279,1,1,293,1556,1263
1280,0,0,15,0,-15
1281,1,1,183,1402,1219
1282,1,1,391,1293,902
1283,0,0,18,0,-18
1284,1,1,147,2286,2139
1285,1,1,148,1281,1133
1286,1,1,133,1286,1153
1287,1,1,159,1748,1589
1288,1,0,73,0,-73
1289,1,1,2483,1252,-1231
1290,1,1,243,1528,1285
1291,0,0,31,0,-31
1292,0,0,7,0,-7
1293,0,0,2,0,-2
1294,0,0,167,0,-167
1295,0,0,36,0,-36
1296,1,0,12,0,-12
1297,0,0,112,0,-112
1298,0,0,31,0,-31
1299,1,0,23,0,-23
1300,1,1,706,1330,624
1301,1,1,1221,1338,117
1302,0,0,106,0,-106
1303,1,0,6,0,-6
1304,1,0,14,0,-14
1305,1,1,154,1401,1247
1306,1,1,601,1643,1042
1307,1,1,978,1562,584
1308,0,0,51,0,-51
1309,1,1,101,1378,1277
1310,1,1,372,1357,985
1311,1,1,766,1336,570
1312,0,0,5,0,-5
1313,1,1,74,1269,1195
1314,1,0,8,0,-8
1315,1,0,140,0,-140
1316,1,0,20,0,-20
1317,0,0,29,0,-29
1318,1,0,6,0,-6
1319,0,0,43,0,-43
1320,0,0,16,0,-16
1321,1,0,18,0,-18
1322,0,0,255,0,-255
1323,1,0,16,0,-16
1324,1,0,6,0,-6
1325,1,1,632,1331,699
1326,1,1,98,1503,1405
1327,1,0,22,0,-22
1328,1,1,1525,1295,-230
1329,1,1,223,1566,1343
1330,1,1,879,1675,796
1331,1,0,11,0,-11
1332,0,0,20,0,-20
1333,0,0,84,0,-84
1334,1,0,15,0,-15
1335,0,0,47,0,-47
1336,1,1,433,1575,1142
1337,1,0,0,0,0
1338,0,0,199,0,-199
1339,1,1,554,1457,903
1340,0,0,147,0,-147
1341,0,0,57,0,-57
1342,1,0,44,0,-44
1343,1,1,124,1323,1199
1344,0,0,3,0,-3
1345,1,0,50,0,-50
1346,0,0,37,0,-37
1347,0,0,22,0,-22
1348,0,0,24,0,-24
1349,1,0,10,0,-10
1350,0,0,7,0,-7
1351,1,0,70,0,-70
1352,0,0,14,0,-14
1353,0,0,23,0,-23
1354,0,0,23,0,-23
1355,1,1,283,1537,1254
1356,0,0,43,0,-43
1357,1,1,278,1248,970
1358,1,0,8,0,-8
1359,0,0,69,0,-69
1360,1,1,439,1352,913
1361,1,1,641,1382,741
1362,1,1,278,2585,2307
1363,1,0,207,0,-207
1364,1,0,102,0,-102
1365,1,1,414,1326,912
1366,1,1,203,1579,1376
1367,1,0,29,0,-29
1368,0,0,12,0,-12
1369,1,1,2320,1355,-965
1370,1,0,44,0,-44
1371,0,0,57,0,-57
1372,0,0,1,0,-1
1373,0,0,4,0,-4
1374,1,1,523,1896,1373
1375,0,0,119,0,-119
1376,0,0,37,0,-37
1377,0,0,21,0,-21
1378,1,1,162,1715,1553
1379,1,0,4,0,-4
1380,1,0,31,0,-31
1381,1,0,65,0,-65
1382,1,1,424,1546,1122
1383,1,0,1,0,-1
1384,1,0,141,0,-141
1385,0,0,1,0,-1
1386,1,1,840,2143,1303
1387,0,0,6,0,-6
1388,1,0,12,0,-12
1389,1,1,455,1616,1161
1390,0,0,1,0,-1
1391,1,1,653,1697,1044
1392,1,0,29,0,-29
1393,1,0,4,0,-4
1394,1,0,7,0,-7
1395,0,0,103,0,-103
1396,1,0,62,0,-62
1397,1,1,443,1540,1097
1398,1,1,851,2222,1371
1399,1,0,9,0,-9
1400,1,1,81,1370,1289
1401,1,0,2,0,-2
1402,1,0,6,0,-6
1403,0,0,1,0,-1
1404,1,0,41,0,-41
1405,1,1,2002,2151,149
1406,1,1,253,1318,1065
1407,1,1,113,3924,3811
1408,1,1,171,2017,1846
1409,0,0,12,0,-12
1410,1,0,50,0,-50
1411,0,0,16,0,-16
1412,0,0,43,0,-43
1413,1,1,470,1858,1388
1414,0,0,10,0,-10
1415,1,0,66,0,-66
1416,1,0,58,0,-58
1417,1,1,178,1308,1130
1418,1,1,598,1298,700
1419,1,1,41,1343,1302
1420,1,1,255,3944,3689
1421,1,0,21,0,-21
1422,1,0,9,0,-9
1423,0,0,2,0,-2
1424,1,1,350,1642,1292
1425,1,0,51,0,-51
1426,1,0,2,0,-2
1427,0,0,3,0,-3
1428,0,0,16,0,-16
1429,1,0,81,0,-81
1430,1,0,64,0,-64
1431,0,0,75,0,-75
1432,0,0,10,0,-10
1433,0,0,9,0,-9
1434,0,0,12,0,-12
1435,0,0,38,0,-38
1436,0,0,39,0,-39
1437,0,0,18,0,-18
1438,1,0,11,0,-11
1439,0,0,455,0,-455
1440,1,1,189,1529,1340
1441,1,1,640,1391,751
1442,0,0,25,0,-25
1443,0,0,1,0,-1
1444,0,0,94,0,-94
1445,0,0,62,0,-62
1446,0,0,47,0,-47
1447,1,1,887,1339,452
1448,1,0,38,0,-38
1449,1,1,224,1276,1052
1450,0,0,3,0,-3
1451,1,0,8,0,-8
1452,1,0,317,0,-317
1453,1,0,55,0,-55
1454,1,0,40,0,-40
1455,1,0,17,0,-17
1456,0,0,29,0,-29
1457,1,0,1,0,-1
1458,1,0,11,0,-11
1459,0,0,55,0,-55
1460,1,1,215,1611,1396
1461,0,0,0,0,0
1462,0,0,7,0,-7
1463,0,0,70,0,-70
1464,1,0,11,0,-11
1465,0,0,9,0,-9
1466,1,1,540,1702,1162
1467,1,0,32,0,-32
1468,1,1,151,1694,1543
1469,1,1,527,1445,918
1470,0,0,392,0,-392
1471,1,1,487,1479,992
1472,0,0,37,0,-37
1473,1,1,418,1964,1546
1474,1,0,27,0,-27
1475,0,0,41,0,-41
1476,0,0,109,0,-109
1477,1,1,1013,1331,318
1478,1,0,0,0,0
1479,1,1,177,1643,1466
1480,0,0,65,0,-65
1481,0,0,53,0,-53
1482,0,0,272,0,-272
1483,1,0,108,0,-108
1484,0,0,189,0,-189
1485,1,0,7,0,-7
1486,1,1,164,1268,1104
1487,0,0,40,0,-40
1488,0,0,77,0,-77
1489,1,1,226,1335,1109
1490,0,0,7,0,-7
1491,1,1,407,1510,1103
1492,1,0,42,0,-42
1493,1,1,325,1570,1245
1494,1,1,386,1377,991
1495,0,0,27,0,-27
1496,0,0,61,0,-61
1497,1,0,13,0,-13
1498,0,0,13,0,-13
1499,1,0,12,0,-12
1500,1,1,64,2466,2402
1501,1,0,100,0,-100
1502,1,1,237,1425,1188
1503,1,0,74,0,-74
1504,0,0,181,0,-181
1505,1,0,79,0,-79
1506,1,1,574,1389,815
1507,1,0,13,0,-13
1508,1,0,92,0,-92
1509,1,1,927,1535,608
1510,1,1,347,1400,1053
1511,0,0,1,0,-1
1512,0,0,45,0,-45
1513,0,0,15,0,-15
1514,1,0,77,0,-77
1515,0,0,25,0,-25
1516,0,0,14,0,-14
1517,1,1,238,1573,1335
1518,0,0,69,0,-69
1519,0,0,40,0,-40
1520,1,1,639,1319,680
1521,0,0,23,0,-23
1522,1,1,532,1379,847
1523,1,0,123,0,-123
1524,0,0,14,0,-14
1525,1,0,42,0,-42
1526,0,0,16,0,-16
1527,1,1,400,1566,1166
1528,1,1,427,1697,1270
1529,1,0,109,0,-109
1530,1,1,215,1279,1064
1531,1,0,47,0,-47
1532,0,0,39,0,-39
1533,1,1,138,1292,1154
1534,1,1,276,1323,1047
1535,0,0,18,0,-18
1536,0,0,17,0,-17
1537,1,1,932,1430,498
1538,0,0,98,0,-98
1539,1,1,1323,1415,92
1540,0,0,8,0,-8
1541,1,0,77,0,-77
1542,0,0,31,0,-31
1543,1,1,823,1289,466
1544,1,1,504,1321,817
1545,1,1,214,1360,1146
1546,0,0,65,0,-65
1547,0,0,85,0,-85
1548,0,0,78,0,-78
1549,0,0,79,0,-79
1550,0,0,16,0,-16
1551,0,0,18,0,-18
1552,1,0,2,0,-2
1553,0,0,5,0,-5
1554,1,0,122,0,-122
1555,0,0,68,0,-68
1556,1,1,222,1266,1044
1557,1,0,33,0,-33
1558,1,0,111,0,-111
1559,0,0,58,0,-58
1560,0,0,20,0,-20
1561,1,0,29,0,-29
1562,1,0,12,0,-12
1563,0,0,3,0,-3
1564,1,0,8,0,-8
1565,1,0,25,0,-25
1566,1,0,67,0,-67
1567,0,0,8,0,-8
1568,1,0,70,0,-70
1569,0,0,69,0,-69
1570,1,1,466,1254,788
1571,0,0,42,0,-42
1572,1,1,521,1734,1213
1573,0,0,139,0,-139
1574,0,0,91,0,-91
1575,1,0,74,0,-74
1576,1,1,894,1306,412
1577,0,0,20,0,-20
1578,1,1,809,1731,922
1579,1,1,24,1243,1219
1580,0,0,6,0,-6
1581,1,0,131,0,-131
1582,0,0,10,0,-10
1583,0,0,159,0,-159
1584,1,1,1325,1718,393
1585,1,0,67,0,-67
1586,1,0,6,0,-6
1587,1,0,0,0,0
1588,1,1,841,1242,401
1589,0,0,11,0,-11
1590,1,1,167,1249,1082
1591,1,0,90,0,-90
1592,0,0,8,0,-8
1593,1,1,282,1413,1131
1594,1,0,43,0,-43
1595,0,0,118,0,-118
1596,0,0,5,0,-5
1597,1,0,55,0,-55
1598,1,0,67,0,-67
1599,0,0,123,0,-123
1600,0,0,33,0,-33
1601,1,1,339,1483,1144
1602,0,0,13,0,-13
1603,1,0,2,0,-2
1604,1,0,111,0,-111
1605,0,0,17,0,-17
1606,1,0,4,0,-4
1607,1,0,82,0,-82
1608,1,0,41,0,-41
1609,0,0,1,0,-1
1610,0,0,47,0,-47
1611,1,1,437,2053,1616
1612,0,0,53,0,-53
1613,1,1,66,1406,1340
1614,1,0,15,0,-15
1615,1,0,24,0,-24
1616,0,0,39,0,-39
1617,1,0,24,0,-24
1618,1,0,12,0,-12
1619,0,0,12,0,-12
1620,1,1,1063,2013,950
1621,1,1,97,1835,1738
1622,1,1,548,1249,701
1623,0,0,27,0,-27
1624,0,0,24,0,-24
1625,0,0,53,0,-53
1626,0,0,19,0,-19
1627,0,0,75,0,-75
1628,0,0,58,0,-58
1629,0,0,15,0,-15
1630,1,1,281,1398,1117
1631,0,0,65,0,-65
1632,1,0,19,0,-19
1633,0,0,2,0,-2
1634,1,0,7,0,-7
1635,1,1,90,2468,2378
1636,1,1,1953,1947,-6
1637,1,0,44,0,-44
1638,1,1,192,1350,1158
1639,1,1,1469,1753,284
1640,0,0,10,0,-10
1641,1,1,199,1447,1248
1642,0,0,114,0,-114
1643,1,1,106,1472,1366
1644,1,0,112,0,-112
1645,0,0,0,0,0
1646,1,1,1234,1543,309
1647,0,0,54,0,-54
1648,1,0,16,0,-16
1649,1,0,17,0,-17
1650,0,0,13,0,-13
1651,1,1,643,3788,3145
1652,0,0,36,0,-36
1653,0,0,67,0,-67
1654,1,1,92,1458,1366
1655,0,0,6,0,-6
1656,1,0,13,0,-13
1657,0,0,127,0,-127
1658,1,0,20,0,-20
1659,1,1,66,1270,1204
1660,1,0,6,0,-6
1661,0,0,4,0,-4
1662,0,0,90,0,-90
1663,1,0,76,0,-76
1664,0,0,0,0,0
1665,0,0,125,0,-125
1666,1,0,122,0,-122
1667,1,1,952,1420,468
1668,0,0,114,0,-114
1669,1,1,495,1421,926
1670,0,0,13,0,-13
1671,0,0,165,0,-165
1672,0,0,72,0,-72
1673,1,1,556,1569,1013
1674,1,0,49,0,-49
1675,0,0,46,0,-46
1676,1,1,79,1665,1586
1677,0,0,1,0,-1
1678,0,0,9,0,-9
1679,0,0,0,0,0
1680,0,0,54,0,-54
1681,0,0,48,0,-48
1682,0,0,1,0,-1
1683,0,0,50,0,-50
1684,1,1,378,1448,1070
1685,1,0,141,0,-141
1686,0,0,106,0,-106
1687,1,1,150,1353,1203
1688,1,0,76,0,-76
1689,0,0,60,0,-60
1690,1,1,472,2295,1823
1691,1,1,203,1573,1370
1692,0,0,95,0,-95
1693,0,0,8,0,-8
1694,1,0,7,0,-7
1695,0,0,70,0,-70
1696,1,1,62,1672,1610
1697,1,1,813,1446,633
1698,0,0,12,0,-12
1699,0,0,11,0,-11
1700,1,0,1,0,-1
1701,0,0,8,0,-8
1702,1,1,203,2215,2012
1703,1,1,380,1424,1044
1704,1,0,31,0,-31
1705,1,0,28,0,-28
1706,1,0,212,0,-212
1707,0,0,51,0,-51
1708,0,0,65,0,-65
1709,1,0,0,0,0
1710,1,0,24,0,-24
1711,1,1,482,1340,858
1712,0,0,146,0,-146
1713,0,0,32,0,-32
1714,1,1,662,1281,619
1715,1,1,58,1469,1411
1716,1,0,26,0,-26
1717,1,1,493,1350,857
1718,0,0,116,0,-116
1719,0,0,80,0,-80
1720,1,1,983,1591,608
1721,1,1,1957,1398,-559
1722,0,0,29,0,-29
1723,1,0,16,0,-16
1724,0,0,87,0,-87
1725,1,1,364,1389,1025
1726,1,0,53,0,-53
1727,1,0,85,0,-85
1728,0,0,39,0,-39
1729,1,1,366,1396,1030
1730,0,0,1,0,-1
1731,1,0,289,0,-289
1732,0,0,129,0,-129
1733,1,1,505,1323,818
1734,1,0,91,0,-91
1735,0,0,58,0,-58
1736,1,0,0,0,0
1737,1,1,223,1505,1282
1738,1,0,50,0,-50
1739,0,0,20,0,-20
1740,1,0,53,0,-53
1741,1,0,72,0,-72
1742,1,1,398,1394,996
1743,1,0,57,0,-57
1744,1,1,174,1668,1494
1745,1,1,307,2055,1748
1746,0,0,40,0,-40
1747,1,0,23,0,-23
1748,1,1,881,4241,3360
1749,1,0,122,0,-122
1750,0,0,4,0,-4
1751,0,0,14,0,-14
1752,1,1,363,1581,1218
1753,0,0,13,0,-13
1754,1,0,41,0,-41
1755,1,1,46,1423,1377
1756,1,0,53,0,-53
1757,0,0,13,0,-13
1758,1,0,148,0,-148
1759,0,0,2,0,-2
1760,0,0,2,0,-2
1761,1,0,3,0,-3
1762,0,0,22,0,-22
1763,0,0,44,0,-44
1764,0,0,41,0,-41
1765,1,1,36,1580,1544
1766,1,0,15,0,-15
1767,1,1,394,1846,1452
1768,0,0,130,0,-130
1769,0,0,27,0,-27
1770,1,0,25,0,-25
1771,0,0,39,0,-39
1772,1,0,14,0,-14
1773,1,1,203,1402,1199
1774,1,1,105,2202,2097
1775,1,1,321,1311,990
1776,0,0,23,0,-23
1777,0,0,78,0,-78
1778,0,0,10,0,-10
1779,1,1,340,1922,1582
1780,0,0,23,0,-23
1781,1,1,895,1258,363
1782,0,0,54,0,-54
1783,1,1,220,1310,1090
1784,1,1,252,1393,1141
1785,0,0,39,0,-39
1786,1,1,1510,1381,-129
1787,0,0,20,0,-20
1788,1,0,17,0,-17
1789,0,0,80,0,-80
1790,1,1,190,1705,1515
1791,1,0,150,0,-150
1792,1,1,642,1263,621
1793,1,1,104,1506,1402
1794,1,1,398,1525,1127
1795,1,1,159,1302,1143
1796,0,0,5,0,-5
1797,1,0,39,0,-39
1798,1,0,107,0,-107
1799,1,1,249,1491,1242
1800,0,0,3,0,-3
1801,1,1,815,1302,487
1802,0,0,198,0,-198
1803,1,0,3,0,-3
1804,0,0,6,0,-6
1805,1,1,573,1287,714
1806,0,0,242,0,-242
1807,0,0,66,0,-66
1808,0,0,196,0,-196
1809,0,0,15,0,-15
1810,0,0,25,0,-25
1811,0,0,42,0,-42
1812,0,0,81,0,-81
1813,0,0,42,0,-42
1814,1,1,200,1402,1202
1815,1,0,6,0,-6
1816,0,0,25,0,-25
1817,0,0,131,0,-131
1818,1,1,232,1530,1298
1819,0,0,207,0,-207
1820,1,0,53,0,-53
1821,0,0,43,0,-43
1822,1,0,5,0,-5
1823,1,0,23,0,-23
1824,0,0,32,0,-32
1825,0,0,10,0,-10
1826,0,0,5,0,-5
1827,1,0,15,0,-15
1828,1,1,205,1771,1566
1829,0,0,1,0,-1
1830,0,0,45,0,-45
1831,1,0,93,0,-93
1832,1,0,10,0,-10
1833,0,0,85,0,-85
1834,0,0,11,0,-11
1835,0,0,36,0,-36
1836,1,1,1847,1428,-419
1837,1,0,23,0,-23
1838,1,0,14,0,-14
1839,0,0,13,0,-13
1840,1,1,290,1782,1492
1841,1,0,13,0,-13
1842,1,1,484,5478,4994
1843,0,0,4,0,-4
1844,0,0,7,0,-7
1845,1,0,61,0,-61
1846,1,1,510,1267,757
1847,1,1,361,1800,1439
1848,1,1,400,4344,3944
1849,0,0,4,0,-4
1850,1,0,42,0,-42
1851,1,0,39,0,-39
1852,0,0,101,0,-101
1853,0,0,7,0,-7
1854,1,1,73,1439,1366
1855,1,1,422,2437,2015
1856,1,0,23,0,-23
1857,1,1,261,1304,1043
1858,0,0,1,0,-1
1859,0,0,43,0,-43
1860,1,0,36,0,-36
1861,0,0,24,0,-24
1862,0,0,82,0,-82
1863,0,0,5,0,-5
1864,1,0,131,0,-131
1865,1,1,155,1266,1111
1866,1,1,377,1370,993
1867,1,0,83,0,-83
1868,1,1,960,1923,963
1869,1,0,49,0,-49
1870,1,1,694,1557,863
1871,1,1,418,1419,1001
1872,1,0,20,0,-20
1873,1,0,35,0,-35
1874,1,1,468,1550,1082
1875,1,0,85,0,-85
1876,0,0,47,0,-47
1877,0,0,121,0,-121
1878,1,0,87,0,-87
1879,0,0,13,0,-13
1880,1,1,566,1634,1068
1881,0,0,5,0,-5
1882,1,1,168,1729,1561
1883,1,1,484,2049,1565
1884,1,0,148,0,-148
1885,1,1,211,1242,1031
1886,0,0,27,0,-27
1887,1,0,7,0,-7
1888,0,0,12,0,-12
1889,1,0,85,0,-85
1890,0,0,67,0,-67
1891,1,1,734,1384,650
1892,0,0,3,0,-3
1893,1,1,743,1856,1113
1894,1,0,71,0,-71
1895,0,0,63,0,-63
1896,1,1,177,1419,1242
1897,1,1,537,1562,1025
1898,1,0,116,0,-116
1899,0,0,15,0,-15
1900,1,1,1319,1457,138
1901,0,0,4,0,-4
1902,0,0,222,0,-222
1903,1,0,20,0,-20
1904,1,0,79,0,-79
1905,0,0,14,0,-14
1906,1,1,305,1703,1398
1907,1,1,152,1288,1136
1908,0,0,99,0,-99
1909,0,0,83,0,-83
1910,1,1,238,1359,1121
1911,0,0,23,0,-23
1912,1,1,288,1700,1412
1913,1,1,282,1500,1218
1914,1,1,37,1353,1316
1915,0,0,49,0,-49
1916,0,0,150,0,-150
1917,1,1,681,1416,735
1918,0,0,7,0,-7
1919,1,1,490,1540,1050
1920,1,0,26,0,-26
1921,0,0,2,0,-2
1922,1,1,232,1280,1048
1923,1,0,18,0,-18
1924,1,0,34,0,-34
1925,0,0,24,0,-24
1926,0,0,17,0,-17
1927,1,0,73,0,-73
1928,0,0,9,0,-9
1929,0,0,5,0,-5
1930,0,0,38,0,-38
1931,1,1,520,1436,916
1932,1,1,2157,1723,-434
1933,1,1,270,1384,1114
1934,1,0,11,0,-11
1935,0,0,126,0,-126
1936,0,0,0,0,0
1937,1,0,105,0,-105
1938,1,1,169,2002,1833
1939,0,0,21,0,-21
1940,0,0,14,0,-14
1941,1,0,50,0,-50
1942,0,0,65,0,-65
1943,1,0,6,0,-6
1944,1,1,144,1468,1324
1945,0,0,57,0,-57
1946,1,1,830,1462,632
1947,0,0,3,0,-3
1948,1,1,328,1537,1209
1949,1,1,763,1531,768
1950,0,0,95,0,-95
1951,0,0,12,0,-12
1952,1,1,76,2003,1927
1953,1,1,294,1590,1296
1954,0,0,48,0,-48
1955,1,0,4,0,-4
1956,1,0,154,0,-154
1957,0,0,21,0,-21
1958,1,0,50,0,-50
1959,1,1,195,1448,1253
1960,0,0,8,0,-8
1961,0,0,90,0,-90
1962,0,0,13,0,-13
1963,0,0,25,0,-25
1964,1,1,623,1282,659
1965,1,1,1236,1528,292
1966,1,1,1002,1402,400
1967,1,1,386,2170,1784
1968,1,1,835,1833,998
1969,0,0,2,0,-2
1970,0,0,87,0,-87
1971,1,1,800,1286,486
1972,1,0,113,0,-113
1973,1,0,180,0,-180
1974,0,0,54,0,-54
1975,1,1,89,2188,2099
1976,1,1,211,1266,1055
1977,0,0,26,0,-26
1978,0,0,17,0,-17
1979,1,1,429,1236,807
1980,1,0,49,0,-49
1981,0,0,63,0,-63
1982,1,1,601,1282,681
1983,1,0,19,0,-19
1984,0,0,27,0,-27
1985,0,0,17,0,-17
1986,1,1,64,1536,1472
1987,0,0,44,0,-44
1988,0,0,150,0,-150
1989,0,0,34,0,-34
1990,0,0,11,0,-11
1991,1,0,12,0,-12
1992,1,0,7,0,-7
1993,1,1,551,2209,1658
1994,1,1,349,1703,1354
1995,1,1,138,1479,1341
1996,1,1,607,1305,698
1997,0,0,12,0,-12
1998,1,1,1681,1560,-121
1999,0,0,71,0,-71
2000,0,0,30,0,-30
2001,1,1,45,1498,1453
2002,0,0,0,0,0
2003,0,0,8,0,-8
2004,0,0,2,0,-2
2005,0,0,4,0,-4
2006,0,0,90,0,-90
2007,1,0,36,0,-36
2008,0,0,48,0,-48
2009,0,0,85,0,-85
2010,0,0,97,0,-97
2011,1,0,209,0,-209
2012,0,0,88,0,-88
2013,1,1,106,1546,1440
2014,1,0,39,0,-39
2015,0,0,2,0,-2
2016,0,0,78,0,-78
2017,1,1,679,1866,1187
2018,0,0,29,0,-29
2019,1,0,56,0,-56
2020,1,0,43,0,-43
2021,0,0,54,0,-54
2022,1,1,67,1351,1284
2023,1,0,75,0,-75
2024,0,0,59,0,-59
2025,1,0,56,0,-56
2026,0,0,55,0,-55
2027,1,1,1592,1347,-245
2028,1,0,13,0,-13
2029,1,1,307,1357,1050
2030,1,1,1329,1452,123
2031,0,0,5,0,-5
2032,0,0,30,0,-30
2033,0,0,8,0,-8
2034,1,0,139,0,-139
2035,0,0,5,0,-5
2036,1,0,76,0,-76
2037,0,0,40,0,-40
2038,1,0,7,0,-7
2039,1,1,500,1387,887
2040,1,0,146,0,-146
2041,1,1,1058,1262,204
2042,1,0,55,0,-55
2043,1,1,28,1507,1479
2044,0,0,20,0,-20
2045,1,0,82,0,-82
2046,1,1,255,2239,1984
2047,1,1,365,2004,1639
2048,1,1,113,1313,1200
2049,1,0,28,0,-28
2050,0,0,75,0,-75
2051,0,0,26,0,-26
2052,1,1,125,1702,1577
2053,0,0,10,0,-10
2054,1,1,806,1309,503
2055,1,1,731,1540,809
2056,1,1,230,2384,2154
2057,1,1,58,1669,1611
2058,1,0,54,0,-54
2059,1,0,76,0,-76
2060,0,0,12,0,-12
2061,1,1,133,1773,1640
2062,0,0,8,0,-8
2063,1,1,561,1376,815
2064,0,0,26,0,-26
2065,1,0,68,0,-68
2066,0,0,49,0,-49
2067,0,0,38,0,-38
2068,1,0,9,0,-9
2069,0,0,211,0,-211
2070,0,0,1,0,-1
2071,0,0,23,0,-23
2072,0,0,19,0,-19
2073,1,0,51,0,-51
2074,1,0,53,0,-53
2075,0,0,81,0,-81
2076,1,0,39,0,-39
2077,1,0,11,0,-11
2078,1,1,313,1260,947
2079,1,0,34,0,-34
2080,1,1,13,1254,1241
2081,1,0,4,0,-4
2082,1,1,1757,1637,-120
2083,0,0,22,0,-22
2084,1,1,145,1863,1718
2085,1,1,168,3184,3016
2086,1,0,10,0,-10
2087,1,1,428,1311,883
2088,0,0,9,0,-9
2089,1,1,648,1611,963
2090,0,0,8,0,-8
2091,1,1,730,2214,1484
2092,1,0,10,0,-10
2093,1,0,58,0,-58
2094,1,1,1277,5161,3884
2095,0,0,189,0,-189
2096,1,0,37,0,-37
2097,0,0,67,0,-67
2098,1,1,157,1247,1090
2099,1,1,106,1367,1261
2100,0,0,336,0,-336
2101,1,1,103,1347,1244
2102,0,0,77,0,-77
2103,1,0,60,0,-60
2104,0,0,53,0,-53
2105,1,0,54,0,-54
2106,1,1,804,1462,658
2107,0,0,100,0,-100
2108,1,0,171,0,-171
2109,0,0,56,0,-56
2110,0,0,63,0,-63
2111,1,0,12,0,-12
2112,1,1,179,1357,1178
2113,1,1,491,1487,996
2114,0,0,75,0,-75
2115,1,0,5,0,-5
2116,0,0,14,0,-14
2117,1,1,543,1462,919
2118,0,0,79,0,-79
2119,1,1,643,1543,900
2120,1,0,49,0,-49
2121,1,0,76,0,-76
2122,1,0,16,0,-16
2123,1,0,17,0,-17
2124,1,1,89,2155,2066
2125,0,0,242,0,-242
2126,0,0,55,0,-55
2127,1,0,82,0,-82
2128,1,1,343,2790,2447
2129,1,0,51,0,-51
2130,1,0,12,0,-12
2131,1,0,7,0,-7
2132,1,0,10,0,-10
2133,1,0,29,0,-29
2134,1,0,46,0,-46
2135,1,0,114,0,-114
2136,0,0,2,0,-2
2137,1,1,686,1237,551
2138,1,1,524,1659,1135
2139,1,1,100,3693,3593
2140,1,0,127,0,-127
2141,0,0,29,0,-29
2142,0,0,55,0,-55
2143,0,0,17,0,-17
2144,0,0,28,0,-28
2145,0,0,71,0,-71
2146,1,0,5,0,-5
2147,1,1,147,2604,2457
2148,0,0,47,0,-47
2149,1,0,34,0,-34
2150,0,0,54,0,-54
2151,0,0,109,0,-109
2152,1,0,156,0,-156
2153,1,1,594,1585,991
2154,1,1,978,1548,570
2155,0,0,7,0,-7
2156,0,0,108,0,-108
2157,1,1,1057,1824,767
2158,0,0,45,0,-45
2159,0,0,39,0,-39
2160,0,0,2,0,-2
2161,1,0,17,0,-17
2162,1,1,870,2968,2098
2163,1,1,1223,1343,120
2164,1,0,13,0,-13
2165,1,0,30,0,-30
2166,0,0,0,0,0
2167,1,1,680,1581,901
2168,0,0,12,0,-12
2169,1,0,26,0,-26
2170,0,0,5,0,-5
2171,0,0,20,0,-20
2172,0,0,61,0,-61
2173,1,0,1,0,-1
2174,1,0,52,0,-52
2175,1,1,896,1955,1059
2176,0,0,17,0,-17
2177,0,0,21,0,-21
2178,1,1,472,2013,1541
2179,0,0,88,0,-88
2180,0,0,82,0,-82
2181,0,0,12,0,-12
2182,1,1,248,1665,1417
2183,1,0,44,0,-44
2184,1,1,391,1279,888
2185,1,0,26,0,-26
2186,1,0,88,0,-88
2187,1,1,270,1830,1560
2188,1,0,11,0,-11
2189,0,0,79,0,-79
2190,1,0,263,0,-263
2191,1,0,97,0,-97
2192,0,0,2,0,-2
2193,1,1,405,1566,1161
2194,1,0,32,0,-32
2195,0,0,0,0,0
2196,0,0,3,0,-3
2197,1,0,8,0,-8
2198,0,0,51,0,-51
2199,0,0,0,0,0
2200,0,0,1,0,-1
2201,1,0,24,0,-24
2202,1,1,488,1360,872
2203,1,1,269,1685,1416
2204,1,0,48,0,-48
2205,1,1,948,2419,1471
2206,1,1,499,1275,776
2207,0,0,10,0,-10
2208,1,0,2,0,-2
2209,0,0,52,0,-52
2210,0,0,11,0,-11
2211,0,0,6,0,-6
2212,0,0,27,0,-27
2213,1,1,465,1876,1411
2214,0,0,20,0,-20
2215,1,0,1,0,-1
2216,1,0,59,0,-59
2217,1,0,7,0,-7
2218,1,0,48,0,-48
2219,1,0,29,0,-29
2220,0,0,0,0,0
2221,1,0,3,0,-3
2222,1,1,482,1544,1062
2223,0,0,93,0,-93
2224,1,1,92,1619,1527
2225,0,0,69,0,-69
2226,1,0,13,0,-13
2227,1,1,1633,1421,-212
2228,1,0,53,0,-53
2229,1,1,177,1511,1334
2230,1,1,912,1285,373
2231,0,0,160,0,-160
2232,1,0,64,0,-64
2233,1,1,244,1386,1142
2234,1,0,27,0,-27
2235,1,1,149,3183,3034
2236,1,1,997,1640,643
2237,1,0,0,0,0
2238,1,0,78,0,-78
2239,1,1,846,1783,937
2240,1,0,31,0,-31
2241,0,0,57,0,-57
2242,1,1,1022,1410,388
2243,1,0,10,0,-10
2244,1,0,48,0,-48
2245,0,0,5,0,-5
2246,1,0,24,0,-24
2247,0,0,4,0,-4
2248,1,0,14,0,-14
2249,0,0,58,0,-58
2250,1,1,70,1276,1206
2251,0,0,28,0,-28
2252,1,1,188,1302,1114
2253,1,0,14,0,-14
2254,1,0,38,0,-38
2255,0,0,8,0,-8
2256,1,1,804,1322,518
2257,1,0,103,0,-103
2258,1,1,1216,1355,139
2259,0,0,16,0,-16
2260,0,0,5,0,-5
2261,1,1,274,1529,1255
2262,1,0,49,0,-49
2263,0,0,26,0,-26
2264,1,1,1268,1248,-20
2265,0,0,27,0,-27
2266,1,0,69,0,-69
2267,1,0,109,0,-109
2268,1,0,70,0,-70
2269,1,0,110,0,-110
2270,0,0,50,0,-50
2271,1,0,2,0,-2
2272,1,1,581,2175,1594
2273,1,1,54,1278,1224
2274,0,0,69,0,-69
2275,1,0,102,0,-102
2276,1,0,90,0,-90
2277,1,0,55,0,-55
2278,1,0,37,0,-37
2279,1,0,11,0,-11
2280,0,0,49,0,-49
2281,1,1,681,1807,1126
2282,1,0,13,0,-13
2283,0,0,2,0,-2
2284,1,0,18,0,-18
2285,0,0,9,0,-9
2286,1,0,53,0,-53
2287,1,1,1021,1457,436
2288,1,0,17,0,-17
2289,1,0,28,0,-28
2290,1,0,0,0,0
2291,0,0,0,0,0
2292,1,1,992,1512,520
2293,0,0,1,0,-1
2294,0,0,29,0,-29
2295,0,0,34,0,-34
2296,1,1,145,1500,1355
2297,1,0,4,0,-4
2298,0,0,10,0,-10
2299,1,0,3,0,-3
2300,1,0,20,0,-20
2301,1,0,2,0,-2
2302,1,1,905,1290,385
2303,0,0,16,0,-16
2304,1,1,1222,1326,104
2305,0,0,61,0,-61
2306,0,0,32,0,-32
2307,1,0,39,0,-39
2308,0,0,73,0,-73
2309,1,0,12,0,-12
2310,0,0,6,0,-6
2311,1,1,159,3064,2905
2312,0,0,1,0,-1
2313,0,0,10,0,-10
2314,1,0,67,0,-67
2315,1,0,49,0,-49
2316,1,1,1818,1458,-360
2317,1,0,4,0,-4
2318,1,1,97,1266,1169
2319,1,1,210,3409,3199
2320,0,0,92,0,-92
2321,0,0,17,0,-17
2322,1,1,919,1627,708
2323,1,0,1,0,-1
2324,1,0,0,0,0
2325,1,1,573,1478,905
2326,0,0,6,0,-6
2327,1,0,29,0,-29
2328,1,1,1041,1443,402
2329,1,0,3,0,-3
2330,0,0,3,0,-3
2331,1,1,46,1337,1291
2332,0,0,19,0,-19
2333,1,0,117,0,-117
2334,1,1,21,1249,1228
2335,0,0,4,0,-4
2336,1,0,36,0,-36
2337,1,0,5,0,-5
2338,1,0,6,0,-6
2339,1,1,658,2046,1388
2340,1,1,107,1250,1143
2341,0,0,0,0,0
2342,1,0,137,0,-137
2343,1,0,62,0,-62
2344,1,1,1150,1336,186
2345,1,1,898,1402,504
2346,0,0,39,0,-39
2347,1,0,74,0,-74
2348,0,0,1,0,-1
2349,0,0,14,0,-14
2350,1,1,354,1710,1356
2351,1,0,49,0,-49
2352,0,0,247,0,-247
2353,1,0,11,0,-11
2354,1,1,145,1714,1569
2355,0,0,125,0,-125
2356,0,0,44,0,-44
2357,0,0,24,0,-24
2358,0,0,22,0,-22
2359,1,0,17,0,-17
2360,1,1,109,1316,1207
2361,1,1,96,1348,1252
2362,1,1,112,1431,1319
2363,1,1,115,1487,1372
2364,0,0,122,0,-122
2365,1,0,12,0,-12
2366,0,0,51,0,-51
2367,0,0,58,0,-58
2368,1,0,66,0,-66
2369,1,0,76,0,-76
2370,0,0,50,0,-50
2371,1,0,101,0,-101
2372,1,0,37,0,-37
2373,1,1,869,1828,959
2374,0,0,174,0,-174
2375,0,0,72,0,-72
2376,1,1,360,1362,1002
2377,0,0,39,0,-39
2378,1,1,204,1641,1437
2379,0,0,37,0,-37
2380,0,0,22,0,-22
2381,0,0,89,0,-89
2382,1,1,361,1609,1248
2383,1,1,596,1260,664
2384,0,0,120,0,-120
2385,1,0,39,0,-39
2386,0,0,18,0,-18
2387,0,0,184,0,-184
2388,1,1,291,1563,1272
2389,1,1,791,1301,510
2390,1,0,6,0,-6
2391,1,1,458,1768,1310
2392,1,0,53,0,-53
2393,1,1,438,1939,1501
2394,1,0,9,0,-9
2395,0,0,51,0,-51
2396,0,0,116,0,-116
2397,1,1,419,1328,909
2398,1,0,15,0,-15
2399,1,0,36,0,-36
2400,0,0,104,0,-104
2401,0,0,14,0,-14
2402,1,1,217,1394,1177
2403,0,0,104,0,-104
2404,0,0,98,0,-98
2405,0,0,28,0,-28
2406,1,0,5,0,-5
2407,1,0,33,0,-33
2408,1,0,26,0,-26
2409,0,0,67,0,-67
2410,1,0,32,0,-32
2411,0,0,36,0,-36
2412,0,0,9,0,-9
2413,1,1,417,1806,1389
2414,1,0,52,0,-52
2415,1,1,416,1411,995
2416,1,1,55,4720,4665
2417,1,0,19,0,-19
2418,1,1,1162,1301,139
2419,0,0,127,0,-127
2420,1,1,894,1578,684
2421,1,0,120,0,-120
2422,0,0,61,0,-61
2423,0,0,8,0,-8
2424,0,0,71,0,-71
2425,1,0,159,0,-159
2426,0,0,21,0,-21
2427,1,0,17,0,-17
2428,0,0,48,0,-48
2429,1,1,813,1369,556
2430,0,0,1,0,-1
2431,1,1,1043,1674,631
2432,1,1,168,1419,1251
2433,1,1,78,1878,1800
2434,1,0,13,0,-13
2435,1,0,14,0,-14
2436,0,0,21,0,-21
2437,1,0,20,0,-20
2438,1,0,37,0,-37
2439,1,0,21,0,-21
2440,0,0,105,0,-105
2441,0,0,21,0,-21
2442,0,0,29,0,-29
2443,1,0,14,0,-14
2444,1,1,693,1523,830
2445,1,1,427,1407,980
2446,1,1,196,1401,1205
2447,0,0,27,0,-27
2448,0,0,69,0,-69
2449,1,0,8,0,-8
2450,0,0,24,0,-24
2451,1,0,30,0,-30
2452,1,0,6,0,-6
2453,1,0,28,0,-28
2454,0,0,34,0,-34
2455,0,0,25,0,-25
2456,1,0,136,0,-136
2457,0,0,2,0,-2
2458,0,0,24,0,-24
2459,0,0,7,0,-7
2460,0,0,91,0,-91
2461,0,0,4,0,-4
2462,1,0,63,0,-63
2463,1,1,889,1507,618
2464,1,1,140,1316,1176
2465,1,1,143,1270,1127
2466,1,0,19,0,-19
2467,0,0,80,0,-80
2468,1,0,40,0,-40
2469,1,1,74,1357,1283
2470,1,1,435,1418,983
2471,1,1,663,1241,578
2472,0,0,147,0,-147
2473,0,0,18,0,-18
2474,1,1,82,1309,1227
2475,0,0,56,0,-56
2476,0,0,8,0,-8
2477,1,0,17,0,-17
2478,1,1,91,1311,1220
2479,1,1,226,2626,2400
2480,1,0,69,0,-69
2481,0,0,0,0,0
2482,0,0,21,0,-21
2483,1,1,151,1432,1281
2484,1,1,346,1487,1141
2485,1,1,891,1406,515
2486,0,0,62,0,-62
2487,1,0,34,0,-34
2488,1,0,27,0,-27
2489,0,0,38,0,-38
2490,0,0,84,0,-84
2491,0,0,55,0,-55
2492,0,0,11,0,-11
2493,0,0,183,0,-183
2494,1,0,83,0,-83
2495,0,0,54,0,-54
2496,0,0,35,0,-35
2497,1,0,68,0,-68
2498,1,1,278,1995,1717
2499,1,1,976,1855,879
2500,1,0,10,0,-10
2501,1,0,12,0,-12
2502,1,1,956,1758,802
2503,1,0,37,0,-37
2504,0,0,94,0,-94
2505,1,1,229,1656,1427
2506,1,1,1824,1575,-249
2507,1,0,31,0,-31
2508,1,0,28,0,-28
2509,0,0,27,0,-27
2510,0,0,51,0,-51
2511,1,0,51,0,-51
2512,1,1,444,1344,900
2513,1,0,159,0,-159
2514,1,1,423,1599,1176
2515,0,0,27,0,-27
2516,0,0,62,0,-62
2517,0,0,124,0,-124
2518,0,0,78,0,-78
2519,1,0,33,0,-33
2520,0,0,165,0,-165
2521,0,0,6,0,-6
2522,1,0,53,0,-53
2523,0,0,31,0,-31
2524,1,1,186,1697,1511
2525,1,0,23,0,-23
2526,0,0,13,0,-13
2527,1,1,97,1526,1429
2528,0,0,61,0,-61
2529,0,0,96,0,-96
2530,1,1,157,2032,1875
2531,0,0,40,0,-40
2532,0,0,27,0,-27
2533,1,0,1,0,-1
2534,0,0,7,0,-7
2535,1,1,55,1304,1249
2536,1,1,730,3471,2741
2537,0,0,98,0,-98
2538,0,0,19,0,-19
2539,1,1,370,1468,1098
2540,1,0,26,0,-26
2541,0,0,64,0,-64
2542,1,0,169,0,-169
2543,1,0,50,0,-50
2544,1,0,24,0,-24
2545,1,1,191,1409,1218
2546,1,0,27,0,-27
2547,1,0,167,0,-167
2548,0,0,41,0,-41
2549,1,1,107,1828,1721
2550,1,1,398,1360,962
2551,1,1,1450,1700,250
2552,1,1,138,1303,1165
2553,0,0,39,0,-39
2554,1,0,16,0,-16
2555,1,1,672,1522,850
2556,1,0,13,0,-13
2557,0,0,111,0,-111
2558,1,0,177,0,-177
2559,1,0,12,0,-12
2560,0,0,22,0,-22
2561,1,1,288,1516,1228
2562,1,1,98,1401,1303
2563,1,1,66,2901,2835
2564,1,0,6,0,-6
2565,0,0,12,0,-12
2566,1,0,2,0,-2
2567,1,0,24,0,-24
2568,1,0,7,0,-7
2569,0,0,40,0,-40
2570,0,0,35,0,-35
2571,0,0,184,0,-184
2572,1,1,386,1850,1464
2573,1,1,1295,1287,-8
2574,1,1,446,1350,904
2575,1,0,1,0,-1
2576,1,0,49,0,-49
2577,1,0,1,0,-1
2578,1,1,375,1493,1118
2579,0,0,159,0,-159
2580,0,0,109,0,-109
2581,0,0,36,0,-36
2582,1,1,454,1491,1037
2583,0,0,25,0,-25
2584,1,1,53,1514,1461
2585,0,0,164,0,-164
2586,1,0,79,0,-79
2587,0,0,29,0,-29
2588,1,0,63,0,-63
2589,1,0,57,0,-57
2590,1,1,1061,1495,434
2591,1,0,235,0,-235
2592,0,0,81,0,-81
2593,0,0,80,0,-80
2594,1,0,6,0,-6
2595,1,0,47,0,-47
2596,0,0,56,0,-56
2597,1,0,82,0,-82
2598,0,0,48,0,-48
2599,1,1,486,1937,1451
2600,1,0,110,0,-110
2601,0,0,36,0,-36
2602,1,0,8,0,-8
2603,1,0,64,0,-64
2604,0,0,151,0,-151
2605,1,0,60,0,-60
2606,0,0,100,0,-100
2607,0,0,39,0,-39
2608,1,0,36,0,-36
2609,1,0,14,0,-14
2610,1,0,9,0,-9
2611,0,0,49,0,-49
2612,1,1,977,2481,1504
2613,0,0,26,0,-26
2614,1,0,9,0,-9
2615,0,0,52,0,-52
2616,1,1,636,2199,1563
2617,1,1,901,1478,577
2618,1,0,1,0,-1
2619,1,0,21,0,-21
2620,0,0,31,0,-31
2621,0,0,37,0,-37
2622,1,0,44,0,-44
2623,1,0,76,0,-76
2624,1,1,377,1474,1097
2625,1,0,41,0,-41
2626,1,0,1,0,-1
2627,1,0,14,0,-14
2628,1,0,79,0,-79
2629,0,0,33,0,-33
2630,1,1,399,1482,1083
2631,0,0,0,0,0
2632,1,0,48,0,-48
2633,1,0,16,0,-16
2634,0,0,41,0,-41
2635,1,0,120,0,-120
2636,1,0,52,0,-52
2637,1,1,790,1334,544
2638,0,0,5,0,-5
2639,1,1,689,1363,674
2640,1,1,1357,1679,322
2641,1,1,192,1369,1177
2642,0,0,99,0,-99
2643,0,0,60,0,-60
2644,0,0,7,0,-7
2645,1,0,50,0,-50
2646,1,0,14,0,-14
2647,1,0,70,0,-70
2648,1,1,195,1243,1048
2649,0,0,16,0,-16
2650,1,0,8,0,-8
2651,1,1,129,1337,1208
2652,0,0,38,0,-38
2653,1,1,341,1518,1177
2654,1,1,478,1317,839
2655,0,0,21,0,-21
2656,1,1,247,1313,1066
2657,1,1,590,1846,1256
2658,1,0,31,0,-31
2659,1,1,552,1405,853
2660,0,0,14,0,-14
2661,1,0,53,0,-53
2662,1,1,117,1368,1251
2663,0,0,70,0,-70
2664,1,1,531,1303,772
2665,1,1,183,3456,3273
2666,1,1,329,1576,1247
2667,0,0,55,0,-55
2668,0,0,126,0,-126
2669,1,1,1068,1430,362
2670,1,1,450,1927,1477
2671,1,1,86,1281,1195
2672,0,0,11,0,-11
2673,1,1,362,2289,1927
2674,0,0,52,0,-52
2675,1,0,97,0,-97
2676,1,0,91,0,-91
2677,1,1,1361,1396,35
2678,0,0,26,0,-26
2679,1,1,343,2193,1850
2680,0,0,117,0,-117
2681,1,0,64,0,-64
2682,0,0,3,0,-3
2683,1,1,347,1479,1132
2684,1,1,63,1363,1300
2685,1,1,144,1349,1205
2686,0,0,39,0,-39
2687,1,0,10,0,-10
2688,0,0,113,0,-113
2689,1,0,36,0,-36
2690,1,0,59,0,-59
2691,1,1,514,1243,729
2692,1,1,891,1641,750
2693,0,0,54,0,-54
2694,0,0,0,0,0
2695,0,0,1,0,-1
2696,1,0,101,0,-101
2697,1,0,56,0,-56
2698,1,1,241,1555,1314
2699,0,0,43,0,-43
2700,0,0,73,0,-73
2701,0,0,37,0,-37
2702,0,0,2,0,-2
2703,0,0,35,0,-35
2704,1,1,105,1373,1268
2705,1,0,77,0,-77
2706,1,1,20,1339,1319
2707,1,0,6,0,-6
2708,0,0,129,0,-129
2709,1,1,934,1236,302
2710,1,1,638,2068,1430
2711,1,1,864,1453,589
2712,0,0,6,0,-6
2713,0,0,68,0,-68
2714,0,0,45,0,-45
2715,1,1,282,1437,1155
2716,1,1,75,1344,1269
2717,0,0,42,0,-42
2718,1,0,179,0,-179
2719,1,0,73,0,-73
2720,0,0,52,0,-52
2721,1,1,39,1656,1617
2722,1,1,1349,4005,2656
2723,0,0,152,0,-152
2724,1,1,1567,1479,-88
2725,1,0,88,0,-88
2726,1,1,435,1246,811
2727,1,0,84,0,-84
2728,1,1,217,1894,1677
2729,1,0,57,0,-57
2730,1,0,43,0,-43
2731,0,0,147,0,-147
2732,0,0,20,0,-20
2733,1,1,476,1888,1412
2734,0,0,2,0,-2
2735,0,0,46,0,-46
2736,0,0,40,0,-40
2737,1,0,45,0,-45
2738,0,0,80,0,-80
2739,0,0,12,0,-12
2740,1,1,1580,1367,-213
2741,1,1,561,2196,1635
2742,1,1,811,3809,2998
2743,1,1,166,1399,1233
2744,1,1,717,2193,1476
2745,0,0,26,0,-26
2746,0,0,25,0,-25
2747,1,1,283,1742,1459
2748,0,0,60,0,-60
2749,1,1,64,1550,1486
2750,0,0,241,0,-241
2751,1,1,352,1318,966
2752,1,0,31,0,-31
2753,0,0,113,0,-113
2754,1,0,10,0,-10
2755,1,0,44,0,-44
2756,1,1,5,2014,2009
2757,1,0,12,0,-12
2758,1,0,4,0,-4
2759,0,0,102,0,-102
2760,0,0,17,0,-17
2761,1,0,43,0,-43
2762,0,0,87,0,-87
2763,1,1,383,1317,934
2764,1,0,26,0,-26
2765,1,1,188,1745,1557
2766,0,0,1,0,-1
2767,1,0,33,0,-33
2768,0,0,42,0,-42
2769,1,0,28,0,-28
2770,0,0,5,0,-5
2771,0,0,7,0,-7
2772,0,0,97,0,-97
2773,0,0,6,0,-6
2774,1,0,24,0,-24
2775,0,0,126,0,-126
2776,1,0,2,0,-2
2777,0,0,99,0,-99
2778,1,0,73,0,-73
2779,0,0,15,0,-15
2780,0,0,54,0,-54
2781,0,0,114,0,-114
2782,1,0,20,0,-20
2783,1,0,9,0,-9
2784,1,1,646,1375,729
2785,0,0,22,0,-22
2786,0,0,26,0,-26
2787,1,0,132,0,-132
2788,1,1,506,1653,1147
2789,1,0,22,0,-22
2790,1,1,954,1385,431
2791,1,0,50,0,-50
2792,0,0,36,0,-36
2793,0,0,60,0,-60
2794,0,0,19,0,-19
2795,1,1,249,1363,1114
2796,1,0,33,0,-33
2797,1,1,1249,2172,923
2798,0,0,8,0,-8
2799,1,1,123,1564,1441
2800,1,0,41,0,-41
2801,1,0,33,0,-33
2802,0,0,67,0,-67
2803,0,0,130,0,-130
2804,0,0,18,0,-18
2805,0,0,16,0,-16
2806,1,0,11,0,-11
2807,0,0,53,0,-53
2808,1,0,41,0,-41
2809,0,0,8,0,-8
2810,1,0,60,0,-60
2811,1,1,239,2028,1789
2812,0,0,17,0,-17
2813,0,0,37,0,-37
2814,1,1,893,1896,1003
2815,0,0,16,0,-16
2816,1,0,131,0,-131
2817,0,0,50,0,-50
2818,1,0,40,0,-40
2819,0,0,29,0,-29
2820,1,1,1874,2038,164
2821,1,0,52,0,-52
2822,1,0,39,0,-39
2823,0,0,12,0,-12
2824,1,1,1385,1610,225
2825,0,0,30,0,-30
2826,1,0,119,0,-119
2827,0,0,79,0,-79
2828,1,0,83,0,-83
2829,1,1,428,2286,1858
2830,1,0,22,0,-22
2831,1,0,78,0,-78
2832,0,0,11,0,-11
2833,0,0,28,0,-28
2834,1,1,1268,1324,56
2835,1,0,104,0,-104
2836,0,0,48,0,-48
2837,1,0,23,0,-23
2838,1,0,84,0,-84
2839,1,0,72,0,-72
2840,1,1,1124,4531,3407
2841,0,0,26,0,-26
2842,1,1,238,1497,1259
2843,1,1,177,2071,1894
2844,0,0,45,0,-45
2845,0,0,21,0,-21
2846,0,0,7,0,-7
2847,1,0,51,0,-51
2848,0,0,62,0,-62
2849,1,1,940,2275,1335
2850,1,0,99,0,-99
2851,1,0,138,0,-138
2852,1,0,79,0,-79
2853,1,0,20,0,-20
2854,0,0,111,0,-111
2855,1,1,245,2045,1800
2856,0,0,42,0,-42
2857,1,0,47,0,-47
2858,1,1,247,1250,1003
2859,0,0,3,0,-3
2860,1,1,450,1359,909
2861,1,0,1,0,-1
2862,1,1,691,1511,820
2863,0,0,30,0,-30
2864,1,1,116,1297,1181
2865,0,0,15,0,-15
2866,0,0,76,0,-76
2867,0,0,4,0,-4
2868,0,0,81,0,-81
2869,0,0,146,0,-146
2870,0,0,23,0,-23
2871,1,0,23,0,-23
2872,1,0,13,0,-13
2873,0,0,115,0,-115
2874,1,1,582,2089,1507
2875,1,1,164,1476,1312
2876,0,0,164,0,-164
2877,1,0,58,0,-58
2878,1,1,1330,1496,166
2879,1,1,359,6701,6342
2880,0,0,22,0,-22
2881,1,0,19,0,-19
2882,1,1,106,1487,1381
2883,0,0,56,0,-56
2884,1,1,282,1434,1152
2885,1,0,42,0,-42
2886,0,0,8,0,-8
2887,0,0,60,0,-60
2888,1,0,112,0,-112
2889,1,1,93,1801,1708
2890,0,0,56,0,-56
2891,1,0,138,0,-138
2892,0,0,20,0,-20
2893,0,0,15,0,-15
2894,0,0,34,0,-34
2895,1,0,45,0,-45
2896,0,0,155,0,-155
2897,0,0,174,0,-174
2898,1,1,227,1718,1491
2899,1,1,562,1393,831
2900,1,1,1083,1316,233
2901,1,1,523,1450,927
2902,0,0,202,0,-202
2903,0,0,60,0,-60
2904,1,1,1137,2842,1705
2905,1,1,140,1513,1373
2906,0,0,224,0,-224
2907,1,0,19,0,-19
2908,1,1,209,1416,1207
2909,0,0,16,0,-16
2910,1,0,12,0,-12
2911,1,0,46,0,-46
2912,1,0,103,0,-103
2913,1,1,161,1769,1608
2914,1,1,263,1461,1198
2915,1,0,58,0,-58
2916,0,0,0,0,0
2917,0,0,87,0,-87
2918,1,1,791,1722,931
2919,0,0,38,0,-38
2920,1,0,56,0,-56
2921,1,1,127,1887,1760
2922,0,0,18,0,-18
2923,0,0,53,0,-53
2924,0,0,97,0,-97
2925,0,0,173,0,-173
2926,0,0,40,0,-40
2927,0,0,2,0,-2
2928,1,0,77,0,-77
2929,1,0,98,0,-98
2930,1,1,2432,1296,-1136
2931,0,0,85,0,-85
2932,0,0,65,0,-65
2933,1,1,1564,1717,153
2934,0,0,159,0,-159
2935,1,1,803,2122,1319
2936,1,0,1,0,-1
2937,0,0,49,0,-49
2938,1,0,1,0,-1
2939,1,0,1,0,-1
2940,1,1,795,1481,686
2941,1,0,90,0,-90
2942,0,0,41,0,-41
2943,1,0,62,0,-62
2944,0,0,6,0,-6
2945,1,0,18,0,-18
2946,0,0,34,0,-34
2947,0,0,44,0,-44
2948,1,0,6,0,-6
2949,1,0,9,0,-9
2950,0,0,13,0,-13
2951,0,0,50,0,-50
2952,1,0,0,0,0
2953,1,1,1264,1253,-11
2954,1,0,5,0,-5
2955,1,1,359,1482,1123
2956,0,0,56,0,-56
2957,1,1,647,1406,759
2958,1,1,191,1669,1478
2959,0,0,82,0,-82
2960,0,0,60,0,-60
2961,1,0,99,0,-99
2962,1,0,30,0,-30
2963,1,1,152,3028,2876
2964,1,1,361,1285,924
2965,1,0,22,0,-22
2966,1,0,20,0,-20
2967,1,0,46,0,-46
2968,0,0,2,0,-2
2969,1,0,12,0,-12
2970,1,0,24,0,-24
2971,0,0,33,0,-33
2972,1,1,131,1636,1505
2973,1,1,470,1516,1046
2974,1,0,47,0,-47
2975,0,0,82,0,-82
2976,0,0,26,0,-26
2977,0,0,3,0,-3
2978,1,0,113,0,-113
2979,1,0,14,0,-14
2980,1,1,256,1326,1070
2981,0,0,72,0,-72
2982,1,0,29,0,-29
2983,1,1,631,2013,1382
2984,0,0,70,0,-70
2985,1,1,372,1242,870
2986,1,1,493,1595,1102
2987,1,1,889,1579,690
2988,0,0,38,0,-38
2989,1,0,27,0,-27
2990,1,1,398,1252,854
2991,1,0,14,0,-14
2992,1,1,140,1255,1115
2993,0,0,45,0,-45
2994,0,0,16,0,-16
2995,0,0,6,0,-6
2996,1,0,50,0,-50
2997,1,1,98,1700,1602
2998,1,1,176,1498,1322
2999,1,0,85,0,-85
3000,1,1,27,2509,2482
3001,0,0,33,0,-33
3002,0,0,38,0,-38
3003,0,0,77,0,-77
3004,1,1,1726,2541,815
3005,1,0,18,0,-18
3006,0,0,15,0,-15
3007,1,0,55,0,-55
3008,0,0,45,0,-45
3009,1,0,30,0,-30
3010,0,0,232,0,-232
3011,1,1,603,2415,1812
3012,0,0,188,0,-188
3013,1,0,67,0,-67
3014,0,0,9,0,-9
3015,0,0,10,0,-10
3016,1,1,475,1415,940
3017,0,0,7,0,-7
3018,0,0,131,0,-131
3019,1,0,40,0,-40
3020,1,1,446,1255,809
3021,0,0,39,0,-39
3022,1,0,9,0,-9
3023,1,1,465,1289,824
3024,1,0,14,0,-14
3025,0,0,59,0,-59
3026,1,0,59,0,-59
3027,1,0,24,0,-24
3028,1,1,130,1293,1163
3029,0,0,18,0,-18
3030,1,1,1189,1445,256
3031,1,1,81,1387,1306
3032,1,0,65,0,-65
3033,1,1,678,1402,724
3034,1,0,59,0,-59
3035,0,0,212,0,-212
3036,1,1,199,2601,2402
3037,0,0,17,0,-17
3038,1,1,1096,1595,499
3039,0,0,40,0,-40
3040,0,0,14,0,-14
3041,1,1,376,1261,885
3042,1,0,31,0,-31
3043,0,0,38,0,-38
3044,1,0,16,0,-16
3045,1,1,628,1308,680
3046,1,0,71,0,-71
3047,0,0,10,0,-10
3048,0,0,13,0,-13
3049,0,0,29,0,-29
3050,1,1,1412,1365,-47
3051,0,0,165,0,-165
3052,0,0,0,0,0
3053,0,0,5,0,-5
3054,1,0,89,0,-89
3055,0,0,78,0,-78
3056,0,0,51,0,-51
3057,1,1,217,1502,1285
3058,0,0,15,0,-15
3059,1,1,278,3672,3394
3060,1,1,141,1290,1149
3061,1,1,566,1613,1047
3062,1,0,61,0,-61
3063,0,0,11,0,-11
3064,1,1,146,1516,1370
3065,1,0,23,0,-23
3066,1,1,530,1291,761
3067,1,1,100,1667,1567
3068,0,0,16,0,-16
3069,1,1,1143,1351,208
3070,1,1,359,1352,993
3071,0,0,47,0,-47
3072,1,0,13,0,-13
3073,0,0,85,0,-85
3074,1,0,77,0,-77
3075,1,1,359,1283,924
3076,0,0,117,0,-117
3077,0,0,133,0,-133
3078,1,0,45,0,-45
3079,1,1,37,1447,1410
3080,1,1,117,1380,1263
3081,1,0,108,0,-108
3082,0,0,206,0,-206
3083,0,0,109,0,-109
3084,1,1,916,1255,339
3085,0,0,9,0,-9
3086,1,1,442,1613,1171
3087,1,1,1057,1626,569
3088,0,0,140,0,-140
3089,0,0,1,0,-1
3090,1,0,42,0,-42
3091,0,0,52,0,-52
3092,0,0,134,0,-134
3093,0,0,2,0,-2
3094,1,0,16,0,-16
3095,1,0,23,0,-23
3096,1,0,113,0,-113
3097,1,1,320,1263,943
3098,1,0,42,0,-42
3099,0,0,22,0,-22
3100,0,0,22,0,-22
3101,1,1,761,1262,501
3102,0,0,5,0,-5
3103,0,0,35,0,-35
3104,0,0,193,0,-193
3105,0,0,348,0,-348
3106,1,1,2128,1400,-728
3107,0,0,63,0,-63
3108,0,0,11,0,-11
3109,1,1,337,1447,1110
3110,1,0,124,0,-124
3111,1,1,525,1311,786
3112,1,0,52,0,-52
3113,1,0,71,0,-71
3114,1,1,64,1740,1676
3115,0,0,98,0,-98
3116,0,0,50,0,-50
3117,1,1,441,1555,1114
3118,1,0,19,0,-19
3119,1,0,11,0,-11
3120,1,0,155,0,-155
3121,1,0,19,0,-19
3122,0,0,49,0,-49
3123,1,1,166,2461,2295
3124,1,0,87,0,-87
3125,1,0,111,0,-111
3126,1,0,4,0,-4
3127,0,0,32,0,-32
3128,0,0,58,0,-58
3129,1,0,112,0,-112
3130,1,1,1324,1582,258
3131,1,1,47,1737,1690
3132,1,1,780,1452,672
3133,0,0,24,0,-24
3134,0,0,15,0,-15
3135,1,1,60,1241,1181
3136,0,0,42,0,-42
3137,0,0,108,0,-108
3138,1,0,12,0,-12
3139,1,1,960,1307,347
3140,1,0,10,0,-10
3141,1,1,275,1258,983
3142,0,0,108,0,-108
3143,1,1,601,1809,1208
3144,1,1,572,1399,827
3145,1,0,28,0,-28
3146,1,0,134,0,-134
3147,1,0,108,0,-108
3148,0,0,6,0,-6
3149,1,1,335,1414,1079
3150,1,0,21,0,-21
3151,1,0,252,0,-252
3152,0,0,69,0,-69
3153,1,0,51,0,-51
3154,0,0,49,0,-49
3155,1,1,152,2173,2021
3156,1,0,88,0,-88
3157,0,0,22,0,-22
3158,0,0,17,0,-17
3159,1,0,12,0,-12
3160,1,0,37,0,-37
3161,0,0,42,0,-42
3162,0,0,1,0,-1
3163,1,0,61,0,-61
3164,1,1,173,1425,1252
3165,0,0,35,0,-35
3166,0,0,2,0,-2
3167,1,0,27,0,-27
3168,0,0,42,0,-42
3169,0,0,68,0,-68
3170,1,0,22,0,-22
3171,1,0,9,0,-9
3172,1,1,586,1452,866
3173,1,0,10,0,-10
3174,0,0,27,0,-27
3175,1,1,506,1283,777
3176,0,0,59,0,-59
3177,0,0,50,0,-50
3178,1,0,1,0,-1
3179,0,0,81,0,-81
3180,1,1,69,1552,1483
3181,1,0,1,0,-1
3182,1,0,14,0,-14
3183,1,1,117,1779,1662
3184,0,0,115,0,-115
3185,0,0,109,0,-109
3186,0,0,14,0,-14
3187,0,0,14,0,-14
3188,0,0,24,0,-24
3189,1,1,238,1265,1027
3190,0,0,55,0,-55
3191,1,0,9,0,-9
3192,1,0,81,0,-81
3193,1,0,23,0,-23
3194,0,0,117,0,-117
3195,1,0,3,0,-3
3196,0,0,6,0,-6
3197,1,0,47,0,-47
3198,1,0,16,0,-16
3199,1,0,5,0,-5
3200,0,0,11,0,-11
3201,1,0,17,0,-17
3202,0,0,21,0,-21
3203,1,0,53,0,-53
3204,0,0,24,0,-24
3205,1,1,57,1237,1180
3206,0,0,56,0,-56
3207,1,0,194,0,-194
3208,1,1,119,1442,1323
3209,0,0,43,0,-43
3210,0,0,95,0,-95
3211,1,0,199,0,-199
3212,0,0,88,0,-88
3213,1,0,49,0,-49
3214,1,1,116,1588,1472
3215,1,1,233,1237,1004
3216,0,0,66,0,-66
3217,1,1,922,1633,711
3218,1,1,571,1394,823
3219,0,0,105,0,-105
3220,0,0,0,0,0
3221,0,0,108,0,-108
3222,1,1,559,1509,950
3223,1,1,166,2242,2076
3224,0,0,24,0,-24
3225,0,0,8,0,-8
3226,1,1,383,1486,1103
3227,1,0,9,0,-9
3228,1,1,778,1321,543
3229,1,0,39,0,-39
3230,0,0,37,0,-37
3231,0,0,3,0,-3
3232,0,0,63,0,-63
3233,0,0,10,0,-10
3234,1,1,70,1287,1217
3235,0,0,83,0,-83
3236,0,0,39,0,-39
3237,1,1,1782,1375,-407
3238,1,1,615,1688,1073
3239,1,1,818,2544,1726
3240,1,1,2558,1348,-1210
3241,0,0,77,0,-77
3242,0,0,26,0,-26
3243,1,1,391,3102,2711
3244,1,1,1374,1449,75
3245,0,0,61,0,-61
3246,1,0,8,0,-8
3247,1,0,10,0,-10
3248,1,1,121,1365,1244
3249,0,0,28,0,-28
3250,0,0,17,0,-17
3251,1,0,11,0,-11
3252,1,1,45,2201,2156
3253,1,0,27,0,-27
3254,1,1,720,1435,715
3255,1,0,33,0,-33
3256,0,0,65,0,-65
3257,0,0,6,0,-6
3258,1,1,1249,1531,282
3259,1,1,905,2256,1351
3260,1,0,74,0,-74
3261,0,0,24,0,-24
3262,1,0,21,0,-21
3263,1,0,25,0,-25
3264,1,1,2479,2705,226
3265,0,0,66,0,-66
3266,1,0,1,0,-1
3267,1,0,249,0,-249
3268,0,0,123,0,-123
3269,1,0,7,0,-7
3270,0,0,53,0,-53
3271,1,0,37,0,-37
3272,0,0,4,0,-4
3273,0,0,9,0,-9
3274,0,0,82,0,-82
3275,1,0,233,0,-233
3276,0,0,54,0,-54
3277,1,1,900,1294,394
3278,1,0,61,0,-61
3279,1,0,22,0,-22
3280,0,0,20,0,-20
3281,0,0,15,0,-15
3282,1,1,389,1339,950
3283,1,1,84,1307,1223
3284,0,0,19,0,-19
3285,0,0,25,0,-25
3286,1,1,154,1366,1212
3287,1,0,15,0,-15
3288,0,0,69,0,-69
3289,0,0,67,0,-67
3290,1,0,75,0,-75
3291,1,0,22,0,-22
3292,0,0,42,0,-42
3293,1,0,90,0,-90
3294,0,0,41,0,-41
3295,1,0,3,0,-3
3296,1,1,81,1336,1255
3297,1,0,29,0,-29
3298,0,0,11,0,-11
3299,0,0,1,0,-1
3300,0,0,7,0,-7
3301,1,1,923,1244,321
3302,0,0,30,0,-30
3303,1,1,452,2554,2102
3304,1,0,84,0,-84
3305,1,1,272,2149,1877
3306,0,0,113,0,-113
3307,0,0,7,0,-7
3308,0,0,1,0,-1
3309,1,1,1184,1298,114
3310,1,0,60,0,-60
3311,1,0,20,0,-20
3312,1,0,26,0,-26
3313,1,1,3,1254,1251
3314,0,0,50,0,-50
3315,0,0,21,0,-21
3316,0,0,78,0,-78
3317,1,0,11,0,-11
3318,1,0,0,0,0
3319,1,0,0,0,0
3320,1,1,258,1716,1458
3321,1,1,939,1520,581
3322,1,0,101,0,-101
3323,0,0,92,0,-92
3324,1,0,0,0,0
3325,1,0,106,0,-106
3326,0,0,103,0,-103
3327,1,0,81,0,-81
3328,1,0,9,0,-9
3329,1,0,12,0,-12
3330,0,0,61,0,-61
3331,1,0,11,0,-11
3332,1,0,93,0,-93
3333,1,1,528,1379,851
3334,0,0,18,0,-18
3335,1,1,290,1336,1046
3336,0,0,45,0,-45
3337,0,0,69,0,-69
3338,1,1,800,1912,1112
3339,1,1,88,1694,1606
3340,0,0,26,0,-26
3341,1,1,160,1576,1416
3342,1,0,146,0,-146
3343,0,0,9,0,-9
3344,1,1,748,1601,853
3345,0,0,2,0,-2
3346,1,1,152,1299,1147
3347,1,1,75,1325,1250
3348,1,0,28,0,-28
3349,1,0,150,0,-150
3350,0,0,20,0,-20
3351,1,1,220,1405,1185
3352,1,1,100,1369,1269
3353,0,0,101,0,-101
3354,0,0,32,0,-32
3355,1,1,636,1490,854
3356,0,0,13,0,-13
3357,1,0,58,0,-58
3358,1,0,23,0,-23
3359,1,1,194,1605,1411
3360,1,0,14,0,-14
3361,1,0,52,0,-52
3362,1,0,82,0,-82
3363,1,1,1084,1967,883
3364,1,0,31,0,-31
3365,1,0,25,0,-25
3366,0,0,16,0,-16
3367,1,0,26,0,-26
3368,0,0,123,0,-123
3369,1,1,227,1286,1059
3370,1,0,108,0,-108
3371,0,0,30,0,-30
3372,1,1,277,1388,1111
3373,1,1,112,1303,1191
3374,0,0,2,0,-2
3375,1,0,26,0,-26
3376,1,1,88,1263,1175
3377,0,0,18,0,-18
3378,1,0,47,0,-47
3379,0,0,27,0,-27
3380,1,0,6,0,-6
3381,0,0,1,0,-1
3382,1,1,663,2081,1418
3383,0,0,33,0,-33
3384,0,0,0,0,0
3385,1,1,1308,1310,2
3386,1,0,57,0,-57
3387,0,0,30,0,-30
3388,1,0,45,0,-45
3389,0,0,28,0,-28
3390,1,0,3,0,-3
3391,0,0,43,0,-43
3392,0,0,18,0,-18
3393,1,0,32,0,-32
3394,1,1,250,1426,1176
3395,0,0,23,0,-23
3396,1,1,376,2252,1876
3397,1,0,45,0,-45
3398,1,0,15,0,-15
3399,1,1,1090,1334,244
3400,0,0,5,0,-5
3401,0,0,89,0,-89
3402,1,0,122,0,-122
3403,0,0,121,0,-121
3404,0,0,45,0,-45
3405,1,0,25,0,-25
3406,0,0,4,0,-4
3407,0,0,22,0,-22
3408,1,1,374,1291,917
3409,1,1,108,1243,1135
3410,0,0,8,0,-8
3411,1,1,205,1479,1274
3412,1,1,121,1679,1558
3413,1,0,98,0,-98
3414,0,0,50,0,-50
3415,1,0,56,0,-56
3416,1,1,185,1450,1265
3417,0,0,10,0,-10
3418,1,1,41,1462,1421
3419,0,0,9,0,-9
3420,0,0,7,0,-7
3421,0,0,77,0,-77
3422,0,0,15,0,-15
3423,0,0,51,0,-51
3424,1,0,6,0,-6
3425,1,0,4,0,-4
3426,1,0,4,0,-4
3427,1,0,51,0,-51
3428,0,0,15,0,-15
3429,1,0,52,0,-52
3430,1,0,2,0,-2
3431,0,0,186,0,-186
3432,1,1,294,1272,978
3433,1,1,1107,1402,295
3434,1,0,23,0,-23
3435,1,0,48,0,-48
3436,0,0,38,0,-38
3437,0,0,108,0,-108
3438,1,1,222,2050,1828
3439,1,0,29,0,-29
3440,1,1,1516,1613,97
3441,1,1,95,1344,1249
3442,0,0,86,0,-86
3443,1,0,20,0,-20
3444,0,0,64,0,-64
3445,1,1,127,1337,1210
3446,0,0,31,0,-31
3447,1,1,378,1257,879
3448,1,0,89,0,-89
3449,1,1,232,1260,1028
3450,1,0,2,0,-2
3451,0,0,58,0,-58
3452,1,0,4,0,-4
3453,0,0,47,0,-47
3454,1,0,84,0,-84
3455,0,0,28,0,-28
3456,0,0,6,0,-6
3457,1,0,8,0,-8
3458,1,0,52,0,-52
3459,1,0,44,0,-44
3460,1,0,107,0,-107
3461,0,0,86,0,-86
3462,1,1,335,1576,1241
3463,0,0,18,0,-18
3464,0,0,57,0,-57
3465,1,1,1169,1688,519
3466,1,0,9,0,-9
3467,0,0,68,0,-68
3468,1,0,12,0,-12
3469,0,0,15,0,-15
3470,1,1,457,1427,970
3471,1,1,817,1248,431
3472,0,0,9,0,-9
3473,1,0,47,0,-47
3474,1,1,39,1422,1383
3475,1,0,93,0,-93
3476,0,0,4,0,-4
3477,0,0,12,0,-12
3478,1,0,47,0,-47
3479,0,0,29,0,-29
3480,1,1,1639,1764,125
3481,0,0,138,0,-138
3482,0,0,49,0,-49
3483,0,0,51,0,-51
3484,1,1,175,1454,1279
3485,1,1,218,1274,1056
3486,1,1,258,1327,1069
3487,1,1,187,1448,1261
3488,0,0,17,0,-17
3489,0,0,16,0,-16
3490,1,0,105,0,-105
3491,0,0,33,0,-33
3492,1,0,55,0,-55
3493,1,1,331,1578,1247
3494,1,1,682,1605,923
3495,0,0,8,0,-8
3496,1,0,47,0,-47
3497,0,0,32,0,-32
3498,0,0,18,0,-18
3499,1,1,681,1935,1254
3500,0,0,27,0,-27
3501,0,0,32,0,-32
3502,0,0,78,0,-78
3503,1,0,104,0,-104
3504,1,0,30,0,-30
3505,1,0,7,0,-7
3506,1,0,17,0,-17
3507,0,0,39,0,-39
3508,1,0,40,0,-40
3509,1,1,1091,1534,443
3510,1,1,325,1303,978
3511,0,0,27,0,-27
3512,1,0,129,0,-129
3513,1,1,141,1349,1208
3514,1,1,777,4949,4172
3515,1,1,634,1320,686
3516,0,0,76,0,-76
3517,0,0,8,0,-8
3518,1,1,239,1691,1452
3519,1,1,240,1332,1092
3520,1,0,12,0,-12
3521,0,0,114,0,-114
3522,1,0,23,0,-23
3523,1,1,126,1368,1242
3524,0,0,168,0,-168
3525,0,0,154,0,-154
3526,0,0,27,0,-27
3527,1,1,327,1321,994
3528,0,0,12,0,-12
3529,0,0,40,0,-40
3530,1,0,86,0,-86
3531,1,0,90,0,-90
3532,0,0,75,0,-75
3533,1,0,130,0,-130
3534,1,1,463,1248,785
3535,0,0,50,0,-50
3536,1,0,98,0,-98
3537,1,0,5,0,-5
3538,1,1,511,3531,3020
3539,0,0,15,0,-15
3540,0,0,2,0,-2
3541,0,0,110,0,-110
3542,1,0,100,0,-100
3543,1,0,10,0,-10
3544,1,1,1732,1791,59
3545,0,0,83,0,-83
3546,1,0,194,0,-194
3547,0,0,103,0,-103
3548,1,0,29,0,-29
3549,1,0,91,0,-91
3550,0,0,46,0,-46
3551,1,0,61,0,-61
3552,1,1,320,1438,1118
3553,1,1,43,1780,1737
3554,1,0,8,0,-8
3555,1,1,232,1392,1160
3556,1,1,2279,4830,2551
3557,1,1,75,1235,1160
3558,0,0,91,0,-91
3559,1,0,7,0,-7
3560,0,0,18,0,-18
3561,1,0,9,0,-9
3562,1,1,185,1504,1319
3563,0,0,21,0,-21
3564,1,0,26,0,-26
3565,0,0,46,0,-46
3566,1,0,12,0,-12
3567,1,1,1136,1507,371
3568,1,1,389,2991,2602
3569,0,0,15,0,-15
3570,1,1,440,1983,1543
3571,0,0,1,0,-1
3572,1,1,127,2380,2253
3573,0,0,39,0,-39
3574,0,0,23,0,-23
3575,0,0,1,0,-1
3576,0,0,39,0,-39
3577,1,1,1777,1268,-509
3578,1,0,10,0,-10
3579,0,0,12,0,-12
3580,1,0,86,0,-86
3581,1,0,51,0,-51
3582,0,0,70,0,-70
3583,0,0,40,0,-40
3584,0,0,83,0,-83
3585,0,0,10,0,-10
3586,0,0,43,0,-43
3587,0,0,24,0,-24
3588,1,1,604,1335,731
3589,1,1,627,1249,622
3590,0,0,65,0,-65
3591,1,0,20,0,-20
3592,1,0,49,0,-49
3593,1,1,65,1593,1528
3594,1,0,36,0,-36
3595,1,1,315,5434,5119
3596,1,1,136,1244,1108
3597,0,0,30,0,-30
3598,1,0,57,0,-57
3599,0,0,60,0,-60
3600,0,0,27,0,-27
3601,0,0,46,0,-46
3602,1,0,87,0,-87
3603,0,0,20,0,-20
3604,0,0,37,0,-37
3605,0,0,57,0,-57
3606,1,0,4,0,-4
3607,1,0,17,0,-17
3608,1,0,0,0,0
3609,0,0,81,0,-81
3610,1,1,262,2140,1878
3611,1,0,122,0,-122
3612,0,0,6,0,-6
3613,0,0,18,0,-18
3614,1,0,145,0,-145
3615,0,0,86,0,-86
3616,0,0,1,0,-1
3617,0,0,7,0,-7
3618,1,1,652,1518,866
3619,1,0,3,0,-3
3620,1,1,464,1296,832
3621,1,1,833,1377,544
3622,0,0,71,0,-71
3623,1,0,11,0,-11
3624,1,0,42,0,-42
3625,1,1,238,1534,1296
3626,1,1,389,1734,1345
3627,0,0,4,0,-4
3628,1,1,713,1515,802
3629,1,0,232,0,-232
3630,0,0,15,0,-15
3631,1,1,93,1524,1431
3632,1,1,430,1655,1225
3633,0,0,55,0,-55
3634,0,0,22,0,-22
3635,1,1,1043,2000,957
3636,1,1,506,2544,2038
3637,1,1,490,1458,968
3638,0,0,85,0,-85
3639,1,1,446,1361,915
3640,0,0,63,0,-63
3641,0,0,28,0,-28
3642,1,1,693,2476,1783
3643,0,0,9,0,-9
3644,1,1,582,1551,969
3645,0,0,38,0,-38
3646,0,0,6,0,-6
3647,0,0,49,0,-49
3648,1,0,19,0,-19
3649,0,0,189,0,-189
3650,1,0,25,0,-25
3651,1,1,837,1952,1115
3652,0,0,4,0,-4
3653,1,0,19,0,-19
3654,0,0,51,0,-51
3655,1,0,19,0,-19
3656,0,0,7,0,-7
3657,0,0,50,0,-50
3658,1,1,156,1705,1549
3659,0,0,4,0,-4
3660,0,0,0,0,0
3661,1,1,338,3145,2807
3662,0,0,28,0,-28
3663,1,0,6,0,-6
3664,0,0,20,0,-20
3665,0,0,3,0,-3
3666,1,1,478,2054,1576
3667,1,1,122,1499,1377
3668,1,0,79,0,-79
3669,1,0,6,0,-6
3670,1,0,20,0,-20
3671,1,0,1,0,-1
3672,1,1,789,1442,653
3673,0,0,99,0,-99
3674,1,0,71,0,-71
3675,1,1,599,1695,1096
3676,1,1,992,1347,355
3677,1,0,27,0,-27
3678,1,0,27,0,-27
3679,0,0,53,0,-53
3680,1,1,132,1803,1671
3681,0,0,20,0,-20
3682,1,0,76,0,-76
3683,0,0,155,0,-155
3684,0,0,7,0,-7
3685,0,0,146,0,-146
3686,1,0,56,0,-56
3687,0,0,144,0,-144
3688,1,0,45,0,-45
3689,1,1,272,1253,981
3690,1,0,77,0,-77
3691,1,0,7,0,-7
3692,1,1,786,1316,530
3693,1,1,612,1400,788
3694,0,0,92,0,-92
3695,1,0,128,0,-128
3696,1,1,216,1514,1298
3697,0,0,114,0,-114
3698,0,0,138,0,-138
3699,1,0,25,0,-25
3700,0,0,5,0,-5
3701,1,1,43,1268,1225
3702,0,0,4,0,-4
3703,0,0,183,0,-183
3704,1,1,1083,1353,270
3705,1,1,107,1701,1594
3706,1,1,1367,1695,328
3707,0,0,24,0,-24
3708,0,0,93,0,-93
3709,1,1,43,1691,1648
3710,0,0,105,0,-105
3711,0,0,6,0,-6
3712,1,1,540,1507,967
3713,1,1,751,1367,616
3714,0,0,123,0,-123
3715,1,1,462,1499,1037
3716,1,1,348,1323,975
3717,1,0,22,0,-22
3718,0,0,1,0,-1
3719,0,0,8,0,-8
3720,1,1,2309,1741,-568
3721,1,0,23,0,-23
3722,0,0,2,0,-2
3723,0,0,115,0,-115
3724,1,1,247,1245,998
3725,1,0,27,0,-27
3726,0,0,9,0,-9
3727,1,1,853,1259,406
3728,1,1,364,1429,1065
3729,1,0,93,0,-93
3730,1,1,709,1751,1042
3731,1,1,451,1497,1046
3732,1,0,87,0,-87
3733,1,1,612,1493,881
3734,1,0,27,0,-27
3735,0,0,10,0,-10
3736,1,1,420,1473,1053
3737,1,1,87,1788,1701
3738,0,0,65,0,-65
3739,1,0,44,0,-44
3740,1,0,189,0,-189
3741,0,0,19,0,-19
3742,1,0,9,0,-9
3743,1,1,54,1557,1503
3744,1,1,557,1732,1175
3745,0,0,5,0,-5
3746,0,0,8,0,-8
3747,1,1,1555,1459,-96
3748,1,1,204,1406,1202
3749,1,1,1196,1316,120
3750,0,0,52,0,-52
3751,1,0,35,0,-35
3752,0,0,9,0,-9
3753,1,0,22,0,-22
3754,1,1,2060,1844,-216
3755,0,0,0,0,0
3756,1,1,171,1456,1285
3757,1,0,55,0,-55
3758,0,0,45,0,-45
3759,0,0,37,0,-37
3760,0,0,57,0,-57
3761,0,0,41,0,-41
3762,1,1,598,1274,676
3763,1,0,122,0,-122
3764,1,1,1059,1370,311
3765,1,1,114,1949,1835
3766,0,0,15,0,-15
3767,1,1,366,1429,1063
3768,0,0,39,0,-39
3769,1,1,747,1503,756
3770,0,0,97,0,-97
3771,1,0,5,0,-5
3772,1,1,491,1279,788
3773,0,0,27,0,-27
3774,0,0,65,0,-65
3775,1,0,35,0,-35
3776,1,0,165,0,-165
3777,0,0,38,0,-38
3778,0,0,4,0,-4
3779,1,1,111,1385,1274
3780,1,0,72,0,-72
3781,1,1,88,1914,1826
3782,1,0,137,0,-137
3783,1,1,956,1320,364
3784,0,0,6,0,-6
3785,0,0,14,0,-14
3786,1,1,299,1600,1301
3787,1,0,100,0,-100
3788,1,1,112,1909,1797
3789,0,0,78,0,-78
3790,1,0,93,0,-93
3791,0,0,45,0,-45
3792,1,1,1281,2158,877
3793,1,1,337,1756,1419
3794,0,0,64,0,-64
3795,0,0,117,0,-117
3796,1,1,722,1307,585
3797,1,0,22,0,-22
3798,0,0,14,0,-14
3799,0,0,30,0,-30
3800,1,0,156,0,-156
3801,0,0,52,0,-52
3802,1,0,10,0,-10
3803,1,1,504,1636,1132
3804,0,0,6,0,-6
3805,1,0,68,0,-68
3806,1,0,26,0,-26
3807,1,0,10,0,-10
3808,1,1,87,1656,1569
3809,1,1,326,1363,1037
3810,1,1,621,1665,1044
3811,1,1,140,1315,1175
3812,1,0,118,0,-118
3813,1,0,41,0,-41
3814,1,1,718,1751,1033
3815,1,1,297,1237,940
3816,1,1,438,1430,992
3817,1,0,3,0,-3
3818,0,0,6,0,-6
3819,0,0,23,0,-23
3820,0,0,66,0,-66
3821,1,0,100,0,-100
3822,0,0,45,0,-45
3823,0,0,27,0,-27
3824,0,0,23,0,-23
3825,0,0,0,0,0
3826,1,1,20,1846,1826
3827,0,0,120,0,-120
3828,0,0,18,0,-18
3829,1,1,676,1571,895
3830,0,0,35,0,-35
3831,0,0,3,0,-3
3832,1,0,8,0,-8
3833,1,0,103,0,-103
3834,1,0,108,0,-108
3835,1,0,41,0,-41
3836,1,0,89,0,-89
3837,1,1,276,1690,1414
3838,1,0,32,0,-32
3839,0,0,18,0,-18
3840,0,0,0,0,0
3841,1,1,574,1894,1320
3842,1,1,101,2944,2843
3843,1,1,954,1253,299
3844,1,1,277,1484,1207
3845,1,1,1198,1379,181
3846,1,1,1118,1940,822
3847,1,0,6,0,-6
3848,1,1,1126,1347,221
3849,0,0,26,0,-26
3850,1,0,21,0,-21
3851,1,0,0,0,0
3852,1,1,625,1370,745
3853,0,0,37,0,-37
3854,0,0,77,0,-77
3855,0,0,85,0,-85
3856,1,1,668,1853,1185
3857,0,0,1,0,-1
3858,1,0,125,0,-125
3859,0,0,34,0,-34
3860,1,1,1179,1408,229
3861,1,0,49,0,-49
3862,0,0,92,0,-92
3863,0,0,0,0,0
3864,1,0,6,0,-6
3865,0,0,81,0,-81
3866,0,0,78,0,-78
3867,0,0,98,0,-98
3868,1,1,755,1478,723
3869,0,0,12,0,-12
3870,1,1,859,1561,702
3871,0,0,33,0,-33
3872,0,0,143,0,-143
3873,0,0,156,0,-156
3874,1,0,46,0,-46
3875,0,0,29,0,-29
3876,1,0,29,0,-29
3877,1,1,209,1596,1387
3878,1,0,40,0,-40
3879,1,1,1476,1314,-162
3880,0,0,43,0,-43
3881,0,0,7,0,-7
3882,0,0,188,0,-188
3883,0,0,14,0,-14
3884,0,0,49,0,-49
3885,1,0,80,0,-80
3886,1,0,5,0,-5
3887,1,0,33,0,-33
3888,0,0,74,0,-74
3889,1,0,18,0,-18
3890,1,1,101,1540,1439
3891,0,0,18,0,-18
3892,0,0,6,0,-6
3893,1,0,9,0,-9
3894,0,0,39,0,-39
3895,1,1,123,2447,2324
3896,1,0,7,0,-7
3897,0,0,26,0,-26
3898,0,0,156,0,-156
3899,0,0,49,0,-49
3900,0,0,3,0,-3
3901,1,0,67,0,-67
3902,1,0,83,0,-83
3903,0,0,95,0,-95
3904,1,0,3,0,-3
3905,1,0,23,0,-23
3906,0,0,27,0,-27
3907,0,0,27,0,-27
3908,0,0,26,0,-26
3909,0,0,62,0,-62
3910,1,1,60,1248,1188
3911,0,0,23,0,-23
3912,1,1,74,1437,1363
3913,1,1,330,1719,1389
3914,1,1,168,1356,1188
3915,0,0,32,0,-32
3916,0,0,10,0,-10
3917,1,0,75,0,-75
3918,1,1,629,1418,789
3919,0,0,81,0,-81
3920,1,0,12,0,-12
3921,1,0,12,0,-12
3922,1,0,17,0,-17
3923,0,0,3,0,-3
3924,1,1,81,2389,2308
3925,1,1,219,1321,1102
3926,1,1,675,1241,566
3927,0,0,54,0,-54
3928,0,0,15,0,-15
3929,1,0,165,0,-165
3930,0,0,42,0,-42
3931,1,0,29,0,-29
3932,0,0,38,0,-38
3933,0,0,2,0,-2
3934,0,0,100,0,-100
3935,0,0,2,0,-2
3936,1,1,646,1311,665
3937,1,1,85,1460,1375
3938,1,0,76,0,-76
3939,1,1,103,1988,1885
3940,0,0,57,0,-57
3941,1,0,46,0,-46
3942,0,0,56,0,-56
3943,1,0,0,0,0
3944,0,0,30,0,-30
3945,0,0,98,0,-98
3946,1,1,497,1505,1008
3947,0,0,70,0,-70
3948,1,1,338,1310,972
3949,0,0,57,0,-57
3950,1,0,56,0,-56
3951,1,1,1642,2372,730
3952,1,0,20,0,-20
3953,0,0,68,0,-68
3954,1,1,134,2545,2411
3955,0,0,87,0,-87
3956,0,0,281,0,-281
3957,1,0,26,0,-26
3958,0,0,16,0,-16
3959,1,1,161,1409,1248
3960,1,1,945,1850,905
3961,0,0,77,0,-77
3962,1,1,167,1678,1511
3963,1,1,186,1416,1230
3964,1,1,387,1323,936
3965,1,0,86,0,-86
3966,0,0,7,0,-7
3967,1,0,117,0,-117
3968,0,0,95,0,-95
3969,0,0,90,0,-90
3970,0,0,7,0,-7
3971,1,0,12,0,-12
3972,0,0,55,0,-55
3973,1,1,178,1376,1198
3974,1,0,217,0,-217
3975,1,1,996,1347,351
3976,1,0,231,0,-231
3977,0,0,85,0,-85
3978,1,0,35,0,-35
3979,0,0,54,0,-54
3980,1,1,417,1297,880
3981,1,0,15,0,-15
3982,1,1,320,2619,2299
3983,1,1,106,2723,2617
3984,1,1,587,1258,671
3985,0,0,0,0,0
3986,1,0,147,0,-147
3987,1,0,53,0,-53
3988,0,0,23,0,-23
3989,0,0,33,0,-33
3990,1,1,502,1348,846
3991,1,0,151,0,-151
3992,0,0,128,0,-128
3993,1,0,85,0,-85
3994,0,0,2,0,-2
3995,1,1,149,1356,1207
3996,0,0,32,0,-32
3997,0,0,19,0,-19
3998,1,0,33,0,-33
3999,0,0,94,0,-94
4000,0,0,82,0,-82
4001,1,0,17,0,-17
4002,1,0,0,0,0
4003,0,0,15,0,-15
4004,1,0,58,0,-58
4005,1,1,32,1636,1604
4006,1,0,24,0,-24
4007,1,1,290,1291,1001
4008,1,0,4,0,-4
4009,1,1,749,2066,1317
4010,0,0,48,0,-48
4011,0,0,21,0,-21
4012,0,0,6,0,-6
4013,1,0,43,0,-43
4014,1,1,185,1828,1643
4015,0,0,79,0,-79
4016,1,1,443,1290,847
4017,0,0,4,0,-4
4018,1,0,0,0,0
4019,1,0,89,0,-89
4020,1,0,3,0,-3
4021,1,0,12,0,-12
4022,1,1,599,1265,666
4023,1,1,92,1331,1239
4024,1,0,8,0,-8
4025,1,1,232,1321,1089
4026,0,0,88,0,-88
4027,0,0,46,0,-46
4028,0,0,34,0,-34
4029,1,1,413,1512,1099
4030,1,0,12,0,-12
4031,1,1,67,1249,1182
4032,1,1,136,1555,1419
4033,1,1,312,1682,1370
4034,1,1,492,1235,743
4035,0,0,70,0,-70
4036,1,1,87,1282,1195
4037,0,0,0,0,0
4038,1,1,316,1280,964
4039,1,0,8,0,-8
4040,1,1,39,1277,1238
4041,0,0,195,0,-195
4042,0,0,108,0,-108
4043,0,0,28,0,-28
4044,0,0,113,0,-113
4045,0,0,14,0,-14
4046,1,0,138,0,-138
4047,1,1,125,1309,1184
4048,1,0,101,0,-101
4049,0,0,88,0,-88
4050,0,0,61,0,-61
4051,0,0,19,0,-19
4052,1,1,299,1426,1127
4053,0,0,15,0,-15
4054,1,0,7,0,-7
4055,1,1,145,2219,2074
4056,1,1,478,1466,988
4057,1,0,44,0,-44
4058,1,1,1377,2528,1151
4059,1,1,314,1452,1138
4060,0,0,6,0,-6
4061,1,0,127,0,-127
4062,0,0,44,0,-44
4063,0,0,18,0,-18
4064,1,1,1684,1647,-37
4065,0,0,306,0,-306
4066,1,1,167,2268,2101
4067,0,0,167,0,-167
4068,1,0,1,0,-1
4069,1,0,39,0,-39
4070,1,0,110,0,-110
4071,1,1,66,1960,1894
4072,0,0,18,0,-18
4073,1,1,273,1255,982
4074,1,1,151,1237,1086
4075,1,0,19,0,-19
4076,0,0,21,0,-21
4077,0,0,3,0,-3
4078,0,0,19,0,-19
4079,1,1,195,1285,1090
4080,1,1,421,1949,1528
4081,0,0,8,0,-8
4082,1,0,25,0,-25
4083,1,1,921,1498,577
4084,0,0,47,0,-47
4085,0,0,16,0,-16
4086,0,0,39,0,-39
4087,1,0,3,0,-3
4088,1,1,793,2004,1211
4089,0,0,66,0,-66
4090,1,1,463,1688,1225
4091,1,0,105,0,-105
4092,1,1,243,1777,1534
4093,1,0,20,0,-20
4094,1,1,405,1266,861
4095,1,0,33,0,-33
4096,1,0,12,0,-12
4097,1,1,367,4953,4586
4098,1,0,170,0,-170
4099,1,0,52,0,-52
4100,0,0,63,0,-63
4101,1,1,399,2634,2235
4102,0,0,16,0,-16
4103,0,0,50,0,-50
4104,1,1,386,1453,1067
4105,1,0,227,0,-227
4106,0,0,14,0,-14
4107,1,0,140,0,-140
4108,1,0,46,0,-46
4109,1,1,322,1490,1168
4110,1,0,63,0,-63
4111,1,1,3,1405,1402
4112,0,0,66,0,-66
4113,0,0,43,0,-43
4114,1,1,964,1329,365
4115,0,0,113,0,-113
4116,1,1,106,1608,1502
4117,1,0,52,0,-52
4118,1,0,43,0,-43
4119,0,0,37,0,-37
4120,0,0,32,0,-32
4121,0,0,82,0,-82
4122,1,0,16,0,-16
4123,1,1,75,1391,1316
4124,0,0,69,0,-69
4125,1,1,418,1719,1301
4126,1,0,14,0,-14
4127,1,0,103,0,-103
4128,0,0,9,0,-9
4129,0,0,55,0,-55
4130,1,1,154,1337,1183
4131,1,0,9,0,-9
4132,0,0,89,0,-89
4133,1,1,830,1395,565
4134,1,0,9,0,-9
4135,1,0,17,0,-17
4136,0,0,97,0,-97
4137,0,0,28,0,-28
4138,1,0,106,0,-106
4139,1,1,510,1470,960
4140,1,0,116,0,-116
4141,1,1,607,1492,885
4142,1,1,62,1534,1472
4143,1,0,150,0,-150
4144,0,0,21,0,-21
4145,1,0,61,0,-61
4146,1,0,16,0,-16
4147,0,0,140,0,-140
4148,1,1,1580,1296,-284
4149,0,0,96,0,-96
4150,0,0,66,0,-66
4151,1,1,622,1300,678
4152,0,0,13,0,-13
4153,0,0,11,0,-11
4154,0,0,74,0,-74
4155,0,0,176,0,-176
4156,1,1,62,1303,1241
4157,1,1,1372,1682,310
4158,1,0,20,0,-20
4159,1,0,8,0,-8
4160,1,1,1519,1576,57
4161,1,1,206,2692,2486
4162,0,0,8,0,-8
4163,0,0,204,0,-204
4164,1,0,5,0,-5
4165,1,1,942,1657,715
4166,1,1,335,1364,1029
4167,1,0,73,0,-73
4168,0,0,61,0,-61
4169,1,1,606,1368,762
4170,1,1,1633,1286,-347
4171,1,0,20,0,-20
4172,1,0,63,0,-63
4173,1,1,113,1413,1300
4174,0,0,19,0,-19
4175,0,0,52,0,-52
4176,1,0,49,0,-49
4177,1,1,685,1386,701
4178,0,0,79,0,-79
4179,0,0,191,0,-191
4180,0,0,4,0,-4
4181,1,1,147,2865,2718
4182,1,1,206,1273,1067
4183,1,0,52,0,-52
4184,0,0,1,0,-1
4185,1,0,110,0,-110
4186,1,1,222,1335,1113
4187,1,1,39,1651,1612
4188,1,0,112,0,-112
4189,0,0,40,0,-40
4190,1,0,22,0,-22
4191,0,0,23,0,-23
4192,0,0,78,0,-78
4193,1,1,252,1260,1008
4194,1,0,1,0,-1
4195,1,0,99,0,-99
4196,0,0,5,0,-5
4197,1,1,203,1336,1133
4198,0,0,0,0,0
4199,1,0,129,0,-129
4200,0,0,48,0,-48
4201,0,0,1,0,-1
4202,1,0,1,0,-1
4203,1,1,163,2567,2404
4204,1,0,15,0,-15
4205,0,0,50,0,-50
4206,1,1,854,2943,2089
4207,1,0,113,0,-113
4208,0,0,37,0,-37
4209,0,0,49,0,-49
4210,0,0,14,0,-14
4211,1,1,711,1585,874
4212,1,0,44,0,-44
4213,0,0,0,0,0
4214,0,0,41,0,-41
4215,1,1,435,1293,858
4216,1,0,7,0,-7
4217,0,0,136,0,-136
4218,1,1,31,2000,1969
4219,1,1,200,1540,1340
4220,0,0,28,0,-28
4221,1,0,29,0,-29
4222,1,1,55,1436,1381
4223,0,0,23,0,-23
4224,1,0,27,0,-27
4225,1,0,21,0,-21
4226,1,1,63,1742,1679
4227,1,0,57,0,-57
4228,0,0,3,0,-3
4229,1,1,146,3160,3014
4230,1,1,3195,1263,-1932
4231,0,0,17,0,-17
4232,1,1,59,1603,1544
4233,0,0,10,0,-10
4234,1,1,586,1235,649
4235,1,0,46,0,-46
4236,0,0,14,0,-14
4237,1,0,71,0,-71
4238,0,0,108,0,-108
4239,0,0,28,0,-28
4240,0,0,9,0,-9
4241,1,0,62,0,-62
4242,1,0,24,0,-24
4243,1,0,6,0,-6
4244,1,1,235,1482,1247
4245,1,1,83,1441,1358
4246,1,0,35,0,-35
4247,0,0,89,0,-89
4248,0,0,22,0,-22
4249,0,0,8,0,-8
4250,0,0,120,0,-120
4251,1,0,71,0,-71
4252,1,0,54,0,-54
4253,1,1,792,1281,489
4254,1,0,13,0,-13
4255,1,1,357,2213,1856
4256,1,1,125,1640,1515
4257,1,0,60,0,-60
4258,0,0,41,0,-41
4259,0,0,0,0,0
4260,0,0,18,0,-18
4261,1,0,68,0,-68
4262,1,1,1049,1549,500
4263,0,0,72,0,-72
4264,1,0,64,0,-64
4265,1,1,24,1282,1258
4266,0,0,17,0,-17
4267,1,1,557,1429,872
4268,0,0,24,0,-24
4269,0,0,10,0,-10
4270,1,1,677,1534,857
4271,0,0,124,0,-124
4272,0,0,135,0,-135
4273,1,0,55,0,-55
4274,0,0,35,0,-35
4275,1,0,7,0,-7
4276,0,0,65,0,-65
4277,1,0,7,0,-7
4278,1,0,7,0,-7
4279,1,1,70,1749,1679
4280,0,0,12,0,-12
4281,1,0,19,0,-19
4282,0,0,5,0,-5
4283,1,1,2852,1299,-1553
4284,1,1,688,1296,608
4285,1,1,211,1480,1269
4286,1,0,90,0,-90
4287,1,1,121,1795,1674
4288,1,1,148,1838,1690
4289,0,0,9,0,-9
4290,1,0,17,0,-17
4291,1,1,1166,2008,842
4292,0,0,25,0,-25
4293,1,1,286,1563,1277
4294,0,0,123,0,-123
4295,0,0,12,0,-12
4296,1,0,26,0,-26
4297,1,1,38,1794,1756
4298,1,0,74,0,-74
4299,1,1,172,1793,1621
4300,1,0,59,0,-59
4301,0,0,41,0,-41
4302,1,0,26,0,-26
4303,0,0,68,0,-68
4304,0,0,0,0,0
4305,1,1,850,1432,582
4306,1,0,62,0,-62
4307,0,0,15,0,-15
4308,1,0,71,0,-71
4309,0,0,56,0,-56
4310,0,0,21,0,-21
4311,1,1,44,1313,1269
4312,0,0,7,0,-7
4313,0,0,155,0,-155
4314,1,1,232,1237,1005
4315,1,0,25,0,-25
4316,1,0,49,0,-49
4317,1,1,815,1570,755
4318,0,0,5,0,-5
4319,1,1,200,1461,1261
4320,0,0,12,0,-12
4321,1,0,97,0,-97
4322,1,1,182,1307,1125
4323,1,1,1175,2099,924
4324,0,0,16,0,-16
4325,1,0,10,0,-10
4326,1,1,730,1265,535
4327,0,0,71,0,-71
4328,0,0,10,0,-10
4329,1,1,115,1289,1174
4330,0,0,182,0,-182
4331,1,0,4,0,-4
4332,1,0,159,0,-159
4333,0,0,102,0,-102
4334,0,0,75,0,-75
4335,1,0,67,0,-67
4336,0,0,115,0,-115
4337,1,0,42,0,-42
4338,0,0,4,0,-4
4339,1,1,903,1593,690
4340,1,1,281,1607,1326
4341,0,0,25,0,-25
4342,0,0,37,0,-37
4343,1,1,328,1512,1184
4344,0,0,142,0,-142
4345,1,0,38,0,-38
4346,1,0,24,0,-24
4347,1,0,50,0,-50
4348,1,1,43,1280,1237
4349,1,1,1648,1466,-182
4350,0,0,27,0,-27
4351,1,0,61,0,-61
4352,1,0,22,0,-22
4353,1,0,87,0,-87
4354,1,0,10,0,-10
4355,0,0,95,0,-95
4356,1,1,1358,1260,-98
4357,1,1,155,1354,1199
4358,1,0,4,0,-4
4359,1,1,1674,1460,-214
4360,0,0,183,0,-183
4361,1,1,507,1255,748
4362,0,0,45,0,-45
4363,1,1,857,1672,815
4364,1,0,31,0,-31
4365,1,1,1970,1257,-713
4366,0,0,78,0,-78
4367,1,0,28,0,-28
4368,1,1,380,1313,933
4369,1,0,13,0,-13
4370,0,0,44,0,-44
4371,1,0,10,0,-10
4372,1,1,570,1631,1061
4373,0,0,34,0,-34
4374,0,0,12,0,-12
4375,1,1,380,1282,902
4376,1,1,240,2023,1783
4377,1,1,85,1263,1178
4378,0,0,187,0,-187
4379,1,0,5,0,-5
4380,0,0,0,0,0
4381,0,0,7,0,-7
4382,1,1,102,1508,1406
4383,0,0,37,0,-37
4384,0,0,121,0,-121
4385,1,1,417,1335,918
4386,0,0,45,0,-45
4387,0,0,8,0,-8
4388,1,0,73,0,-73
4389,1,0,11,0,-11
4390,0,0,16,0,-16
4391,0,0,3,0,-3
4392,0,0,7,0,-7
4393,0,0,68,0,-68
4394,1,1,72,1409,1337
4395,1,1,304,1307,1003
4396,0,0,85,0,-85
4397,1,0,9,0,-9
4398,0,0,60,0,-60
4399,1,1,631,2309,1678
4400,0,0,72,0,-72
4401,1,1,450,1794,1344
4402,0,0,44,0,-44
4403,1,0,39,0,-39
4404,1,0,99,0,-99
4405,1,1,90,1763,1673
4406,1,0,5,0,-5
4407,1,0,150,0,-150
4408,1,1,416,2835,2419
4409,1,0,0,0,0
4410,1,1,150,2080,1930
4411,0,0,52,0,-52
4412,0,0,20,0,-20
4413,1,0,20,0,-20
4414,1,1,763,1441,678
4415,1,0,8,0,-8
4416,1,1,167,1251,1084
4417,1,0,120,0,-120
4418,1,0,189,0,-189
4419,1,1,2239,1916,-323
4420,1,1,364,1582,1218
4421,0,0,45,0,-45
4422,1,1,228,1380,1152
4423,1,0,15,0,-15
4424,1,1,249,1363,1114
4425,0,0,71,0,-71
4426,0,0,4,0,-4
4427,1,1,320,2010,1690
4428,0,0,72,0,-72
4429,1,0,170,0,-170
4430,1,1,2130,1373,-757
4431,0,0,74,0,-74
4432,0,0,7,0,-7
4433,1,1,59,1422,1363
4434,1,1,1036,1540,504
4435,1,0,4,0,-4
4436,1,0,40,0,-40
4437,1,1,507,1587,1080
4438,0,0,88,0,-88
4439,0,0,18,0,-18
4440,0,0,38,0,-38
4441,0,0,12,0,-12
4442,1,0,12,0,-12
4443,1,0,8,0,-8
4444,1,1,124,1281,1157
4445,0,0,75,0,-75
4446,0,0,136,0,-136
4447,1,1,702,1715,1013
4448,1,1,70,1883,1813
4449,1,1,308,1263,955
4450,1,0,30,0,-30
4451,1,1,416,1286,870
4452,0,0,39,0,-39
4453,0,0,4,0,-4
4454,0,0,44,0,-44
4455,1,0,37,0,-37
4456,0,0,12,0,-12
4457,0,0,11,0,-11
4458,1,0,46,0,-46
4459,0,0,91,0,-91
4460,0,0,34,0,-34
4461,0,0,21,0,-21
4462,1,0,13,0,-13
4463,1,0,4,0,-4
4464,1,0,29,0,-29
4465,1,1,434,1549,1115
4466,1,1,263,1495,1232
4467,1,0,15,0,-15
4468,0,0,16,0,-16
4469,0,0,6,0,-6
4470,1,0,42,0,-42
4471,1,1,1059,3096,2037
4472,1,0,53,0,-53
4473,1,0,7,0,-7
4474,1,1,391,2092,1701
4475,0,0,44,0,-44
4476,0,0,28,0,-28
4477,1,0,36,0,-36
4478,0,0,69,0,-69
4479,0,0,94,0,-94
4480,1,0,43,0,-43
4481,0,0,102,0,-102
4482,1,0,23,0,-23
4483,1,1,188,1882,1694
4484,0,0,0,0,0
4485,0,0,51,0,-51
4486,1,0,9,0,-9
4487,1,0,44,0,-44
4488,1,0,123,0,-123
4489,1,1,348,1371,1023
4490,0,0,74,0,-74
4491,1,0,16,0,-16
4492,0,0,19,0,-19
4493,0,0,13,0,-13
4494,1,1,409,4222,3813
4495,1,1,240,1442,1202
4496,1,0,149,0,-149
4497,1,1,512,1376,864
4498,1,1,1161,2443,1282
4499,1,0,171,0,-171
4500,1,1,479,1261,782
4501,0,0,23,0,-23
4502,1,0,41,0,-41
4503,1,1,81,1717,1636
4504,1,0,1,0,-1
4505,1,0,16,0,-16
4506,0,0,85,0,-85
4507,1,1,186,1256,1070
4508,0,0,204,0,-204
4509,1,0,82,0,-82
4510,1,1,187,3049,2862
4511,1,0,36,0,-36
4512,1,0,47,0,-47
4513,0,0,148,0,-148
4514,1,0,7,0,-7
4515,1,0,79,0,-79
4516,0,0,19,0,-19
4517,1,1,1044,1362,318
4518,1,1,438,1472,1034
4519,1,1,1311,1670,359
4520,1,0,16,0,-16
4521,1,0,15,0,-15
4522,0,0,14,0,-14
4523,0,0,28,0,-28
4524,1,0,17,0,-17
4525,1,1,1219,1347,128
4526,1,1,30,1680,1650
4527,1,1,390,1726,1336
4528,0,0,16,0,-16
4529,0,0,24,0,-24
4530,1,1,361,1646,1285
4531,1,0,84,0,-84
4532,0,0,57,0,-57
4533,1,1,107,1277,1170
4534,0,0,40,0,-40
4535,1,0,58,0,-58
4536,1,0,3,0,-3
4537,0,0,2,0,-2
4538,1,1,241,1480,1239
4539,1,0,83,0,-83
4540,1,0,60,0,-60
4541,1,0,55,0,-55
4542,0,0,4,0,-4
4543,0,0,18,0,-18
4544,1,0,5,0,-5
4545,1,1,946,1258,312
4546,0,0,20,0,-20
4547,0,0,86,0,-86
4548,1,0,79,0,-79
4549,0,0,76,0,-76
4550,1,0,143,0,-143
4551,1,1,488,1300,812
4552,1,1,185,1363,1178
4553,1,1,243,1267,1024
4554,0,0,18,0,-18
4555,1,0,27,0,-27
4556,1,0,94,0,-94
4557,1,0,29,0,-29
4558,0,0,46,0,-46
4559,0,0,12,0,-12
4560,0,0,13,0,-13
4561,1,0,39,0,-39
4562,1,1,197,1768,1571
4563,0,0,4,0,-4
4564,0,0,0,0,0
4565,0,0,18,0,-18
4566,0,0,18,0,-18
4567,0,0,41,0,-41
4568,1,1,905,1248,343
4569,1,1,499,1848,1349
4570,0,0,47,0,-47
4571,0,0,3,0,-3
4572,1,0,33,0,-33
4573,1,1,68,1465,1397
4574,1,1,1511,4783,3272
4575,0,0,165,0,-165
4576,1,0,160,0,-160
4577,1,0,43,0,-43
4578,1,1,687,1377,690
4579,0,0,51,0,-51
4580,1,0,29,0,-29
4581,0,0,14,0,-14
4582,1,0,16,0,-16
4583,1,0,34,0,-34
4584,1,1,150,1513,1363
4585,0,0,20,0,-20
4586,1,0,31,0,-31
4587,1,0,60,0,-60
4588,1,0,107,0,-107
4589,1,0,29,0,-29
4590,1,0,116,0,-116
4591,0,0,48,0,-48
4592,1,1,186,1477,1291
4593,0,0,50,0,-50
4594,1,0,10,0,-10
4595,1,1,1030,1867,837
4596,1,0,30,0,-30
4597,0,0,19,0,-19
4598,1,0,126,0,-126
4599,1,1,714,1555,841
4600,0,0,47,0,-47
4601,0,0,30,0,-30
4602,1,1,411,1458,1047
4603,0,0,35,0,-35
4604,1,1,486,1499,1013
4605,1,1,351,1236,885
4606,1,0,73,0,-73
4607,0,0,98,0,-98
4608,1,1,301,1270,969
4609,1,0,13,0,-13
4610,0,0,37,0,-37
4611,0,0,116,0,-116
4612,1,0,28,0,-28
4613,1,1,229,1653,1424
4614,1,0,23,0,-23
4615,1,1,545,1486,941
4616,1,0,88,0,-88
4617,1,0,33,0,-33
4618,1,1,1150,1688,538
4619,1,1,534,1239,705
4620,0,0,10,0,-10
4621,0,0,159,0,-159
4622,1,0,1,0,-1
4623,0,0,86,0,-86
4624,1,0,97,0,-97
4625,1,0,9,0,-9
4626,0,0,51,0,-51
4627,1,0,101,0,-101
4628,1,1,75,2686,2611
4629,1,1,1173,1452,279
4630,1,1,295,1333,1038
4631,1,0,179,0,-179
4632,1,1,315,2287,1972
4633,0,0,53,0,-53
4634,0,0,28,0,-28
4635,0,0,55,0,-55
4636,0,0,171,0,-171
4637,1,1,145,1761,1616
4638,1,0,16,0,-16
4639,1,0,16,0,-16
4640,0,0,25,0,-25
4641,0,0,50,0,-50
4642,0,0,69,0,-69
4643,0,0,40,0,-40
4644,1,1,237,2025,1788
4645,1,1,1324,1434,110
4646,0,0,3,0,-3
4647,1,1,856,1459,603
4648,0,0,116,0,-116
4649,1,0,68,0,-68
4650,1,1,413,1694,1281
4651,1,0,26,0,-26
4652,1,1,380,1456,1076
4653,1,0,38,0,-38
4654,1,0,26,0,-26
4655,1,0,64,0,-64
4656,0,0,22,0,-22
4657,0,0,77,0,-77
4658,1,1,115,1273,1158
4659,1,1,1451,2011,560
4660,0,0,1,0,-1
4661,0,0,73,0,-73
4662,0,0,42,0,-42
4663,1,1,299,1283,984
4664,1,0,37,0,-37
4665,1,0,0,0,0
4666,1,1,462,1570,1108
4667,1,0,3,0,-3
4668,1,0,28,0,-28
4669,1,1,1166,1828,662
4670,1,1,86,1485,1399
4671,0,0,88,0,-88
4672,1,1,362,2098,1736
4673,0,0,26,0,-26
4674,1,0,175,0,-175
4675,0,0,6,0,-6
4676,1,0,5,0,-5
4677,1,1,180,1464,1284
4678,1,0,28,0,-28
4679,0,0,94,0,-94
4680,1,0,3,0,-3
4681,0,0,0,0,0
4682,1,1,223,2474,2251
4683,0,0,79,0,-79
4684,1,1,1642,1575,-67
4685,0,0,0,0,0
4686,0,0,3,0,-3
4687,1,1,1203,1508,305
4688,1,0,54,0,-54
4689,0,0,68,0,-68
4690,1,0,17,0,-17
4691,0,0,29,0,-29
4692,1,1,36,1362,1326
4693,1,0,85,0,-85
4694,1,1,1286,2132,846
4695,1,0,18,0,-18
4696,0,0,62,0,-62
4697,0,0,48,0,-48
4698,0,0,59,0,-59
4699,0,0,17,0,-17
4700,0,0,26,0,-26
4701,0,0,22,0,-22
4702,1,0,171,0,-171
4703,0,0,6,0,-6
4704,1,0,268,0,-268
4705,0,0,61,0,-61
4706,1,1,1213,1351,138
4707,1,1,642,2509,1867
4708,0,0,37,0,-37
4709,0,0,31,0,-31
4710,1,0,34,0,-34
4711,1,0,6,0,-6
4712,1,1,57,1378,1321
4713,0,0,73,0,-73
4714,0,0,92,0,-92
4715,0,0,16,0,-16
4716,0,0,8,0,-8
4717,1,0,0,0,0
4718,1,1,149,1236,1087
4719,1,1,210,1265,1055
4720,1,0,11,0,-11
4721,0,0,203,0,-203
4722,1,0,98,0,-98
4723,0,0,54,0,-54
4724,1,0,12,0,-12
4725,0,0,14,0,-14
4726,1,1,153,1775,1622
4727,1,0,57,0,-57
4728,1,0,15,0,-15
4729,1,0,64,0,-64
4730,1,1,2290,1335,-955
4731,0,0,4,0,-4
4732,1,0,1,0,-1
4733,1,0,36,0,-36
4734,1,1,1038,1721,683
4735,1,1,514,1421,907
4736,1,1,1403,1623,220
4737,0,0,174,0,-174
4738,1,0,77,0,-77
4739,0,0,60,0,-60
4740,1,0,10,0,-10
4741,1,1,149,1314,1165
4742,0,0,227,0,-227
4743,0,0,36,0,-36
4744,1,0,65,0,-65
4745,1,0,82,0,-82
4746,0,0,40,0,-40
4747,0,0,186,0,-186
4748,0,0,26,0,-26
4749,1,0,13,0,-13
4750,1,0,16,0,-16
4751,1,1,566,1265,699
4752,0,0,127,0,-127
4753,1,0,9,0,-9
4754,0,0,4,0,-4
4755,1,0,42,0,-42
4756,1,1,1303,1658,355
4757,1,0,22,0,-22
4758,1,0,139,0,-139
4759,1,0,37,0,-37
4760,1,1,1166,1772,606
4761,0,0,15,0,-15
4762,0,0,3,0,-3
4763,1,0,15,0,-15
4764,1,1,2098,1326,-772
4765,1,0,38,0,-38
4766,1,0,26,0,-26
4767,1,1,291,1317,1026
4768,0,0,13,0,-13
4769,0,0,224,0,-224
4770,0,0,23,0,-23
4771,0,0,219,0,-219
4772,1,1,284,1630,1346
4773,1,0,30,0,-30
4774,1,1,521,1457,936
4775,1,1,438,1495,1057
4776,0,0,40,0,-40
4777,1,0,30,0,-30
4778,1,0,25,0,-25
4779,0,0,75,0,-75
4780,1,0,41,0,-41
4781,0,0,24,0,-24
4782,1,0,51,0,-51
4783,1,0,103,0,-103
4784,0,0,1,0,-1
4785,0,0,40,0,-40
4786,1,0,22,0,-22
4787,0,0,10,0,-10
4788,1,0,6,0,-6
4789,1,0,9,0,-9
4790,1,1,690,1333,643
4791,1,0,85,0,-85
4792,0,0,68,0,-68
4793,1,1,604,2109,1505
4794,1,1,61,2051,1990
4795,0,0,26,0,-26
4796,0,0,59,0,-59
4797,1,1,1635,1454,-181
4798,0,0,52,0,-52
4799,0,0,13,0,-13
4800,0,0,42,0,-42
4801,0,0,83,0,-83
4802,1,1,1281,1261,-20
4803,0,0,81,0,-81
4804,0,0,6,0,-6
4805,0,0,32,0,-32
4806,0,0,78,0,-78
4807,0,0,123,0,-123
4808,0,0,39,0,-39
4809,1,1,1234,1481,247
4810,1,0,25,0,-25
4811,1,0,16,0,-16
4812,1,1,261,1400,1139
4813,1,0,80,0,-80
4814,0,0,9,0,-9
4815,0,0,16,0,-16
4816,1,1,64,1412,1348
4817,1,0,16,0,-16
4818,0,0,58,0,-58
4819,0,0,42,0,-42
4820,1,0,30,0,-30
4821,0,0,63,0,-63
4822,0,0,7,0,-7
4823,1,0,24,0,-24
4824,0,0,46,0,-46
4825,1,0,28,0,-28
4826,1,1,1170,1570,400
4827,1,1,232,1413,1181
4828,0,0,80,0,-80
4829,1,1,871,1425,554
4830,0,0,46,0,-46
4831,1,1,91,1344,1253
4832,1,0,12,0,-12
4833,0,0,20,0,-20
4834,1,0,0,0,0
4835,0,0,7,0,-7
4836,1,1,80,1449,1369
4837,1,1,42,1247,1205
4838,0,0,70,0,-70
4839,1,1,177,1730,1553
4840,1,0,31,0,-31
4841,0,0,98,0,-98
4842,0,0,152,0,-152
4843,1,0,86,0,-86
4844,0,0,51,0,-51
4845,1,0,25,0,-25
4846,0,0,37,0,-37
4847,1,0,84,0,-84
4848,1,1,637,1888,1251
4849,0,0,30,0,-30
4850,1,1,432,1451,1019
4851,1,1,2049,1794,-255
4852,1,1,1156,1599,443
4853,1,1,452,1531,1079
4854,0,0,70,0,-70
4855,0,0,30,0,-30
4856,0,0,82,0,-82
4857,1,1,175,1273,1098
4858,0,0,34,0,-34
4859,0,0,4,0,-4
4860,0,0,65,0,-65
4861,1,1,375,1550,1175
4862,1,1,557,1898,1341
4863,0,0,58,0,-58
4864,0,0,142,0,-142
4865,0,0,141,0,-141
4866,0,0,19,0,-19
4867,1,0,3,0,-3
4868,1,1,358,1633,1275
4869,1,0,411,0,-411
4870,1,0,31,0,-31
4871,0,0,118,0,-118
4872,1,1,381,1404,1023
4873,1,0,68,0,-68
4874,0,0,32,0,-32
4875,1,0,96,0,-96
4876,0,0,5,0,-5
4877,1,0,37,0,-37
4878,1,1,514,1711,1197
4879,1,1,266,1467,1201
4880,1,1,140,1322,1182
4881,1,0,126,0,-126
4882,1,0,7,0,-7
4883,1,1,235,1725,1490
4884,0,0,42,0,-42
4885,1,1,661,1310,649
4886,1,1,489,1255,766
4887,1,1,310,1624,1314
4888,1,0,164,0,-164
4889,1,0,31,0,-31
4890,0,0,115,0,-115
4891,1,0,11,0,-11
4892,1,0,99,0,-99
4893,0,0,36,0,-36
4894,0,0,187,0,-187
4895,1,1,574,1369,795
4896,1,1,268,1377,1109
4897,1,1,141,1409,1268
4898,1,0,29,0,-29
4899,1,1,245,1342,1097
4900,0,0,10,0,-10
4901,1,0,64,0,-64
4902,1,0,2,0,-2
4903,1,1,149,7460,7311
4904,1,1,1690,1336,-354
4905,0,0,42,0,-42
4906,1,0,12,0,-12
4907,0,0,21,0,-21
4908,0,0,31,0,-31
4909,0,0,22,0,-22
4910,1,1,1321,1440,119
4911,0,0,21,0,-21
4912,0,0,70,0,-70
4913,1,0,74,0,-74
4914,0,0,36,0,-36
4915,1,1,179,1415,1236
4916,1,1,36,1379,1343
4917,1,1,123,1367,1244
4918,0,0,68,0,-68
4919,0,0,75,0,-75
4920,1,0,331,0,-331
4921,0,0,67,0,-67
4922,1,0,100,0,-100
4923,1,1,373,1912,1539
4924,0,0,10,0,-10
4925,1,0,23,0,-23
4926,0,0,41,0,-41
4927,1,0,20,0,-20
4928,1,1,533,1363,830
4929,1,0,134,0,-134
4930,1,1,727,1361,634
4931,0,0,37,0,-37
4932,1,0,40,0,-40
4933,1,1,230,2159,1929
4934,1,0,40,0,-40
4935,1,1,143,2013,1870
4936,0,0,18,0,-18
4937,0,0,13,0,-13
4938,0,0,242,0,-242
4939,0,0,4,0,-4
4940,1,0,3,0,-3
4941,0,0,50,0,-50
4942,1,1,1795,2022,227
4943,0,0,26,0,-26
4944,1,0,45,0,-45
4945,0,0,22,0,-22
4946,0,0,6,0,-6
4947,1,0,80,0,-80
4948,0,0,42,0,-42
4949,1,1,484,1649,1165
4950,1,1,673,1471,798
4951,0,0,24,0,-24
4952,0,0,117,0,-117
4953,1,1,204,1686,1482
4954,0,0,18,0,-18
4955,1,1,197,1343,1146
4956,0,0,12,0,-12
4957,1,1,109,1842,1733
4958,0,0,42,0,-42
4959,1,1,302,1748,1446
4960,1,0,36,0,-36
4961,0,0,177,0,-177
4962,1,1,452,1971,1519
4963,0,0,18,0,-18
4964,1,0,8,0,-8
4965,0,0,134,0,-134
4966,1,0,260,0,-260
4967,1,0,33,0,-33
4968,0,0,18,0,-18
4969,1,0,12,0,-12
4970,0,0,13,0,-13
4971,1,0,39,0,-39
4972,1,1,456,1328,872
4973,1,0,20,0,-20
4974,1,0,83,0,-83
4975,1,1,431,1934,1503
4976,1,0,37,0,-37
4977,1,1,769,1437,668
4978,1,0,8,0,-8
4979,0,0,29,0,-29
4980,0,0,1,0,-1
4981,0,0,113,0,-113
4982,0,0,92,0,-92
4983,1,0,65,0,-65
4984,0,0,44,0,-44
4985,0,0,16,0,-16
4986,1,1,144,1295,1151
4987,1,1,126,1942,1816
4988,0,0,29,0,-29
4989,0,0,140,0,-140
4990,1,0,32,0,-32
4991,0,0,46,0,-46
4992,0,0,10,0,-10
4993,1,0,67,0,-67
4994,1,1,384,1294,910
4995,0,0,63,0,-63
4996,1,0,63,0,-63
4997,0,0,77,0,-77
4998,0,0,64,0,-64
4999,1,0,2,0,-2
5000,1,1,1489,1463,-26
5001,1,0,9,0,-9
5002,1,1,1027,1304,277
5003,1,0,47,0,-47
5004,0,0,26,0,-26
5005,1,1,537,1765,1228
5006,0,0,8,0,-8
5007,1,0,29,0,-29
5008,1,0,37,0,-37
5009,0,0,88,0,-88
5010,0,0,40,0,-40
5011,1,1,513,1362,849
5012,1,0,50,0,-50
5013,1,0,5,0,-5
5014,0,0,22,0,-22
5015,1,1,382,1998,1616
5016,1,1,136,1368,1232
5017,1,1,398,1245,847
5018,1,1,401,1276,875
5019,0,0,131,0,-131
5020,1,0,165,0,-165
5021,0,0,57,0,-57
5022,1,1,112,1346,1234
5023,0,0,26,0,-26
5024,1,1,950,1398,448
5025,0,0,47,0,-47
5026,1,1,1185,1267,82
5027,1,1,870,1323,453
5028,0,0,43,0,-43
5029,1,0,135,0,-135
5030,0,0,11,0,-11
5031,1,0,0,0,0
5032,1,0,202,0,-202
5033,1,1,732,2521,1789
5034,1,1,483,1441,958
5035,1,1,260,1325,1065
5036,1,1,694,2094,1400
5037,0,0,12,0,-12
5038,0,0,46,0,-46
5039,0,0,3,0,-3
5040,0,0,66,0,-66
5041,1,0,25,0,-25
5042,0,0,22,0,-22
5043,1,0,42,0,-42
5044,0,0,23,0,-23
5045,1,1,437,1527,1090
5046,0,0,66,0,-66
5047,1,1,383,1281,898
5048,1,0,23,0,-23
5049,0,0,15,0,-15
5050,1,1,48,1741,1693
5051,1,0,3,0,-3
5052,1,0,68,0,-68
5053,1,1,737,1298,561
5054,1,0,110,0,-110
5055,1,1,478,2066,1588
5056,1,1,266,1252,986
5057,1,0,4,0,-4
5058,0,0,27,0,-27
5059,0,0,22,0,-22
5060,1,1,173,1725,1552
5061,1,1,133,1564,1431
5062,1,0,60,0,-60
5063,1,0,7,0,-7
5064,1,0,5,0,-5
5065,0,0,90,0,-90
5066,0,0,9,0,-9
5067,0,0,35,0,-35
5068,1,0,55,0,-55
5069,0,0,19,0,-19
5070,0,0,41,0,-41
5071,1,0,5,0,-5
5072,0,0,21,0,-21
5073,1,1,190,1339,1149
5074,0,0,133,0,-133
5075,1,1,670,1593,923
5076,1,1,165,1490,1325
5077,1,1,85,1497,1412
5078,1,0,6,0,-6
5079,1,0,87,0,-87
5080,1,1,662,1700,1038
5081,0,0,4,0,-4
5082,0,0,29,0,-29
5083,0,0,15,0,-15
5084,0,0,17,0,-17
5085,1,0,10,0,-10
5086,1,1,2132,1839,-293
5087,1,0,17,0,-17
5088,1,1,374,1291,917
5089,1,0,62,0,-62
5090,1,0,171,0,-171
5091,0,0,0,0,0
5092,1,0,1,0,-1
5093,1,1,629,1929,1300
5094,0,0,63,0,-63
5095,0,0,60,0,-60
5096,1,1,1917,1280,-637
5097,0,0,4,0,-4
5098,0,0,1,0,-1
5099,0,0,1,0,-1
5100,1,1,233,1771,1538
5101,0,0,26,0,-26
5102,1,1,582,1245,663
5103,1,1,87,2300,2213
5104,1,1,7,1306,1299
5105,1,0,51,0,-51
5106,0,0,36,0,-36
5107,1,0,86,0,-86
5108,1,0,77,0,-77
5109,0,0,126,0,-126
5110,1,1,439,1335,896
5111,1,0,39,0,-39
5112,1,1,513,1244,731
5113,0,0,69,0,-69
5114,0,0,21,0,-21
5115,0,0,9,0,-9
5116,1,0,22,0,-22
5117,1,0,5,0,-5
5118,0,0,14,0,-14
5119,1,1,411,1958,1547
5120,0,0,23,0,-23
5121,0,0,1,0,-1
5122,0,0,274,0,-274
5123,0,0,81,0,-81
5124,1,1,300,1287,987
5125,0,0,40,0,-40
5126,1,1,321,1251,930
5127,0,0,178,0,-178
5128,0,0,51,0,-51
5129,0,0,6,0,-6
5130,0,0,114,0,-114
5131,0,0,15,0,-15
5132,0,0,5,0,-5
5133,0,0,4,0,-4
5134,0,0,19,0,-19
5135,1,0,94,0,-94
5136,0,0,13,0,-13
5137,0,0,13,0,-13
5138,1,1,67,1408,1341
5139,1,1,391,2888,2497
5140,0,0,79,0,-79
5141,0,0,13,0,-13
5142,1,1,652,1550,898
5143,1,0,6,0,-6
5144,0,0,66,0,-66
5145,0,0,6,0,-6
5146,1,0,271,0,-271
5147,0,0,0,0,0
5148,1,0,71,0,-71
5149,1,0,14,0,-14
5150,1,0,80,0,-80
5151,0,0,50,0,-50
5152,1,0,27,0,-27
5153,0,0,111,0,-111
5154,1,1,426,1261,835
5155,1,1,314,1458,1144
5156,0,0,62,0,-62
5157,0,0,125,0,-125
5158,0,0,10,0,-10
5159,0,0,20,0,-20
5160,0,0,23,0,-23
5161,0,0,124,0,-124
5162,1,0,105,0,-105
5163,1,0,44,0,-44
5164,0,0,127,0,-127
5165,1,1,516,1891,1375
5166,0,0,72,0,-72
5167,1,0,35,0,-35
5168,1,0,28,0,-28
5169,1,0,33,0,-33
5170,1,0,10,0,-10
5171,1,0,71,0,-71
5172,1,0,27,0,-27
5173,1,1,286,1676,1390
5174,1,1,1262,1333,71
5175,0,0,93,0,-93
5176,1,1,756,1310,554
5177,0,0,59,0,-59
5178,1,0,19,0,-19
5179,1,1,330,1864,1534
5180,0,0,22,0,-22
5181,0,0,46,0,-46
5182,0,0,24,0,-24
5183,1,1,1042,1513,471
5184,1,1,919,1258,339
5185,1,0,44,0,-44
5186,0,0,37,0,-37
5187,1,0,37,0,-37
5188,0,0,143,0,-143
5189,0,0,118,0,-118
5190,0,0,59,0,-59
5191,1,0,103,0,-103
5192,0,0,62,0,-62
5193,1,1,665,1443,778
5194,0,0,65,0,-65
5195,1,0,125,0,-125
5196,1,0,101,0,-101
5197,0,0,65,0,-65
5198,0,0,132,0,-132
5199,1,0,9,0,-9
5200,1,0,215,0,-215
5201,1,0,25,0,-25
5202,0,0,39,0,-39
5203,1,1,63,1366,1303
5204,1,1,806,2788,1982
5205,0,0,148,0,-148
5206,1,1,201,1958,1757
5207,0,0,111,0,-111
5208,1,1,553,1434,881
5209,0,0,4,0,-4
5210,1,0,10,0,-10
5211,1,1,78,1513,1435
5212,0,0,283,0,-283
5213,0,0,40,0,-40
5214,1,1,430,1263,833
5215,1,0,3,0,-3
5216,0,0,12,0,-12
5217,0,0,33,0,-33
5218,1,1,603,1355,752
5219,1,1,133,1296,1163
5220,1,0,6,0,-6
5221,1,1,382,1280,898
5222,1,1,355,1245,890
5223,0,0,36,0,-36
5224,1,1,221,1960,1739
5225,1,1,576,1289,713
5226,1,0,3,0,-3
5227,1,0,153,0,-153
5228,0,0,65,0,-65
5229,1,0,61,0,-61
5230,0,0,54,0,-54
5231,0,0,29,0,-29
5232,0,0,9,0,-9
5233,1,0,18,0,-18
5234,0,0,34,0,-34
5235,1,0,46,0,-46
5236,1,1,795,1391,596
5237,0,0,18,0,-18
5238,1,0,35,0,-35
5239,1,1,353,1437,1084
5240,0,0,40,0,-40
5241,1,1,1140,1782,642
5242,1,1,607,1572,965
5243,1,0,29,0,-29
5244,1,0,68,0,-68
5245,0,0,37,0,-37
5246,1,1,299,1516,1217
5247,1,0,4,0,-4
5248,0,0,8,0,-8
5249,0,0,48,0,-48
5250,0,0,75,0,-75
5251,1,0,59,0,-59
5252,0,0,44,0,-44
5253,0,0,17,0,-17
5254,0,0,87,0,-87
5255,1,0,223,0,-223
5256,1,0,74,0,-74
5257,1,1,93,1414,1321
5258,0,0,33,0,-33
5259,1,0,12,0,-12
5260,0,0,9,0,-9
5261,1,1,256,1456,1200
5262,0,0,37,0,-37
5263,0,0,131,0,-131
5264,1,0,56,0,-56
5265,1,0,14,0,-14
5266,1,0,138,0,-138
5267,0,0,30,0,-30
5268,0,0,16,0,-16
5269,1,0,140,0,-140
5270,0,0,32,0,-32
5271,1,0,47,0,-47
5272,1,1,111,1682,1571
5273,0,0,24,0,-24
5274,1,0,32,0,-32
5275,0,0,73,0,-73
5276,1,0,4,0,-4
5277,1,0,78,0,-78
5278,1,1,876,1465,589
5279,1,1,525,1996,1471
5280,1,1,1978,3015,1037
5281,1,1,376,2606,2230
5282,1,1,504,1451,947
5283,1,1,631,1267,636
5284,0,0,10,0,-10
5285,0,0,11,0,-11
5286,1,1,14,1323,1309
5287,1,1,1200,1378,178
5288,1,1,445,1263,818
5289,0,0,139,0,-139
5290,1,0,3,0,-3
5291,1,0,38,0,-38
5292,0,0,12,0,-12
5293,1,0,37,0,-37
5294,0,0,23,0,-23
5295,0,0,84,0,-84
5296,1,1,741,1255,514
5297,0,0,10,0,-10
5298,1,1,601,1411,810
5299,1,1,376,1369,993
5300,0,0,57,0,-57
5301,0,0,33,0,-33
5302,1,0,34,0,-34
5303,1,1,1527,1798,271
5304,1,0,3,0,-3
5305,0,0,302,0,-302
5306,0,0,232,0,-232
5307,1,0,61,0,-61
5308,0,0,79,0,-79
5309,1,1,917,1704,787
5310,0,0,18,0,-18
5311,1,1,396,1472,1076
5312,1,1,972,1480,508
5313,0,0,19,0,-19
5314,1,0,39,0,-39
5315,1,1,152,1276,1124
5316,1,1,799,1460,661
5317,1,1,424,1237,813
5318,1,1,146,1321,1175
5319,0,0,63,0,-63
5320,1,0,22,0,-22
5321,1,0,158,0,-158
5322,1,1,1402,1243,-159
5323,0,0,36,0,-36
5324,1,1,761,1409,648
5325,0,0,0,0,0
5326,0,0,30,0,-30
5327,1,1,759,1703,944
5328,0,0,82,0,-82
5329,0,0,23,0,-23
5330,1,1,98,1416,1318
5331,0,0,3,0,-3
5332,1,1,1185,1460,275
5333,0,0,34,0,-34
5334,0,0,19,0,-19
5335,1,1,293,1901,1608
5336,1,1,145,1529,1384
5337,1,1,101,2043,1942
5338,1,0,2,0,-2
5339,0,0,26,0,-26
5340,1,0,60,0,-60
5341,1,0,0,0,0
5342,1,1,235,1422,1187
5343,0,0,41,0,-41
5344,0,0,11,0,-11
5345,1,1,993,1350,357
5346,0,0,58,0,-58
5347,1,0,20,0,-20
5348,1,0,184,0,-184
5349,1,0,29,0,-29
5350,0,0,48,0,-48
5351,0,0,4,0,-4
5352,1,0,5,0,-5
5353,1,0,205,0,-205
5354,0,0,10,0,-10
5355,0,0,70,0,-70
5356,1,0,67,0,-67
5357,0,0,17,0,-17
5358,1,1,139,3409,3270
5359,0,0,32,0,-32
5360,0,0,18,0,-18
5361,1,0,17,0,-17
5362,1,0,163,0,-163
5363,1,0,26,0,-26
5364,1,1,238,1239,1001
5365,1,1,162,1363,1201
5366,1,0,20,0,-20
5367,1,0,0,0,0
5368,0,0,24,0,-24
5369,0,0,3,0,-3
5370,1,1,865,1714,849
5371,1,1,130,1298,1168
5372,0,0,3,0,-3
5373,0,0,16,0,-16
5374,0,0,81,0,-81
5375,1,1,849,1937,1088
5376,1,1,1849,1252,-597
5377,1,1,415,1352,937
5378,0,0,24,0,-24
5379,1,1,584,1399,815
5380,1,0,98,0,-98
5381,1,1,610,1404,794
5382,1,0,53,0,-53
5383,1,0,60,0,-60
5384,1,0,45,0,-45
5385,0,0,11,0,-11
5386,1,0,16,0,-16
5387,0,0,139,0,-139
5388,0,0,54,0,-54
5389,0,0,38,0,-38
5390,0,0,2,0,-2
5391,1,1,488,1705,1217
5392,1,1,445,1315,870
5393,1,0,14,0,-14
5394,1,1,948,1857,909
5395,1,1,415,1360,945
5396,0,0,14,0,-14
5397,1,0,10,0,-10
5398,1,1,140,1259,1119
5399,0,0,7,0,-7
5400,0,0,16,0,-16
5401,1,0,6,0,-6
5402,0,0,59,0,-59
5403,1,1,462,1422,960
5404,1,1,680,1306,626
5405,0,0,16,0,-16
5406,1,1,192,1522,1330
5407,0,0,74,0,-74
5408,0,0,43,0,-43
5409,0,0,10,0,-10
5410,1,0,65,0,-65
5411,1,0,159,0,-159
5412,1,1,169,2009,1840
5413,1,1,328,1467,1139
5414,0,0,8,0,-8
5415,1,1,189,1838,1649
5416,1,0,7,0,-7
5417,1,1,1085,1249,164
5418,1,1,546,1375,829
5419,0,0,3,0,-3
5420,1,1,699,1992,1293
5421,1,1,331,2269,1938
5422,0,0,54,0,-54
5423,1,1,351,1394,1043
5424,0,0,18,0,-18
5425,0,0,42,0,-42
5426,1,1,584,1663,1079
5427,1,0,65,0,-65
5428,1,0,60,0,-60
5429,1,1,807,1845,1038
5430,0,0,49,0,-49
5431,1,1,73,1466,1393
5432,0,0,52,0,-52
5433,1,0,88,0,-88
5434,1,1,74,1512,1438
5435,1,1,277,1354,1077
5436,1,1,189,1436,1247
5437,1,1,1575,1786,211
5438,0,0,7,0,-7
5439,0,0,52,0,-52
5440,0,0,10,0,-10
5441,1,0,174,0,-174
5442,1,0,37,0,-37
5443,1,1,443,1421,978
5444,0,0,12,0,-12
5445,1,0,3,0,-3
5446,0,0,134,0,-134
5447,1,1,1388,1470,82
5448,1,1,155,1296,1141
5449,1,1,584,1341,757
5450,1,0,8,0,-8
5451,1,0,97,0,-97
5452,0,0,70,0,-70
5453,0,0,41,0,-41
5454,1,1,320,1608,1288
5455,0,0,16,0,-16
5456,1,0,16,0,-16
5457,1,0,68,0,-68
5458,1,0,14,0,-14
5459,0,0,61,0,-61
5460,0,0,26,0,-26
5461,0,0,32,0,-32
5462,0,0,88,0,-88
5463,1,1,402,1252,850
5464,1,1,190,1512,1322
5465,1,0,30,0,-30
5466,1,0,19,0,-19
5467,1,0,10,0,-10
5468,1,0,25,0,-25
5469,1,1,1893,1807,-86
5470,1,0,18,0,-18
5471,0,0,19,0,-19
5472,1,0,71,0,-71
5473,0,0,5,0,-5
5474,1,1,720,2064,1344
5475,0,0,81,0,-81
5476,1,0,90,0,-90
5477,0,0,22,0,-22
5478,1,0,39,0,-39
5479,1,0,11,0,-11
5480,1,0,176,0,-176
5481,0,0,39,0,-39
5482,0,0,2,0,-2
5483,1,0,10,0,-10
5484,0,0,44,0,-44
5485,1,1,173,1533,1360
5486,1,1,19,1246,1227
5487,1,1,475,1347,872
5488,1,1,336,1702,1366
5489,1,0,62,0,-62
5490,1,1,1111,1402,291
5491,0,0,18,0,-18
5492,0,0,49,0,-49
5493,1,1,1341,1384,43
5494,1,0,240,0,-240
5495,1,0,3,0,-3
5496,1,0,37,0,-37
5497,1,0,150,0,-150
5498,1,1,1141,1622,481
5499,1,1,878,2251,1373
5500,0,0,93,0,-93
5501,1,1,1424,1306,-118
5502,1,0,1,0,-1
5503,0,0,78,0,-78
5504,1,0,49,0,-49
5505,0,0,40,0,-40
5506,0,0,166,0,-166
5507,1,0,29,0,-29
5508,0,0,30,0,-30
5509,1,0,43,0,-43
5510,1,0,24,0,-24
5511,0,0,22,0,-22
5512,0,0,23,0,-23
5513,0,0,94,0,-94
5514,0,0,16,0,-16
5515,0,0,27,0,-27
5516,1,0,83,0,-83
5517,0,0,169,0,-169
5518,1,1,57,2045,1988
5519,0,0,5,0,-5
5520,1,1,1099,2222,1123
5521,1,0,4,0,-4
5522,0,0,101,0,-101
5523,0,0,47,0,-47
5524,0,0,86,0,-86
5525,0,0,13,0,-13
5526,1,0,19,0,-19
5527,1,0,100,0,-100
5528,0,0,4,0,-4
5529,0,0,110,0,-110
5530,1,0,31,0,-31
5531,1,1,911,1359,448
5532,0,0,65,0,-65
5533,0,0,20,0,-20
5534,1,0,75,0,-75
5535,0,0,133,0,-133
5536,0,0,34,0,-34
5537,1,1,984,1302,318
5538,0,0,21,0,-21
5539,1,1,46,1291,1245
5540,0,0,39,0,-39
5541,1,1,616,1580,964
5542,1,1,130,1759,1629
5543,1,1,272,1624,1352
5544,0,0,0,0,0
5545,0,0,14,0,-14
5546,0,0,154,0,-154
5547,1,1,731,1675,944
5548,1,1,429,2198,1769
5549,1,1,192,1844,1652
5550,1,0,5,0,-5
5551,0,0,64,0,-64
5552,1,0,95,0,-95
5553,1,1,245,1250,1005
5554,1,0,16,0,-16
5555,1,0,82,0,-82
5556,0,0,17,0,-17
5557,0,0,88,0,-88
5558,1,1,16,1991,1975
5559,1,1,579,1313,734
5560,1,1,206,1395,1189
5561,0,0,98,0,-98
5562,1,0,42,0,-42
5563,1,0,132,0,-132
5564,1,1,468,2710,2242
5565,0,0,76,0,-76
5566,1,0,33,0,-33
5567,0,0,34,0,-34
5568,1,0,58,0,-58
5569,1,0,32,0,-32
5570,0,0,101,0,-101
5571,0,0,6,0,-6
5572,0,0,6,0,-6
5573,1,0,2,0,-2
5574,0,0,132,0,-132
5575,1,0,10,0,-10
5576,1,1,78,1285,1207
5577,1,1,81,1377,1296
5578,1,0,7,0,-7
5579,1,0,55,0,-55
5580,1,1,686,1586,900
5581,1,1,594,1404,810
5582,1,0,19,0,-19
5583,1,0,12,0,-12
5584,1,1,424,1630,1206
5585,1,0,56,0,-56
5586,1,0,42,0,-42
5587,0,0,27,0,-27
5588,1,0,84,0,-84
5589,0,0,8,0,-8
5590,0,0,59,0,-59
5591,0,0,19,0,-19
5592,1,0,18,0,-18
5593,0,0,187,0,-187
5594,1,0,111,0,-111
5595,1,1,332,1257,925
5596,1,0,2,0,-2
5597,1,0,6,0,-6
5598,0,0,26,0,-26
5599,0,0,13,0,-13
5600,1,0,7,0,-7
5601,1,1,115,1752,1637
5602,0,0,71,0,-71
5603,1,1,800,1504,704
5604,1,1,473,2045,1572
5605,1,0,29,0,-29
5606,0,0,39,0,-39
5607,0,0,113,0,-113
5608,1,0,18,0,-18
5609,1,1,276,1451,1175
5610,1,0,46,0,-46
5611,1,0,96,0,-96
5612,0,0,39,0,-39
5613,0,0,37,0,-37
5614,1,0,25,0,-25
5615,1,0,11,0,-11
5616,1,0,46,0,-46
5617,1,0,0,0,0
5618,1,0,62,0,-62
5619,1,0,33,0,-33
5620,1,0,33,0,-33
5621,1,1,374,1470,1096
5622,1,1,66,1472,1406
5623,1,1,477,2924,2447
5624,1,1,713,1860,1147
5625,0,0,101,0,-101
5626,1,1,771,1246,475
5627,1,0,30,0,-30
5628,1,1,806,1625,819
5629,0,0,52,0,-52
5630,1,1,506,1296,790
5631,1,1,355,1462,1107
5632,1,0,2,0,-2
5633,0,0,24,0,-24
5634,1,1,29,1299,1270
5635,0,0,33,0,-33
5636,0,0,87,0,-87
5637,1,1,371,2884,2513
5638,0,0,77,0,-77
5639,0,0,9,0,-9
5640,0,0,26,0,-26
5641,0,0,83,0,-83
5642,1,0,3,0,-3
5643,1,1,1758,2056,298
5644,1,0,89,0,-89
5645,0,0,0,0,0
5646,1,0,21,0,-21
5647,1,0,50,0,-50
5648,1,0,33,0,-33
5649,1,1,268,1658,1390
5650,1,1,743,1394,651
5651,1,0,66,0,-66
5652,0,0,96,0,-96
5653,1,1,163,1320,1157
5654,1,1,581,1271,690
5655,0,0,33,0,-33
5656,0,0,70,0,-70
5657,1,1,641,1482,841
5658,1,0,26,0,-26
5659,0,0,149,0,-149
5660,0,0,61,0,-61
5661,0,0,81,0,-81
5662,0,0,16,0,-16
5663,1,1,285,1386,1101
5664,1,0,98,0,-98
5665,1,1,1604,1268,-336
5666,0,0,1,0,-1
5667,0,0,56,0,-56
5668,0,0,14,0,-14
5669,0,0,0,0,0
5670,1,1,861,1824,963
5671,1,0,22,0,-22
5672,0,0,11,0,-11
5673,0,0,6,0,-6
5674,0,0,114,0,-114
5675,1,1,579,1445,866
5676,1,1,1072,1908,836
5677,1,1,575,1512,937
5678,0,0,5,0,-5
5679,1,0,108,0,-108
5680,0,0,22,0,-22
5681,0,0,35,0,-35
5682,0,0,42,0,-42
5683,1,1,259,1248,989
5684,1,1,500,1691,1191
5685,1,1,1460,1769,309
5686,1,1,353,1414,1061
5687,0,0,27,0,-27
5688,1,1,344,1486,1142
5689,0,0,18,0,-18
5690,1,0,45,0,-45
5691,1,0,45,0,-45
5692,1,1,776,2142,1366
5693,0,0,10,0,-10
5694,1,1,588,1649,1061
5695,1,1,952,1398,446
5696,1,0,61,0,-61
5697,0,0,18,0,-18
5698,1,0,153,0,-153
5699,1,1,125,1403,1278
5700,0,0,98,0,-98
5701,0,0,19,0,-19
5702,1,1,115,1337,1222
5703,0,0,80,0,-80
5704,1,0,219,0,-219
5705,1,1,406,1275,869
5706,0,0,45,0,-45
5707,1,0,36,0,-36
5708,1,0,82,0,-82
5709,0,0,35,0,-35
5710,0,0,19,0,-19
5711,0,0,32,0,-32
5712,1,1,194,1247,1053
5713,0,0,118,0,-118
5714,0,0,0,0,0
5715,1,1,143,1483,1340
5716,1,1,911,1354,443
5717,1,1,796,1311,515
5718,1,1,716,1562,846
5719,1,1,464,1388,924
5720,1,1,450,1780,1330
5721,1,1,175,1353,1178
5722,1,1,814,1694,880
5723,1,0,53,0,-53
5724,1,0,34,0,-34
5725,0,0,57,0,-57
5726,1,0,85,0,-85
5727,0,0,142,0,-142
5728,1,1,646,1263,617
5729,1,0,28,0,-28
5730,1,0,17,0,-17
5731,1,1,303,1458,1155
5732,0,0,14,0,-14
5733,0,0,79,0,-79
5734,1,0,2,0,-2
5735,1,0,99,0,-99
5736,0,0,3,0,-3
5737,1,0,38,0,-38
5738,1,1,489,1354,865
5739,0,0,86,0,-86
5740,0,0,89,0,-89
5741,0,0,38,0,-38
5742,1,1,270,1376,1106
5743,1,1,1002,1829,827
5744,1,1,80,1387,1307
5745,0,0,12,0,-12
5746,1,1,445,1518,1073
5747,1,0,113,0,-113
5748,1,1,20,1620,1600
5749,0,0,8,0,-8
5750,1,0,120,0,-120
5751,1,1,33,1248,1215
5752,1,0,23,0,-23
5753,0,0,224,0,-224
5754,0,0,10,0,-10
5755,1,1,127,1452,1325
5756,1,1,397,1326,929
5757,0,0,54,0,-54
5758,0,0,31,0,-31
5759,1,0,13,0,-13
5760,0,0,52,0,-52
5761,0,0,82,0,-82
5762,0,0,5,0,-5
5763,0,0,19,0,-19
5764,1,1,67,1277,1210
5765,1,0,0,0,0
5766,0,0,26,0,-26
5767,1,1,375,1502,1127
5768,0,0,2,0,-2
5769,1,0,19,0,-19
5770,1,1,478,1674,1196
5771,1,0,75,0,-75
5772,1,0,63,0,-63
5773,1,1,388,1325,937
5774,1,1,732,1399,667
5775,1,0,126,0,-126
5776,1,0,58,0,-58
5777,1,0,25,0,-25
5778,1,0,130,0,-130
5779,0,0,43,0,-43
5780,0,0,72,0,-72
5781,1,1,2081,2338,257
5782,1,1,741,2213,1472
5783,1,0,50,0,-50
5784,0,0,33,0,-33
5785,0,0,10,0,-10
5786,0,0,98,0,-98
5787,0,0,64,0,-64
5788,1,0,36,0,-36
5789,0,0,35,0,-35
5790,0,0,32,0,-32
5791,1,1,502,1494,992
5792,0,0,73,0,-73
5793,1,0,43,0,-43
5794,1,0,34,0,-34
5795,0,0,30,0,-30
5796,1,1,286,1416,1130
5797,1,1,260,1690,1430
5798,1,1,979,1258,279
5799,1,0,97,0,-97
5800,1,1,89,1823,1734
5801,1,1,604,1331,727
5802,1,1,783,1484,701
5803,1,0,35,0,-35
5804,1,1,164,1646,1482
5805,1,0,114,0,-114
5806,0,0,5,0,-5
5807,0,0,9,0,-9
5808,1,0,24,0,-24
5809,1,1,233,1434,1201
5810,1,1,377,1543,1166
5811,0,0,28,0,-28
5812,0,0,36,0,-36
5813,1,1,828,2328,1500
5814,1,1,966,1932,966
5815,1,1,213,1278,1065
5816,0,0,6,0,-6
5817,0,0,32,0,-32
5818,1,1,567,1265,698
5819,1,1,424,1328,904
5820,1,1,406,2202,1796
5821,1,1,171,1364,1193
5822,0,0,10,0,-10
5823,1,0,2,0,-2
5824,1,0,26,0,-26
5825,0,0,43,0,-43
5826,1,0,17,0,-17
5827,1,0,123,0,-123
5828,1,1,1897,1275,-622
5829,1,1,603,1397,794
5830,1,1,1044,1712,668
5831,0,0,68,0,-68
5832,1,0,29,0,-29
5833,1,1,417,1457,1040
5834,0,0,71,0,-71
5835,1,1,87,1274,1187
5836,0,0,5,0,-5
5837,1,1,546,1372,826
5838,1,1,198,1280,1082
5839,0,0,29,0,-29
5840,0,0,13,0,-13
5841,1,1,373,1804,1431
5842,0,0,51,0,-51
5843,0,0,80,0,-80
5844,1,1,1973,1546,-427
5845,0,0,3,0,-3
5846,1,0,10,0,-10
5847,0,0,77,0,-77
5848,1,0,17,0,-17
5849,0,0,31,0,-31
5850,0,0,24,0,-24
5851,1,0,69,0,-69
5852,1,1,172,1270,1098
5853,1,1,612,4406,3794
5854,1,1,787,1374,587
5855,1,0,13,0,-13
5856,1,1,710,3825,3115
5857,1,0,42,0,-42
5858,1,1,1288,1268,-20
5859,0,0,116,0,-116
5860,0,0,4,0,-4
5861,0,0,21,0,-21
5862,0,0,55,0,-55
5863,1,0,38,0,-38
5864,1,0,59,0,-59
5865,0,0,4,0,-4
5866,1,1,325,1777,1452
5867,1,1,363,1346,983
5868,0,0,23,0,-23
5869,0,0,28,0,-28
5870,0,0,21,0,-21
5871,1,1,549,1362,813
5872,0,0,5,0,-5
5873,0,0,15,0,-15
5874,0,0,61,0,-61
5875,1,1,416,1924,1508
5876,1,1,390,1283,893
5877,0,0,23,0,-23
5878,1,1,347,1767,1420
5879,1,0,226,0,-226
5880,0,0,0,0,0
5881,0,0,13,0,-13
5882,1,1,897,1658,761
5883,0,0,28,0,-28
5884,0,0,136,0,-136
5885,1,1,977,1280,303
5886,1,1,69,1949,1880
5887,1,0,16,0,-16
5888,0,0,33,0,-33
5889,1,1,239,1770,1531
5890,1,0,48,0,-48
5891,0,0,57,0,-57
5892,1,0,182,0,-182
5893,1,1,381,1435,1054
5894,1,0,31,0,-31
5895,1,1,307,1309,1002
5896,1,0,90,0,-90
5897,1,1,648,1238,590
5898,1,1,437,1258,821
5899,1,0,21,0,-21
5900,1,0,30,0,-30
5901,1,1,1039,1964,925
5902,0,0,40,0,-40
5903,1,1,326,1392,1066
5904,1,1,383,1278,895
5905,0,0,60,0,-60
5906,1,1,269,1772,1503
5907,0,0,2,0,-2
5908,0,0,8,0,-8
5909,1,1,652,1408,756
5910,0,0,48,0,-48
5911,1,0,40,0,-40
5912,0,0,44,0,-44
5913,1,1,486,1434,948
5914,0,0,23,0,-23
5915,1,0,43,0,-43
5916,1,1,477,1505,1028
5917,0,0,50,0,-50
5918,1,0,0,0,0
5919,0,0,4,0,-4
5920,1,0,158,0,-158
5921,1,1,288,3840,3552
5922,1,0,190,0,-190
5923,0,0,41,0,-41
5924,1,0,1,0,-1
5925,1,0,4,0,-4
5926,0,0,79,0,-79
5927,0,0,2,0,-2
5928,0,0,51,0,-51
5929,1,1,876,1858,982
5930,1,1,785,1492,707
5931,1,0,6,0,-6
5932,0,0,47,0,-47
5933,1,0,7,0,-7
5934,1,1,1413,1707,294
5935,0,0,21,0,-21
5936,0,0,44,0,-44
5937,0,0,24,0,-24
5938,1,0,74,0,-74
5939,1,0,108,0,-108
5940,1,1,1894,2083,189
5941,0,0,39,0,-39
5942,1,0,27,0,-27
5943,1,0,89,0,-89
5944,1,0,134,0,-134
5945,1,0,55,0,-55
5946,0,0,51,0,-51
5947,1,0,6,0,-6
5948,1,1,212,1257,1045
5949,1,0,41,0,-41
5950,1,0,17,0,-17
5951,0,0,58,0,-58
5952,1,0,1,0,-1
5953,0,0,106,0,-106
5954,1,0,24,0,-24
5955,0,0,207,0,-207
5956,1,1,340,1504,1164
5957,1,0,32,0,-32
5958,0,0,19,0,-19
5959,1,0,38,0,-38
5960,1,0,28,0,-28
5961,1,0,31,0,-31
5962,1,0,135,0,-135
5963,1,0,3,0,-3
5964,0,0,17,0,-17
5965,1,0,134,0,-134
5966,0,0,38,0,-38
5967,1,0,10,0,-10
5968,1,0,200,0,-200
5969,1,1,168,2005,1837
5970,1,0,141,0,-141
5971,1,1,945,1543,598
5972,0,0,219,0,-219
5973,1,1,334,1237,903
5974,0,0,91,0,-91
5975,0,0,48,0,-48
5976,0,0,26,0,-26
5977,0,0,115,0,-115
5978,0,0,65,0,-65
5979,1,0,4,0,-4
5980,1,1,945,2870,1925
5981,1,0,9,0,-9
5982,0,0,65,0,-65
5983,1,1,191,1570,1379
5984,1,0,64,0,-64
5985,0,0,40,0,-40
5986,1,1,753,1577,824
5987,0,0,50,0,-50
5988,1,0,9,0,-9
5989,1,1,716,2204,1488
5990,0,0,23,0,-23
5991,1,0,27,0,-27
5992,1,0,0,0,0
5993,1,0,2,0,-2
5994,0,0,57,0,-57
5995,1,0,172,0,-172
5996,1,1,136,1781,1645
5997,1,1,874,1569,695
5998,1,1,1024,1283,259
5999,1,1,29,2925,2896
6000,0,0,122,0,-122
6001,1,0,35,0,-35
6002,1,1,59,1690,1631
6003,0,0,1,0,-1
6004,1,1,821,1757,936
6005,0,0,11,0,-11
6006,1,1,52,1503,1451
6007,1,0,10,0,-10
6008,1,0,26,0,-26
6009,1,0,26,0,-26
6010,0,0,252,0,-252
6011,0,0,45,0,-45
6012,1,0,10,0,-10
6013,1,1,118,1290,1172
6014,1,0,89,0,-89
6015,0,0,77,0,-77
6016,0,0,86,0,-86
6017,1,0,141,0,-141
6018,1,1,175,2457,2282
6019,1,0,2,0,-2
6020,1,1,366,1463,1097
6021,1,0,66,0,-66
6022,1,0,11,0,-11
6023,1,0,18,0,-18
6024,0,0,9,0,-9
6025,1,1,228,2230,2002
6026,0,0,23,0,-23
6027,0,0,64,0,-64
6028,1,0,40,0,-40
6029,0,0,43,0,-43
6030,0,0,99,0,-99
6031,1,0,15,0,-15
6032,1,1,480,2840,2360
6033,1,0,8,0,-8
6034,0,0,145,0,-145
6035,1,0,1,0,-1
6036,0,0,36,0,-36
6037,1,1,141,1652,1511
6038,1,0,28,0,-28
6039,0,0,11,0,-11
6040,1,1,749,1271,522
6041,1,0,47,0,-47
6042,0,0,38,0,-38
6043,1,0,19,0,-19
6044,1,1,354,1630,1276
6045,0,0,129,0,-129
6046,1,0,5,0,-5
6047,0,0,60,0,-60
6048,1,1,207,1350,1143
6049,0,0,52,0,-52
6050,0,0,2,0,-2
6051,1,0,22,0,-22
6052,0,0,13,0,-13
6053,1,0,38,0,-38
6054,1,1,401,1404,1003
6055,1,0,47,0,-47
6056,0,0,105,0,-105
6057,1,1,702,2741,2039
6058,1,1,64,1329,1265
6059,0,0,30,0,-30
6060,0,0,23,0,-23
6061,0,0,22,0,-22
6062,1,1,33,1260,1227
6063,0,0,145,0,-145
6064,0,0,18,0,-18
6065,1,1,966,2915,1949
6066,1,0,89,0,-89
6067,1,1,2487,1494,-993
6068,1,1,281,1740,1459
6069,0,0,76,0,-76
6070,1,1,109,1344,1235
6071,0,0,22,0,-22
6072,1,0,3,0,-3
6073,0,0,169,0,-169
6074,0,0,43,0,-43
6075,1,1,375,2112,1737
6076,1,0,32,0,-32
6077,0,0,20,0,-20
6078,1,1,168,1304,1136
6079,1,1,713,1418,705
6080,0,0,69,0,-69
6081,1,1,61,1775,1714
6082,1,1,73,1468,1395
6083,0,0,19,0,-19
6084,0,0,20,0,-20
6085,0,0,10,0,-10
6086,0,0,31,0,-31
6087,1,1,1410,1497,87
6088,1,1,211,1268,1057
6089,1,0,0,0,0
6090,0,0,19,0,-19
6091,0,0,2,0,-2
6092,1,0,51,0,-51
6093,0,0,102,0,-102
6094,1,1,343,1316,973
6095,1,1,805,1741,936
6096,1,1,257,2329,2072
6097,1,0,76,0,-76
6098,1,1,392,2157,1765
6099,0,0,189,0,-189
6100,0,0,51,0,-51
6101,0,0,37,0,-37
6102,1,1,758,1344,586
6103,1,1,1007,1237,230
6104,1,0,17,0,-17
6105,1,0,45,0,-45
6106,0,0,9,0,-9
6107,1,1,562,1259,697
6108,1,1,125,1505,1380
6109,0,0,12,0,-12
6110,1,1,377,2064,1687
6111,0,0,78,0,-78
6112,0,0,144,0,-144
6113,0,0,18,0,-18
6114,0,0,38,0,-38
6115,0,0,22,0,-22
6116,0,0,93,0,-93
6117,1,0,7,0,-7
6118,1,0,23,0,-23
6119,1,1,555,1239,684
6120,1,0,4,0,-4
6121,0,0,5,0,-5
6122,1,1,1151,1444,293
6123,1,1,413,1429,1016
6124,1,0,17,0,-17
6125,1,1,451,3108,2657
6126,1,1,660,1388,728
6127,0,0,23,0,-23
6128,0,0,20,0,-20
6129,1,0,92,0,-92
6130,0,0,11,0,-11
6131,1,0,51,0,-51
6132,1,0,96,0,-96
6133,0,0,3,0,-3
6134,0,0,33,0,-33
6135,1,1,1226,1577,351
6136,0,0,42,0,-42
6137,1,0,16,0,-16
6138,1,1,556,1264,708
6139,1,1,396,1247,851
6140,1,1,98,1338,1240
6141,1,0,104,0,-104
6142,1,0,60,0,-60
6143,0,0,62,0,-62
6144,1,1,425,1372,947
6145,0,0,3,0,-3
6146,1,0,10,0,-10
6147,0,0,75,0,-75
6148,0,0,1,0,-1
6149,0,0,50,0,-50
6150,0,0,28,0,-28
6151,1,0,67,0,-67
6152,1,0,52,0,-52
6153,0,0,60,0,-60
6154,1,0,12,0,-12
6155,1,1,1071,1486,415
6156,1,1,86,1366,1280
6157,1,1,1083,1263,180
6158,1,1,1379,1275,-104
6159,1,1,397,1487,1090
6160,1,1,251,2581,2330
6161,0,0,73,0,-73
6162,1,0,134,0,-134
6163,0,0,21,0,-21
6164,1,0,55,0,-55
6165,0,0,4,0,-4
6166,1,1,216,1268,1052
6167,1,1,515,1265,750
6168,1,0,44,0,-44
6169,1,0,145,0,-145
6170,0,0,11,0,-11
6171,0,0,164,0,-164
6172,0,0,215,0,-215
6173,0,0,1,0,-1
6174,1,0,20,0,-20
6175,1,1,814,1424,610
6176,1,1,356,1343,987
6177,1,1,859,1512,653
6178,1,0,232,0,-232
6179,1,1,508,1373,865
6180,1,0,14,0,-14
6181,1,1,172,3403,3231
6182,0,0,9,0,-9
6183,0,0,10,0,-10
6184,1,0,44,0,-44
6185,0,0,9,0,-9
6186,1,0,54,0,-54
6187,0,0,15,0,-15
6188,1,0,49,0,-49
6189,1,0,20,0,-20
6190,1,0,41,0,-41
6191,1,1,385,1346,961
6192,1,1,239,1433,1194
6193,1,0,110,0,-110
6194,1,1,64,1403,1339
6195,0,0,7,0,-7
6196,0,0,7,0,-7
6197,0,0,77,0,-77
6198,1,0,91,0,-91
6199,1,0,85,0,-85
6200,0,0,74,0,-74
6201,0,0,72,0,-72
6202,1,1,268,3521,3253
6203,1,1,313,1366,1053
6204,0,0,195,0,-195
6205,0,0,35,0,-35
6206,0,0,96,0,-96
6207,0,0,124,0,-124
6208,0,0,97,0,-97
6209,1,1,1450,1314,-136
6210,1,1,1511,1573,62
6211,1,1,69,1322,1253
6212,1,0,36,0,-36
6213,1,1,151,2188,2037
6214,1,0,131,0,-131
6215,0,0,23,0,-23
6216,1,1,546,1517,971
6217,1,1,487,3788,3301
6218,0,0,18,0,-18
6219,0,0,37,0,-37
6220,1,0,30,0,-30
6221,0,0,82,0,-82
6222,1,1,541,1352,811
6223,1,0,6,0,-6
6224,1,1,232,1303,1071
6225,1,0,134,0,-134
6226,1,1,159,1415,1256
6227,0,0,81,0,-81
6228,0,0,47,0,-47
6229,0,0,152,0,-152
6230,0,0,156,0,-156
6231,1,0,27,0,-27
6232,0,0,26,0,-26
6233,1,1,320,1889,1569
6234,1,0,45,0,-45
6235,0,0,22,0,-22
6236,0,0,19,0,-19
6237,1,0,26,0,-26
6238,1,0,73,0,-73
6239,0,0,22,0,-22
6240,0,0,44,0,-44
6241,0,0,36,0,-36
6242,1,0,36,0,-36
6243,0,0,11,0,-11
6244,0,0,267,0,-267
6245,1,1,232,1557,1325
6246,1,0,171,0,-171
6247,1,1,526,1589,1063
6248,0,0,0,0,0
6249,1,0,45,0,-45
6250,0,0,26,0,-26
6251,0,0,64,0,-64
6252,0,0,30,0,-30
6253,1,1,1702,2169,467
6254,1,0,26,0,-26
6255,1,1,282,1440,1158
6256,0,0,6,0,-6
6257,0,0,112,0,-112
6258,1,0,25,0,-25
6259,1,1,499,1241,742
6260,1,1,562,1423,861
6261,0,0,92,0,-92
6262,1,1,179,2216,2037
6263,1,0,19,0,-19
6264,1,1,289,1296,1007
6265,0,0,106,0,-106
6266,1,0,59,0,-59
6267,0,0,5,0,-5
6268,1,1,445,1635,1190
6269,1,1,563,1321,758
6270,1,1,378,1624,1246
6271,1,0,12,0,-12
6272,0,0,42,0,-42
6273,0,0,48,0,-48
6274,1,0,16,0,-16
6275,1,1,509,1293,784
6276,1,1,59,2184,2125
6277,0,0,0,0,0
6278,1,0,97,0,-97
6279,1,1,442,1859,1417
6280,1,1,638,2105,1467
6281,1,1,902,1524,622
6282,1,0,47,0,-47
6283,1,1,1087,1265,178
6284,0,0,22,0,-22
6285,1,1,1039,2407,1368
6286,0,0,184,0,-184
6287,0,0,79,0,-79
6288,1,1,465,1251,786
6289,0,0,61,0,-61
6290,0,0,63,0,-63
6291,1,1,1186,1274,88
6292,1,0,22,0,-22
6293,0,0,11,0,-11
6294,0,0,10,0,-10
6295,1,0,77,0,-77
6296,0,0,68,0,-68
6297,1,0,22,0,-22
6298,0,0,173,0,-173
6299,0,0,37,0,-37
6300,0,0,158,0,-158
6301,0,0,0,0,0
6302,1,0,20,0,-20
6303,0,0,28,0,-28
6304,1,1,672,1629,957
6305,0,0,127,0,-127
6306,1,0,68,0,-68
6307,0,0,2,0,-2
6308,1,1,1257,1414,157
6309,1,0,3,0,-3
6310,1,1,106,1637,1531
6311,1,0,8,0,-8
6312,0,0,24,0,-24
6313,1,0,6,0,-6
6314,1,1,147,1239,1092
6315,0,0,16,0,-16
6316,0,0,100,0,-100
6317,0,0,88,0,-88
6318,1,0,21,0,-21
6319,1,1,445,1496,1051
6320,0,0,6,0,-6
6321,1,0,18,0,-18
6322,0,0,28,0,-28
6323,1,0,3,0,-3
6324,0,0,83,0,-83
6325,1,1,290,2467,2177
6326,1,1,352,1374,1022
6327,1,1,681,1315,634
6328,1,0,49,0,-49
6329,0,0,34,0,-34
6330,0,0,31,0,-31
6331,1,0,0,0,0
6332,1,0,9,0,-9
6333,1,1,573,1471,898
6334,1,1,360,1669,1309
6335,1,1,173,1253,1080
6336,1,1,692,1808,1116
6337,0,0,76,0,-76
6338,0,0,100,0,-100
6339,0,0,18,0,-18
6340,1,0,23,0,-23
6341,0,0,48,0,-48
6342,0,0,11,0,-11
6343,0,0,162,0,-162
6344,0,0,116,0,-116
6345,0,0,1,0,-1
6346,0,0,14,0,-14
6347,0,0,14,0,-14
6348,1,1,106,1400,1294
6349,1,0,76,0,-76
6350,0,0,27,0,-27
6351,1,0,38,0,-38
6352,1,1,1798,5114,3316
6353,1,1,960,1265,305
6354,0,0,20,0,-20
6355,1,0,29,0,-29
6356,1,0,23,0,-23
6357,1,0,44,0,-44
6358,1,1,272,1358,1086
6359,0,0,52,0,-52
6360,1,1,701,1295,594
6361,0,0,29,0,-29
6362,0,0,47,0,-47
6363,0,0,10,0,-10
6364,1,1,1034,1571,537
6365,1,1,2173,1825,-348
6366,1,1,109,1929,1820
6367,1,0,61,0,-61
6368,0,0,7,0,-7
6369,1,0,17,0,-17
6370,1,1,1463,2032,569
6371,0,0,2,0,-2
6372,1,0,52,0,-52
6373,0,0,99,0,-99
6374,0,0,46,0,-46
6375,0,0,77,0,-77
6376,1,1,58,1606,1548
6377,0,0,21,0,-21
6378,0,0,115,0,-115
6379,0,0,26,0,-26
6380,1,0,6,0,-6
6381,1,1,875,1259,384
6382,1,1,2326,1626,-700
6383,1,1,488,2441,1953
6384,1,0,7,0,-7
6385,0,0,93,0,-93
6386,0,0,44,0,-44
6387,0,0,50,0,-50
6388,0,0,15,0,-15
6389,1,1,983,1625,642
6390,0,0,126,0,-126
6391,1,1,66,2085,2019
6392,0,0,22,0,-22
6393,1,0,1,0,-1
6394,1,1,56,2212,2156
6395,1,1,310,1892,1582
6396,0,0,10,0,-10
6397,0,0,37,0,-37
6398,0,0,295,0,-295
6399,1,1,269,1526,1257
6400,0,0,24,0,-24
6401,1,1,541,3559,3018
6402,1,1,69,1363,1294
6403,1,0,82,0,-82
6404,0,0,37,0,-37
6405,1,0,47,0,-47
6406,1,1,142,1364,1222
6407,1,1,355,1862,1507
6408,1,1,872,2084,1212
6409,1,1,575,2039,1464
6410,1,1,314,1385,1071
6411,1,1,1017,1361,344
6412,0,0,55,0,-55
6413,0,0,26,0,-26
6414,1,1,199,1901,1702
6415,1,1,251,2457,2206
6416,0,0,62,0,-62
6417,1,1,991,2522,1531
6418,1,1,127,1305,1178
6419,0,0,137,0,-137
6420,1,0,143,0,-143
6421,1,0,96,0,-96
6422,1,1,1209,1892,683
6423,1,1,497,1772,1275
6424,1,1,206,2627,2421
6425,1,0,33,0,-33
6426,1,0,157,0,-157
6427,1,0,39,0,-39
6428,1,1,570,1575,1005
6429,0,0,50,0,-50
6430,1,1,1362,1515,153
6431,0,0,81,0,-81
6432,1,1,506,1333,827
6433,0,0,41,0,-41
6434,0,0,109,0,-109
6435,1,0,75,0,-75
6436,1,0,17,0,-17
6437,1,0,28,0,-28
6438,1,0,20,0,-20
6439,0,0,17,0,-17
6440,1,0,157,0,-157
6441,0,0,0,0,0
6442,0,0,137,0,-137
6443,0,0,55,0,-55
6444,0,0,96,0,-96
6445,0,0,25,0,-25
6446,1,0,73,0,-73
6447,1,1,460,1414,954
6448,1,1,130,2048,1918
6449,1,0,13,0,-13
6450,1,0,80,0,-80
6451,0,0,8,0,-8
6452,1,1,430,1365,935
6453,1,1,204,1417,1213
6454,1,1,468,1778,1310
6455,1,1,309,1323,1014
6456,0,0,75,0,-75
6457,0,0,11,0,-11
6458,1,1,1240,1594,354
6459,1,0,51,0,-51
6460,1,1,1417,1730,313
6461,0,0,30,0,-30
6462,1,1,142,1670,1528
6463,1,0,32,0,-32
6464,1,0,16,0,-16
6465,1,1,90,1250,1160
6466,0,0,23,0,-23
6467,0,0,5,0,-5
6468,1,1,579,1393,814
6469,0,0,8,0,-8
6470,1,0,0,0,0
6471,1,1,485,1394,909
6472,0,0,102,0,-102
6473,0,0,258,0,-258
6474,1,0,16,0,-16
6475,1,1,1077,2746,1669
6476,0,0,13,0,-13
6477,0,0,3,0,-3
6478,0,0,150,0,-150
6479,1,1,1136,1724,588
6480,0,0,10,0,-10
6481,1,0,124,0,-124
6482,0,0,36,0,-36
6483,0,0,34,0,-34
6484,1,0,76,0,-76
6485,1,1,213,1492,1279
6486,0,0,15,0,-15
6487,1,0,18,0,-18
6488,1,0,24,0,-24
6489,1,1,559,1559,1000
6490,1,1,722,1409,687
6491,1,0,180,0,-180
6492,1,0,26,0,-26
6493,1,1,112,1304,1192
6494,0,0,55,0,-55
6495,0,0,82,0,-82
6496,1,0,72,0,-72
6497,1,1,381,3112,2731
6498,0,0,16,0,-16
6499,0,0,4,0,-4
6500,1,0,7,0,-7
6501,1,1,298,1269,971
6502,1,1,11,1391,1380
6503,1,1,523,1833,1310
6504,1,0,20,0,-20
6505,0,0,1,0,-1
6506,0,0,30,0,-30
6507,1,1,920,1675,755
6508,1,0,60,0,-60
6509,1,0,131,0,-131
6510,1,1,935,4229,3294
6511,0,0,18,0,-18
6512,1,0,52,0,-52
6513,1,0,3,0,-3
6514,0,0,66,0,-66
6515,0,0,21,0,-21
6516,0,0,141,0,-141
6517,1,0,34,0,-34
6518,1,1,400,1302,902
6519,1,1,242,1255,1013
6520,1,0,5,0,-5
6521,0,0,12,0,-12
6522,1,0,31,0,-31
6523,1,0,71,0,-71
6524,1,1,1475,1438,-37
6525,1,0,52,0,-52
6526,0,0,247,0,-247
6527,0,0,27,0,-27
6528,1,1,29,1656,1627
6529,0,0,155,0,-155
6530,0,0,87,0,-87
6531,1,1,186,1455,1269
6532,1,1,104,1938,1834
6533,1,1,199,1453,1254
6534,1,1,502,1384,882
6535,1,0,59,0,-59
6536,1,0,31,0,-31
6537,1,0,5,0,-5
6538,1,1,2096,1433,-663
6539,1,1,243,1442,1199
6540,1,0,115,0,-115
6541,1,0,47,0,-47
6542,1,0,9,0,-9
6543,0,0,25,0,-25
6544,1,1,273,1283,1010
6545,1,0,8,0,-8
6546,1,1,198,1287,1089
6547,0,0,61,0,-61
6548,0,0,100,0,-100
6549,1,1,259,1343,1084
6550,1,0,7,0,-7
6551,0,0,44,0,-44
6552,0,0,29,0,-29
6553,1,1,415,1551,1136
6554,0,0,125,0,-125
6555,1,0,19,0,-19
6556,0,0,26,0,-26
6557,1,1,369,1385,1016
6558,1,0,41,0,-41
6559,0,0,53,0,-53
6560,0,0,1,0,-1
6561,1,0,137,0,-137
6562,1,1,1045,1428,383
6563,1,0,81,0,-81
6564,0,0,14,0,-14
6565,1,1,417,1492,1075
6566,1,1,317,1301,984
6567,1,0,163,0,-163
6568,0,0,75,0,-75
6569,0,0,50,0,-50
6570,1,1,560,1302,742
6571,0,0,1,0,-1
6572,1,1,333,1314,981
6573,1,1,1163,1477,314
6574,1,1,754,1680,926
6575,0,0,65,0,-65
6576,1,0,5,0,-5
6577,1,0,1,0,-1
6578,1,0,15,0,-15
6579,1,0,64,0,-64
6580,1,0,106,0,-106
6581,0,0,103,0,-103
6582,1,1,896,1684,788
6583,0,0,136,0,-136
6584,0,0,31,0,-31
6585,1,1,361,1683,1322
6586,0,0,79,0,-79
6587,1,0,14,0,-14
6588,1,1,162,1284,1122
6589,0,0,40,0,-40
6590,0,0,16,0,-16
6591,1,1,481,1244,763
6592,1,0,178,0,-178
6593,0,0,10,0,-10
6594,0,0,12,0,-12
6595,0,0,13,0,-13
6596,1,1,274,1251,977
6597,0,0,86,0,-86
6598,1,1,114,1309,1195
6599,0,0,24,0,-24
6600,0,0,105,0,-105
6601,1,0,13,0,-13
6602,1,0,49,0,-49
6603,1,0,42,0,-42
6604,1,1,680,1249,569
6605,0,0,49,0,-49
6606,1,1,167,1532,1365
6607,1,1,1603,1248,-355
6608,1,0,17,0,-17
6609,1,0,35,0,-35
6610,1,0,28,0,-28
6611,1,1,676,1635,959
6612,0,0,7,0,-7
6613,0,0,8,0,-8
6614,1,1,1160,1975,815
6615,1,0,31,0,-31
6616,1,1,415,1426,1011
6617,1,1,87,3031,2944
6618,1,0,93,0,-93
6619,1,1,241,1890,1649
6620,1,1,2085,1299,-786
6621,1,1,179,1257,1078
6622,1,1,2290,2588,298
6623,0,0,94,0,-94
6624,0,0,50,0,-50
6625,1,0,116,0,-116
6626,1,1,98,1336,1238
6627,1,1,1118,1382,264
6628,0,0,2,0,-2
6629,0,0,59,0,-59
6630,0,0,131,0,-131
6631,0,0,37,0,-37
6632,1,0,72,0,-72
6633,0,0,163,0,-163
6634,1,1,532,1345,813
6635,1,0,60,0,-60
6636,1,0,30,0,-30
6637,0,0,38,0,-38
6638,1,1,97,1315,1218
6639,1,0,45,0,-45
6640,0,0,63,0,-63
6641,0,0,104,0,-104
6642,0,0,95,0,-95
6643,0,0,5,0,-5
6644,0,0,3,0,-3
6645,1,1,598,1692,1094
6646,1,0,20,0,-20
6647,1,1,759,2964,2205
6648,1,1,627,1435,808
6649,1,0,40,0,-40
6650,1,0,10,0,-10
6651,1,0,10,0,-10
6652,0,0,10,0,-10
6653,1,1,241,1290,1049
6654,1,1,694,1236,542
6655,0,0,19,0,-19
6656,1,1,161,1709,1548
6657,1,1,962,1360,398
6658,1,0,61,0,-61
6659,0,0,48,0,-48
6660,1,1,386,1668,1282
6661,0,0,28,0,-28
6662,0,0,20,0,-20
6663,1,1,365,1406,1041
6664,1,1,97,1494,1397
6665,1,1,270,1448,1178
6666,1,1,121,1432,1311
6667,1,1,672,1279,607
6668,1,0,1,0,-1
6669,1,1,145,2867,2722
6670,1,1,748,3812,3064
6671,0,0,7,0,-7
6672,1,1,1057,1881,824
6673,1,0,80,0,-80
6674,1,1,192,1243,1051
6675,0,0,85,0,-85
6676,1,0,82,0,-82
6677,1,1,219,2251,2032
6678,1,1,153,1448,1295
6679,0,0,116,0,-116
6680,1,0,19,0,-19
6681,1,0,1,0,-1
6682,1,0,14,0,-14
6683,0,0,7,0,-7
6684,1,0,0,0,0
6685,1,0,59,0,-59
6686,0,0,6,0,-6
6687,0,0,9,0,-9
6688,1,0,32,0,-32
6689,1,1,78,1304,1226
6690,0,0,19,0,-19
6691,0,0,59,0,-59
6692,1,0,6,0,-6
6693,1,0,131,0,-131
6694,0,0,24,0,-24
6695,1,1,1904,1367,-537
6696,0,0,70,0,-70
6697,0,0,3,0,-3
6698,1,1,160,2472,2312
6699,1,0,2,0,-2
6700,1,0,68,0,-68
6701,1,0,64,0,-64
6702,1,1,737,1366,629
6703,0,0,11,0,-11
6704,0,0,22,0,-22
6705,0,0,33,0,-33
6706,0,0,5,0,-5
6707,0,0,72,0,-72
6708,0,0,9,0,-9
6709,1,1,298,1485,1187
6710,0,0,1,0,-1
6711,1,0,264,0,-264
6712,0,0,173,0,-173
6713,1,1,892,2324,1432
6714,0,0,3,0,-3
6715,1,0,104,0,-104
6716,1,0,29,0,-29
6717,0,0,17,0,-17
6718,0,0,5,0,-5
6719,0,0,39,0,-39
6720,1,0,2,0,-2
6721,1,1,62,1464,1402
6722,1,0,54,0,-54
6723,1,1,614,1449,835
6724,0,0,42,0,-42
6725,1,0,167,0,-167
6726,1,0,76,0,-76
6727,1,1,289,1348,1059
6728,0,0,0,0,0
6729,1,0,3,0,-3
6730,0,0,10,0,-10
6731,0,0,31,0,-31
6732,1,0,125,0,-125
6733,0,0,36,0,-36
6734,0,0,116,0,-116
6735,0,0,35,0,-35
6736,1,1,369,1253,884
6737,1,0,1,0,-1
6738,0,0,3,0,-3
6739,0,0,138,0,-138
6740,1,1,589,1269,680
6741,0,0,24,0,-24
6742,1,0,59,0,-59
6743,0,0,0,0,0
6744,0,0,50,0,-50
6745,1,0,80,0,-80
6746,0,0,32,0,-32
6747,0,0,105,0,-105
6748,1,0,34,0,-34
6749,1,0,51,0,-51
6750,1,1,381,2150,1769
6751,1,1,905,1511,606
6752,0,0,136,0,-136
6753,1,0,4,0,-4
6754,0,0,9,0,-9
6755,1,0,57,0,-57
6756,0,0,2,0,-2
6757,0,0,16,0,-16
6758,1,1,414,1264,850
6759,0,0,13,0,-13
6760,1,0,39,0,-39
6761,1,1,72,1345,1273
6762,0,0,82,0,-82
6763,1,1,285,1430,1145
6764,0,0,20,0,-20
6765,0,0,92,0,-92
6766,0,0,179,0,-179
6767,0,0,18,0,-18
6768,1,1,185,1633,1448
6769,1,1,1587,1266,-321
6770,0,0,8,0,-8
6771,0,0,40,0,-40
6772,1,0,84,0,-84
6773,0,0,14,0,-14
6774,1,0,59,0,-59
6775,1,0,11,0,-11
6776,1,0,29,0,-29
6777,1,1,547,1726,1179
6778,0,0,5,0,-5
6779,0,0,28,0,-28
6780,0,0,18,0,-18
6781,0,0,1,0,-1
6782,1,0,59,0,-59
6783,1,1,1647,1356,-291
6784,0,0,45,0,-45
6785,1,1,1502,2288,786
6786,0,0,8,0,-8
6787,1,0,0,0,0
6788,0,0,23,0,-23
6789,0,0,12,0,-12
6790,1,0,21,0,-21
6791,0,0,56,0,-56
6792,1,0,38,0,-38
6793,1,1,375,1336,961
6794,0,0,26,0,-26
6795,0,0,39,0,-39
6796,0,0,19,0,-19
6797,0,0,38,0,-38
6798,0,0,63,0,-63
6799,1,0,133,0,-133
6800,1,1,264,1656,1392
6801,1,0,88,0,-88
6802,1,1,857,1934,1077
6803,1,0,6,0,-6
6804,0,0,13,0,-13
6805,1,1,668,1372,704
6806,1,1,46,1628,1582
6807,0,0,16,0,-16
6808,1,0,66,0,-66
6809,0,0,85,0,-85
6810,0,0,129,0,-129
6811,0,0,116,0,-116
6812,0,0,7,0,-7
6813,1,1,620,1707,1087
6814,1,0,27,0,-27
6815,1,1,874,1411,537
6816,1,0,49,0,-49
6817,1,1,100,1608,1508
6818,0,0,2,0,-2
6819,1,0,6,0,-6
6820,1,1,868,1327,459
6821,1,1,160,1704,1544
6822,1,0,203,0,-203
6823,1,1,127,1309,1182
6824,0,0,22,0,-22
6825,1,0,16,0,-16
6826,1,1,482,1274,792
6827,0,0,5,0,-5
6828,0,0,26,0,-26
6829,1,1,62,1267,1205
6830,1,1,1102,1307,205
6831,0,0,24,0,-24
6832,1,1,280,1805,1525
6833,1,0,17,0,-17
6834,0,0,4,0,-4
6835,1,1,566,1923,1357
6836,1,0,4,0,-4
6837,1,1,1401,1467,66
6838,1,1,519,1240,721
6839,0,0,109,0,-109
6840,1,1,483,2062,1579
6841,1,1,265,1352,1087
6842,1,1,829,1631,802
6843,0,0,2,0,-2
6844,1,1,240,2510,2270
6845,1,1,583,1838,1255
6846,1,0,12,0,-12
6847,1,0,150,0,-150
6848,1,0,155,0,-155
6849,0,0,33,0,-33
6850,0,0,30,0,-30
6851,0,0,38,0,-38
6852,0,0,14,0,-14
6853,0,0,42,0,-42
6854,0,0,110,0,-110
6855,1,0,55,0,-55
6856,1,1,210,1284,1074
6857,0,0,17,0,-17
6858,1,0,10,0,-10
6859,0,0,59,0,-59
6860,1,0,4,0,-4
6861,0,0,66,0,-66
6862,0,0,67,0,-67
6863,0,0,33,0,-33
6864,0,0,35,0,-35
6865,1,0,67,0,-67
6866,1,0,39,0,-39
6867,0,0,40,0,-40
6868,1,1,1388,1433,45
6869,0,0,49,0,-49
6870,1,0,90,0,-90
6871,0,0,7,0,-7
6872,0,0,75,0,-75
6873,1,1,194,1270,1076
6874,1,0,12,0,-12
6875,1,0,68,0,-68
6876,1,0,40,0,-40
6877,1,0,1,0,-1
6878,1,1,288,1304,1016
6879,0,0,222,0,-222
6880,0,0,6,0,-6
6881,1,0,90,0,-90
6882,1,0,46,0,-46
6883,0,0,18,0,-18
6884,1,1,510,1584,1074
6885,0,0,55,0,-55
6886,1,0,4,0,-4
6887,1,0,43,0,-43
6888,1,1,1211,1330,119
6889,1,1,379,1297,918
6890,0,0,42,0,-42
6891,1,1,215,1534,1319
6892,0,0,19,0,-19
6893,0,0,19,0,-19
6894,0,0,70,0,-70
6895,1,1,157,1280,1123
6896,0,0,50,0,-50
6897,0,0,57,0,-57
6898,1,0,32,0,-32
6899,1,0,14,0,-14
6900,0,0,118,0,-118
6901,0,0,94,0,-94
6902,1,1,470,1527,1057
6903,1,0,28,0,-28
6904,1,1,141,1288,1147
6905,1,0,41,0,-41
6906,1,1,586,1398,812
6907,0,0,73,0,-73
6908,1,1,1569,1840,271
6909,1,0,40,0,-40
6910,0,0,74,0,-74
6911,0,0,165,0,-165
6912,1,0,4,0,-4
6913,1,0,13,0,-13
6914,1,1,925,1469,544
6915,0,0,3,0,-3
6916,0,0,98,0,-98
6917,0,0,1,0,-1
6918,0,0,81,0,-81
6919,1,1,480,1544,1064
6920,1,0,38,0,-38
6921,1,1,430,2104,1674
6922,1,0,5,0,-5
6923,0,0,6,0,-6
6924,1,1,286,1293,1007
6925,0,0,35,0,-35
6926,0,0,72,0,-72
6927,0,0,0,0,0
6928,0,0,128,0,-128
6929,1,0,43,0,-43
6930,0,0,47,0,-47
6931,1,0,23,0,-23
6932,1,0,23,0,-23
6933,0,0,63,0,-63
6934,0,0,43,0,-43
6935,0,0,2,0,-2
6936,1,0,48,0,-48
6937,0,0,56,0,-56
6938,1,0,1,0,-1
6939,1,1,89,1272,1183
6940,0,0,15,0,-15
6941,1,0,23,0,-23
6942,1,0,11,0,-11
6943,0,0,48,0,-48
6944,1,1,1113,1243,130
6945,0,0,55,0,-55
6946,0,0,6,0,-6
6947,1,1,216,1261,1045
6948,1,0,55,0,-55
6949,0,0,1,0,-1
6950,1,1,198,1297,1099
6951,1,1,341,1255,914
6952,1,1,532,1543,1011
6953,1,1,731,1323,592
6954,1,1,297,1344,1047
6955,1,0,26,0,-26
6956,1,1,107,2091,1984
6957,1,1,142,1331,1189
6958,0,0,1,0,-1
6959,0,0,49,0,-49
6960,1,1,421,1379,958
6961,0,0,96,0,-96
6962,0,0,56,0,-56
6963,1,1,564,1468,904
6964,0,0,2,0,-2
6965,0,0,185,0,-185
6966,0,0,9,0,-9
6967,1,0,93,0,-93
6968,0,0,2,0,-2
6969,0,0,1,0,-1
6970,1,0,29,0,-29
6971,1,1,1074,1354,280
6972,1,1,396,1889,1493
6973,1,0,26,0,-26
6974,1,1,569,1707,1138
6975,1,0,148,0,-148
6976,0,0,8,0,-8
6977,1,1,275,1301,1026
6978,0,0,122,0,-122
6979,1,1,460,1443,983
6980,1,1,690,1238,548
6981,0,0,121,0,-121
6982,1,1,585,1579,994
6983,0,0,54,0,-54
6984,0,0,1,0,-1
6985,1,1,194,1421,1227
6986,0,0,191,0,-191
6987,0,0,11,0,-11
6988,0,0,17,0,-17
6989,1,0,55,0,-55
6990,1,0,18,0,-18
6991,0,0,6,0,-6
6992,1,0,71,0,-71
6993,1,1,1280,1257,-23
6994,1,1,187,1972,1785
6995,1,0,6,0,-6
6996,1,1,315,1955,1640
6997,0,0,28,0,-28
6998,1,1,595,1269,674
6999,1,0,4,0,-4
7000,1,1,304,2659,2355
7001,1,0,59,0,-59
7002,1,0,64,0,-64
7003,1,1,272,1313,1041
7004,1,0,63,0,-63
7005,1,1,767,1474,707
7006,1,1,366,1415,1049
7007,1,0,42,0,-42
7008,1,0,6,0,-6
7009,0,0,227,0,-227
7010,0,0,25,0,-25
7011,0,0,71,0,-71
7012,1,0,22,0,-22
7013,1,0,68,0,-68
7014,1,0,27,0,-27
7015,0,0,12,0,-12
7016,1,0,75,0,-75
7017,1,1,746,1336,590
7018,1,0,67,0,-67
7019,0,0,3,0,-3
7020,1,1,957,1412,455
7021,1,0,2,0,-2
7022,1,0,62,0,-62
7023,1,1,553,1399,846
7024,1,1,348,1264,916
7025,1,1,995,1318,323
7026,1,0,5,0,-5
7027,1,0,44,0,-44
7028,1,1,261,1394,1133
7029,1,1,418,1353,935
7030,1,0,2,0,-2
7031,0,0,59,0,-59
7032,1,0,4,0,-4
7033,0,0,13,0,-13
7034,0,0,9,0,-9
7035,1,0,88,0,-88
7036,1,0,9,0,-9
7037,0,0,21,0,-21
7038,0,0,37,0,-37
7039,1,0,63,0,-63
7040,0,0,24,0,-24
7041,1,1,158,1503,1345
7042,1,1,711,2154,1443
7043,1,0,71,0,-71
7044,0,0,79,0,-79
7045,1,1,506,1804,1298
7046,0,0,85,0,-85
7047,0,0,5,0,-5
7048,1,1,495,1888,1393
7049,0,0,52,0,-52
7050,0,0,3,0,-3
7051,0,0,30,0,-30
7052,1,1,1176,1990,814
7053,0,0,21,0,-21
7054,1,1,452,1330,878
7055,1,1,320,1335,1015
7056,0,0,53,0,-53
7057,1,0,21,0,-21
7058,1,0,23,0,-23
7059,0,0,0,0,0
7060,1,1,325,1406,1081
7061,1,1,1147,1743,596
7062,1,1,72,1494,1422
7063,1,1,456,1317,861
7064,1,1,191,1324,1133
7065,0,0,14,0,-14
7066,1,0,7,0,-7
7067,1,0,42,0,-42
7068,1,1,119,1409,1290
7069,0,0,77,0,-77
7070,1,0,11,0,-11
7071,0,0,5,0,-5
7072,1,1,1745,1829,84
7073,1,0,0,0,0
7074,1,1,276,1306,1030
7075,0,0,6,0,-6
7076,1,0,19,0,-19
7077,1,0,39,0,-39
7078,0,0,43,0,-43
7079,1,1,197,1540,1343
7080,1,0,30,0,-30
7081,0,0,80,0,-80
7082,1,1,1543,1822,279
7083,0,0,13,0,-13
7084,1,1,197,2086,1889
7085,1,0,28,0,-28
7086,0,0,5,0,-5
7087,0,0,128,0,-128
7088,1,1,115,1486,1371
7089,1,1,84,1369,1285
7090,0,0,10,0,-10
7091,0,0,119,0,-119
7092,1,1,1691,1833,142
7093,1,1,137,1663,1526
7094,1,0,6,0,-6
7095,1,1,490,1369,879
7096,1,1,247,2295,2048
7097,1,0,152,0,-152
7098,1,1,1143,1261,118
7099,1,1,63,1776,1713
7100,0,0,1,0,-1
7101,1,0,30,0,-30
7102,1,0,6,0,-6
7103,0,0,97,0,-97
7104,0,0,1,0,-1
7105,0,0,121,0,-121
7106,1,1,3457,1963,-1494
7107,1,0,34,0,-34
7108,1,0,39,0,-39
7109,1,0,5,0,-5
7110,1,0,172,0,-172
7111,1,0,28,0,-28
7112,1,0,69,0,-69
7113,1,1,1396,2089,693
7114,0,0,103,0,-103
7115,0,0,120,0,-120
7116,1,0,49,0,-49
7117,0,0,22,0,-22
7118,1,1,664,1456,792
7119,0,0,16,0,-16
7120,1,1,911,1406,495
7121,0,0,71,0,-71
7122,1,0,15,0,-15
7123,0,0,12,0,-12
7124,1,1,308,1576,1268
7125,1,1,131,1690,1559
7126,0,0,52,0,-52
7127,1,0,21,0,-21
7128,1,0,29,0,-29
7129,0,0,84,0,-84
7130,1,0,9,0,-9
7131,1,0,69,0,-69
7132,1,0,0,0,0
7133,0,0,59,0,-59
7134,1,1,450,1644,1194
7135,1,0,33,0,-33
7136,1,1,472,1780,1308
7137,1,1,1507,1547,40
7138,1,0,31,0,-31
7139,0,0,134,0,-134
7140,1,0,39,0,-39
7141,1,1,254,1616,1362
7142,0,0,237,0,-237
7143,0,0,39,0,-39
7144,1,1,540,2916,2376
7145,0,0,63,0,-63
7146,1,0,384,0,-384
7147,1,0,203,0,-203
7148,1,1,268,1603,1335
7149,1,0,175,0,-175
7150,0,0,96,0,-96
7151,1,0,95,0,-95
7152,0,0,25,0,-25
7153,1,1,1425,1287,-138
7154,0,0,38,0,-38
7155,1,0,65,0,-65
7156,1,0,1,0,-1
7157,1,1,1197,1469,272
7158,0,0,114,0,-114
7159,0,0,82,0,-82
7160,1,0,9,0,-9
7161,0,0,108,0,-108
7162,0,0,89,0,-89
7163,1,0,23,0,-23
7164,1,0,31,0,-31
7165,1,1,664,1831,1167
7166,1,0,124,0,-124
7167,1,1,1283,1636,353
7168,1,1,481,1397,916
7169,0,0,15,0,-15
7170,1,0,5,0,-5
7171,1,0,3,0,-3
7172,1,0,39,0,-39
7173,1,0,95,0,-95
7174,1,1,215,1326,1111
7175,1,1,2153,1272,-881
7176,0,0,99,0,-99
7177,0,0,11,0,-11
7178,1,0,17,0,-17
7179,0,0,38,0,-38
7180,1,0,16,0,-16
7181,1,0,7,0,-7
7182,1,0,25,0,-25
7183,1,0,31,0,-31
7184,1,0,59,0,-59
7185,0,0,43,0,-43
7186,0,0,153,0,-153
7187,1,0,20,0,-20
7188,0,0,9,0,-9
7189,0,0,8,0,-8
7190,1,0,117,0,-117
7191,1,0,84,0,-84
7192,0,0,9,0,-9
7193,0,0,5,0,-5
7194,1,1,81,1510,1429
7195,0,0,130,0,-130
7196,0,0,16,0,-16
7197,1,0,77,0,-77
7198,1,0,12,0,-12
7199,1,1,173,2387,2214
7200,0,0,6,0,-6
7201,1,1,302,1247,945
7202,1,1,231,1529,1298
7203,1,0,64,0,-64
7204,0,0,2,0,-2
7205,1,0,48,0,-48
7206,0,0,64,0,-64
7207,1,1,104,1331,1227
7208,0,0,17,0,-17
7209,1,0,70,0,-70
7210,0,0,81,0,-81
7211,1,1,978,1335,357
7212,0,0,162,0,-162
7213,1,0,21,0,-21
7214,1,1,332,1652,1320
7215,1,0,15,0,-15
7216,1,0,98,0,-98
7217,0,0,14,0,-14
7218,1,1,904,1236,332
7219,1,1,548,1793,1245
7220,1,0,44,0,-44
7221,0,0,27,0,-27
7222,1,1,821,1329,508
7223,1,0,23,0,-23
7224,1,1,82,1296,1214
7225,0,0,0,0,0
7226,1,0,60,0,-60
7227,1,0,31,0,-31
7228,0,0,77,0,-77
7229,1,0,15,0,-15
7230,1,0,60,0,-60
7231,1,1,392,1978,1586
7232,0,0,7,0,-7
7233,1,0,57,0,-57
7234,0,0,108,0,-108
7235,1,1,473,1311,838
7236,0,0,27,0,-27
7237,0,0,2,0,-2
7238,0,0,4,0,-4
7239,1,0,15,0,-15
7240,0,0,20,0,-20
7241,1,0,13,0,-13
7242,1,1,353,1917,1564
7243,1,0,7,0,-7
7244,1,0,37,0,-37
7245,0,0,77,0,-77
7246,0,0,16,0,-16
7247,0,0,59,0,-59
7248,0,0,21,0,-21
7249,1,0,77,0,-77
7250,1,0,47,0,-47
7251,1,1,278,5200,4922
7252,0,0,31,0,-31
7253,0,0,8,0,-8
7254,0,0,20,0,-20
7255,1,1,469,1665,1196
7256,1,1,978,1436,458
7257,1,0,22,0,-22
7258,1,1,481,1886,1405
7259,0,0,54,0,-54
7260,1,0,0,0,0
7261,0,0,16,0,-16
7262,0,0,95,0,-95
7263,0,0,31,0,-31
7264,1,1,583,2082,1499
7265,0,0,3,0,-3
7266,1,1,433,1314,881
7267,0,0,34,0,-34
7268,1,1,32,1415,1383
7269,0,0,7,0,-7
7270,1,0,36,0,-36
7271,0,0,35,0,-35
7272,1,0,203,0,-203
7273,1,1,573,1307,734
7274,0,0,14,0,-14
7275,0,0,52,0,-52
7276,1,0,24,0,-24
7277,1,1,809,1649,840
7278,1,1,446,1997,1551
7279,1,1,1116,1325,209
7280,0,0,45,0,-45
7281,1,0,5,0,-5
7282,0,0,78,0,-78
7283,0,0,50,0,-50
7284,1,0,35,0,-35
7285,1,0,19,0,-19
7286,0,0,6,0,-6
7287,0,0,9,0,-9
7288,1,0,19,0,-19
7289,0,0,75,0,-75
7290,1,1,356,2038,1682
7291,1,1,128,1400,1272
7292,0,0,10,0,-10
7293,0,0,65,0,-65
7294,0,0,2,0,-2
7295,1,0,86,0,-86
7296,1,0,55,0,-55
7297,1,0,97,0,-97
7298,1,1,240,1946,1706
7299,0,0,4,0,-4
7300,0,0,90,0,-90
7301,0,0,122,0,-122
7302,1,1,1396,1446,50
7303,1,1,75,1413,1338
7304,0,0,6,0,-6
7305,1,0,28,0,-28
7306,0,0,88,0,-88
7307,1,1,528,1311,783
7308,1,0,28,0,-28
7309,1,0,28,0,-28
7310,1,0,75,0,-75
7311,1,0,4,0,-4
7312,1,1,1537,1331,-206
7313,0,0,1,0,-1
7314,1,0,95,0,-95
7315,1,1,972,1844,872
7316,1,1,209,1380,1171
7317,0,0,91,0,-91
7318,1,1,223,1411,1188
7319,0,0,184,0,-184
7320,0,0,15,0,-15
7321,0,0,20,0,-20
7322,1,0,81,0,-81
7323,0,0,63,0,-63
7324,0,0,64,0,-64
7325,0,0,3,0,-3
7326,1,0,135,0,-135
7327,1,0,14,0,-14
7328,1,0,88,0,-88
7329,0,0,27,0,-27
7330,1,1,1334,1472,138
7331,0,0,44,0,-44
7332,0,0,49,0,-49
7333,1,0,21,0,-21
7334,1,0,8,0,-8
7335,1,1,110,1385,1275
7336,1,1,671,1613,942
7337,1,0,3,0,-3
7338,1,0,0,0,0
7339,0,0,75,0,-75
7340,1,0,38,0,-38
7341,0,0,6,0,-6
7342,0,0,64,0,-64
7343,0,0,56,0,-56
7344,1,1,165,1711,1546
7345,1,0,41,0,-41
7346,1,1,1041,1922,881
7347,0,0,41,0,-41
7348,1,1,81,1294,1213
7349,0,0,101,0,-101
7350,0,0,10,0,-10
7351,0,0,18,0,-18
7352,1,0,42,0,-42
7353,0,0,79,0,-79
7354,0,0,20,0,-20
7355,1,1,143,1333,1190
7356,1,0,9,0,-9
7357,1,1,579,2078,1499
7358,1,1,2113,3001,888
7359,1,1,258,1559,1301
7360,1,1,569,1353,784
7361,0,0,41,0,-41
7362,0,0,28,0,-28
7363,1,1,42,1490,1448
7364,0,0,61,0,-61
7365,0,0,40,0,-40
7366,1,0,0,0,0
7367,1,0,103,0,-103
7368,1,1,64,1236,1172
7369,1,1,398,1497,1099
7370,0,0,26,0,-26
7371,1,0,23,0,-23
7372,0,0,16,0,-16
7373,1,1,262,1391,1129
7374,0,0,18,0,-18
7375,1,0,21,0,-21
7376,0,0,42,0,-42
7377,0,0,31,0,-31
7378,1,0,114,0,-114
7379,1,1,1691,2403,712
7380,0,0,10,0,-10
7381,1,0,24,0,-24
7382,0,0,12,0,-12
7383,1,0,193,0,-193
7384,0,0,10,0,-10
7385,0,0,12,0,-12
7386,1,0,46,0,-46
7387,1,1,773,1535,762
7388,1,1,390,2153,1763
7389,1,0,6,0,-6
7390,1,1,574,1402,828
7391,1,0,12,0,-12
7392,1,1,21,1933,1912
7393,1,1,520,1879,1359
7394,1,0,55,0,-55
7395,1,1,350,1347,997
7396,1,0,308,0,-308
7397,1,1,218,1398,1180
7398,1,1,302,2009,1707
7399,1,1,160,2125,1965
7400,0,0,128,0,-128
7401,0,0,51,0,-51
7402,0,0,67,0,-67
7403,1,1,533,2060,1527
7404,1,1,350,1710,1360
7405,0,0,126,0,-126
7406,0,0,80,0,-80
7407,1,1,710,2211,1501
7408,1,0,26,0,-26
7409,0,0,8,0,-8
7410,1,1,886,2372,1486
7411,1,0,63,0,-63
7412,0,0,30,0,-30
7413,0,0,219,0,-219
7414,1,0,25,0,-25
7415,0,0,47,0,-47
7416,0,0,35,0,-35
7417,0,0,30,0,-30
7418,1,1,1480,1936,456
7419,1,0,26,0,-26
7420,1,1,618,1561,943
7421,1,1,598,1274,676
7422,1,1,83,1300,1217
7423,0,0,11,0,-11
7424,1,0,94,0,-94
7425,1,1,278,1671,1393
7426,1,0,133,0,-133
7427,1,1,286,2065,1779
7428,1,0,62,0,-62
7429,0,0,175,0,-175
7430,1,1,607,1468,861
7431,0,0,80,0,-80
7432,1,0,6,0,-6
7433,1,0,70,0,-70
7434,1,0,3,0,-3
7435,1,1,154,1308,1154
7436,1,1,308,1548,1240
7437,1,1,492,1366,874
7438,1,0,83,0,-83
7439,1,1,1660,1729,69
7440,1,0,101,0,-101
7441,1,1,180,1990,1810
7442,0,0,44,0,-44
7443,1,1,927,1437,510
7444,1,0,72,0,-72
7445,0,0,2,0,-2
7446,0,0,10,0,-10
7447,0,0,81,0,-81
7448,1,1,347,1329,982
7449,0,0,1,0,-1
7450,1,1,601,1255,654
7451,0,0,69,0,-69
7452,0,0,52,0,-52
7453,1,0,3,0,-3
7454,1,0,72,0,-72
7455,0,0,24,0,-24
7456,1,0,7,0,-7
7457,1,0,18,0,-18
7458,1,0,57,0,-57
7459,1,0,42,0,-42
7460,1,1,199,1387,1188
7461,0,0,52,0,-52
7462,0,0,7,0,-7
7463,0,0,1,0,-1
7464,1,0,15,0,-15
7465,0,0,20,0,-20
7466,1,1,754,1636,882
7467,1,1,165,1401,1236
7468,1,0,13,0,-13
7469,0,0,35,0,-35
7470,0,0,224,0,-224
7471,1,0,0,0,0
7472,1,1,874,1630,756
7473,1,1,537,2418,1881
7474,0,0,3,0,-3
7475,1,1,151,1474,1323
7476,0,0,46,0,-46
7477,1,0,36,0,-36
7478,1,1,1006,1310,304
7479,1,1,675,1435,760
7480,1,1,453,1448,995
7481,1,1,193,2690,2497
7482,0,0,5,0,-5
7483,1,1,84,1552,1468
7484,0,0,38,0,-38
7485,1,1,457,1675,1218
7486,0,0,42,0,-42
7487,1,0,84,0,-84
7488,1,1,99,1371,1272
7489,1,1,218,1390,1172
7490,1,0,67,0,-67
7491,1,1,921,1317,396
7492,1,1,2099,1394,-705
7493,1,1,80,1518,1438
7494,1,0,108,0,-108
7495,0,0,25,0,-25
7496,0,0,22,0,-22
7497,0,0,172,0,-172
7498,0,0,82,0,-82
7499,1,1,74,1789,1715
7500,1,0,11,0,-11
7501,0,0,61,0,-61
7502,0,0,30,0,-30
7503,1,0,67,0,-67
7504,1,0,73,0,-73
7505,0,0,23,0,-23
7506,1,1,377,1831,1454
7507,0,0,10,0,-10
7508,1,0,36,0,-36
7509,0,0,38,0,-38
7510,1,1,65,1292,1227
7511,1,1,303,1337,1034
7512,0,0,4,0,-4
7513,1,1,206,1276,1070
7514,1,1,27,1539,1512
7515,1,1,1457,1267,-190
7516,1,1,696,3246,2550
7517,0,0,130,0,-130
7518,0,0,78,0,-78
7519,1,0,26,0,-26
7520,1,0,179,0,-179
7521,1,0,2,0,-2
7522,1,1,143,1490,1347
7523,1,1,60,1397,1337
7524,0,0,65,0,-65
7525,1,1,845,1267,422
7526,0,0,1,0,-1
7527,1,1,1091,1471,380
7528,0,0,27,0,-27
7529,1,0,50,0,-50
7530,1,1,130,1266,1136
7531,1,1,220,1944,1724
7532,0,0,32,0,-32
7533,1,1,222,1585,1363
7534,1,0,27,0,-27
7535,1,1,365,1344,979
7536,1,1,386,1292,906
7537,0,0,72,0,-72
7538,1,1,171,1888,1717
7539,0,0,6,0,-6
7540,1,0,81,0,-81
7541,1,1,224,1856,1632
7542,1,0,56,0,-56
7543,1,1,384,3030,2646
7544,0,0,31,0,-31
7545,0,0,74,0,-74
7546,0,0,337,0,-337
7547,1,1,355,2015,1660
7548,1,0,19,0,-19
7549,1,0,17,0,-17
7550,1,0,15,0,-15
7551,0,0,54,0,-54
7552,1,0,125,0,-125
7553,1,1,175,1788,1613
7554,1,1,2342,1258,-1084
7555,0,0,57,0,-57
7556,1,0,42,0,-42
7557,1,0,139,0,-139
7558,0,0,166,0,-166
7559,0,0,271,0,-271
7560,1,1,782,1508,726
7561,0,0,50,0,-50
7562,1,0,0,0,0
7563,1,1,173,1468,1295
7564,0,0,154,0,-154
7565,1,0,0,0,0
7566,1,0,42,0,-42
7567,0,0,60,0,-60
7568,1,1,171,1303,1132
7569,1,1,826,1581,755
7570,1,0,41,0,-41
7571,1,1,703,1567,864
7572,1,0,117,0,-117
7573,1,1,557,1883,1326
7574,1,0,18,0,-18
7575,1,1,774,2197,1423
7576,1,1,55,2909,2854
7577,1,1,926,2119,1193
7578,1,1,728,1518,790
7579,0,0,142,0,-142
7580,1,1,3194,1489,-1705
7581,1,1,379,1554,1175
7582,1,0,14,0,-14
7583,0,0,32,0,-32
7584,1,1,232,2470,2238
7585,0,0,76,0,-76
7586,0,0,33,0,-33
7587,0,0,59,0,-59
7588,1,1,108,1582,1474
7589,1,0,20,0,-20
7590,1,1,366,2447,2081
7591,1,1,2160,1564,-596
7592,1,0,8,0,-8
7593,1,1,1302,1340,38
7594,1,1,300,1306,1006
7595,1,1,123,1490,1367
7596,1,1,927,2015,1088
7597,0,0,58,0,-58
7598,1,1,778,1304,526
7599,1,0,25,0,-25
7600,1,1,495,1457,962
7601,0,0,5,0,-5
7602,0,0,21,0,-21
7603,1,1,3283,1291,-1992
7604,1,0,54,0,-54
7605,1,1,372,1307,935
7606,1,0,218,0,-218
7607,0,0,22,0,-22
7608,1,1,297,1512,1215
7609,1,1,327,1810,1483
7610,1,0,101,0,-101
7611,1,1,449,1561,1112
7612,0,0,20,0,-20
7613,1,0,70,0,-70
7614,0,0,105,0,-105
7615,0,0,56,0,-56
7616,0,0,47,0,-47
7617,0,0,15,0,-15
7618,1,1,526,1688,1162
7619,1,0,13,0,-13
7620,0,0,0,0,0
7621,1,0,95,0,-95
7622,1,0,1,0,-1
7623,1,0,33,0,-33
7624,0,0,24,0,-24
7625,0,0,50,0,-50
7626,1,0,25,0,-25
7627,1,1,479,1521,1042
7628,1,1,1604,1647,43
7629,0,0,18,0,-18
7630,0,0,20,0,-20
7631,0,0,18,0,-18
7632,1,1,706,1668,962
7633,1,1,407,1863,1456
7634,1,1,141,1505,1364
7635,0,0,317,0,-317
7636,1,0,52,0,-52
7637,0,0,26,0,-26
7638,1,0,26,0,-26
7639,1,0,38,0,-38
7640,0,0,4,0,-4
7641,1,0,64,0,-64
7642,0,0,0,0,0
7643,0,0,37,0,-37
7644,0,0,12,0,-12
7645,0,0,69,0,-69
7646,0,0,31,0,-31
7647,0,0,31,0,-31
7648,0,0,24,0,-24
7649,1,0,10,0,-10
7650,1,1,182,1396,1214
7651,1,1,2997,1757,-1240
7652,1,0,38,0,-38
7653,0,0,36,0,-36
7654,1,0,4,0,-4
7655,0,0,50,0,-50
7656,1,0,73,0,-73
7657,0,0,122,0,-122
7658,0,0,122,0,-122
7659,0,0,121,0,-121
7660,1,1,902,1948,1046
7661,1,1,34,1764,1730
7662,0,0,39,0,-39
7663,1,1,462,1295,833
7664,0,0,112,0,-112
7665,0,0,71,0,-71
7666,1,1,200,1277,1077
7667,0,0,64,0,-64
7668,0,0,1,0,-1
7669,1,0,53,0,-53
7670,0,0,7,0,-7
7671,1,0,13,0,-13
7672,1,0,47,0,-47
7673,1,1,134,1584,1450
7674,0,0,78,0,-78
7675,0,0,17,0,-17
7676,1,0,33,0,-33
7677,1,0,26,0,-26
7678,1,0,44,0,-44
7679,1,1,460,1549,1089
7680,1,0,127,0,-127
7681,1,1,218,2071,1853
7682,0,0,0,0,0
7683,1,0,22,0,-22
7684,1,1,551,1415,864
7685,1,1,1374,1259,-115
7686,1,0,142,0,-142
7687,0,0,26,0,-26
7688,0,0,108,0,-108
7689,0,0,30,0,-30
7690,1,0,4,0,-4
7691,1,1,233,1639,1406
7692,0,0,46,0,-46
7693,1,0,37,0,-37
7694,0,0,32,0,-32
7695,0,0,2,0,-2
7696,1,0,34,0,-34
7697,0,0,85,0,-85
7698,0,0,42,0,-42
7699,1,1,218,1928,1710
7700,1,1,21,1345,1324
7701,1,1,423,1243,820
7702,1,0,32,0,-32
7703,1,0,44,0,-44
7704,1,1,327,2309,1982
7705,1,0,25,0,-25
7706,0,0,43,0,-43
7707,0,0,85,0,-85
7708,1,1,1202,1496,294
7709,0,0,111,0,-111
7710,1,1,213,1325,1112
7711,0,0,35,0,-35
7712,1,1,631,1393,762
7713,0,0,43,0,-43
7714,1,1,78,1324,1246
7715,1,0,33,0,-33
7716,1,0,20,0,-20
7717,1,1,159,1609,1450
7718,0,0,33,0,-33
7719,1,1,851,1243,392
7720,0,0,6,0,-6
7721,0,0,62,0,-62
7722,0,0,18,0,-18
7723,0,0,124,0,-124
7724,0,0,111,0,-111
7725,0,0,17,0,-17
7726,1,1,310,2725,2415
7727,1,0,207,0,-207
7728,1,0,9,0,-9
7729,1,1,252,1316,1064
7730,1,0,20,0,-20
7731,0,0,6,0,-6
7732,0,0,57,0,-57
7733,1,1,249,1247,998
7734,0,0,53,0,-53
7735,1,1,874,1855,981
7736,1,0,74,0,-74
7737,1,0,6,0,-6
7738,1,1,1500,1322,-178
7739,1,1,472,1269,797
7740,0,0,31,0,-31
7741,0,0,4,0,-4
7742,1,1,963,1648,685
7743,0,0,86,0,-86
7744,1,0,28,0,-28
7745,0,0,73,0,-73
7746,1,0,120,0,-120
7747,1,1,1425,1455,30
7748,0,0,118,0,-118
7749,1,0,34,0,-34
7750,1,0,50,0,-50
7751,0,0,8,0,-8
7752,0,0,123,0,-123
7753,1,0,31,0,-31
7754,1,1,2192,1446,-746
7755,0,0,0,0,0
7756,1,0,55,0,-55
7757,1,1,39,1377,1338
7758,1,0,6,0,-6
7759,1,0,84,0,-84
7760,0,0,14,0,-14
7761,1,0,13,0,-13
7762,1,1,292,1975,1683
7763,1,0,23,0,-23
7764,1,1,516,1270,754
7765,0,0,38,0,-38
7766,0,0,48,0,-48
7767,1,1,429,1395,966
7768,1,1,1231,1305,74
7769,1,0,45,0,-45
7770,0,0,83,0,-83
7771,1,0,43,0,-43
7772,0,0,1,0,-1
7773,1,1,95,1249,1154
7774,1,1,227,2010,1783
7775,1,1,472,1246,774
7776,0,0,33,0,-33
7777,0,0,54,0,-54
7778,0,0,0,0,0
7779,0,0,3,0,-3
7780,1,0,25,0,-25
7781,1,1,206,1692,1486
7782,1,0,53,0,-53
7783,0,0,9,0,-9
7784,0,0,10,0,-10
7785,1,0,34,0,-34
7786,1,1,620,1260,640
7787,1,1,444,1745,1301
7788,1,0,94,0,-94
7789,1,1,160,2468,2308
7790,0,0,2,0,-2
7791,1,1,50,4435,4385
7792,0,0,1,0,-1
7793,1,0,25,0,-25
7794,1,1,204,1430,1226
7795,0,0,10,0,-10
7796,1,0,77,0,-77
7797,1,1,154,2308,2154
7798,0,0,9,0,-9
7799,0,0,7,0,-7
7800,0,0,11,0,-11
7801,1,1,520,1369,849
7802,0,0,0,0,0
7803,0,0,32,0,-32
7804,0,0,170,0,-170
7805,1,1,142,1238,1096
7806,1,1,348,1702,1354
7807,0,0,17,0,-17
7808,0,0,62,0,-62
7809,1,0,5,0,-5
7810,1,0,13,0,-13
7811,0,0,7,0,-7
7812,0,0,59,0,-59
7813,1,0,23,0,-23
7814,1,0,1,0,-1
7815,0,0,31,0,-31
7816,1,1,340,1534,1194
7817,0,0,81,0,-81
7818,1,1,1276,1424,148
7819,1,1,136,1459,1323
7820,1,1,708,2026,1318
7821,1,1,319,1416,1097
7822,0,0,45,0,-45
7823,1,0,35,0,-35
7824,0,0,20,0,-20
7825,1,0,47,0,-47
7826,0,0,17,0,-17
7827,1,1,1100,1456,356
7828,1,0,14,0,-14
7829,0,0,43,0,-43
7830,0,0,2,0,-2
7831,1,1,446,1353,907
7832,1,1,1359,1421,62
7833,1,0,2,0,-2
7834,0,0,27,0,-27
7835,1,0,26,0,-26
7836,1,0,155,0,-155
7837,1,0,20,0,-20
7838,1,1,324,1334,1010
7839,1,1,164,1433,1269
7840,1,0,104,0,-104
7841,1,1,564,1474,910
7842,0,0,27,0,-27
7843,1,1,177,2248,2071
7844,0,0,5,0,-5
7845,1,1,331,1502,1171
7846,0,0,21,0,-21
7847,0,0,225,0,-225
7848,0,0,12,0,-12
7849,1,1,349,1737,1388
7850,0,0,102,0,-102
7851,1,0,2,0,-2
7852,1,1,112,1247,1135
7853,1,0,76,0,-76
7854,0,0,12,0,-12
7855,0,0,17,0,-17
7856,0,0,4,0,-4
7857,1,1,168,1281,1113
7858,1,0,33,0,-33
7859,0,0,35,0,-35
7860,0,0,27,0,-27
7861,0,0,27,0,-27
7862,1,0,31,0,-31
7863,1,0,351,0,-351
7864,1,0,35,0,-35
7865,1,0,33,0,-33
7866,0,0,195,0,-195
7867,1,1,213,1850,1637
7868,1,0,5,0,-5
7869,0,0,156,0,-156
7870,1,0,2,0,-2
7871,0,0,38,0,-38
7872,1,1,486,1243,757
7873,0,0,56,0,-56
7874,1,0,35,0,-35
7875,0,0,19,0,-19
7876,0,0,36,0,-36
7877,1,1,113,1432,1319
7878,1,1,436,1925,1489
7879,1,0,17,0,-17
7880,1,1,401,1401,1000
7881,1,1,891,1488,597
7882,1,1,751,1518,767
7883,1,1,324,1732,1408
7884,1,1,379,1267,888
7885,0,0,6,0,-6
7886,1,1,134,2246,2112
7887,1,0,12,0,-12
7888,1,1,649,3005,2356
7889,1,1,255,1380,1125
7890,1,1,73,1356,1283
7891,1,1,650,4030,3380
7892,1,0,0,0,0
7893,0,0,41,0,-41
7894,0,0,16,0,-16
7895,0,0,5,0,-5
7896,0,0,103,0,-103
7897,1,1,36,1530,1494
7898,1,0,25,0,-25
7899,0,0,13,0,-13
7900,1,0,13,0,-13
7901,0,0,61,0,-61
7902,1,0,29,0,-29
7903,1,0,36,0,-36
7904,1,0,91,0,-91
7905,1,0,41,0,-41
7906,1,1,364,1439,1075
7907,0,0,46,0,-46
7908,0,0,50,0,-50
7909,1,1,2402,1551,-851
7910,1,1,851,1300,449
7911,1,0,98,0,-98
7912,0,0,25,0,-25
7913,1,1,281,1623,1342
7914,1,1,241,1335,1094
7915,0,0,25,0,-25
7916,0,0,12,0,-12
7917,1,0,13,0,-13
7918,0,0,37,0,-37
7919,1,0,107,0,-107
7920,0,0,94,0,-94
7921,1,0,150,0,-150
7922,0,0,101,0,-101
7923,1,0,48,0,-48
7924,1,0,30,0,-30
7925,1,1,559,1465,906
7926,1,1,131,1443,1312
7927,0,0,31,0,-31
7928,1,0,38,0,-38
7929,1,0,137,0,-137
7930,1,1,839,1431,592
7931,1,0,29,0,-29
7932,1,0,32,0,-32
7933,0,0,4,0,-4
7934,0,0,47,0,-47
7935,1,0,2,0,-2
7936,1,0,46,0,-46
7937,1,1,478,1679,1201
7938,1,1,300,1567,1267
7939,1,0,17,0,-17
7940,1,1,626,1842,1216
7941,1,1,1273,1380,107
7942,1,1,910,1659,749
7943,0,0,183,0,-183
7944,1,1,884,1329,445
7945,1,1,123,1300,1177
7946,1,1,171,1382,1211
7947,0,0,237,0,-237
7948,1,0,77,0,-77
7949,1,1,77,1350,1273
7950,0,0,7,0,-7
7951,1,1,78,1383,1305
7952,1,1,147,1676,1529
7953,1,0,13,0,-13
7954,0,0,7,0,-7
7955,0,0,28,0,-28
7956,0,0,54,0,-54
7957,0,0,298,0,-298
7958,1,1,71,1373,1302
7959,1,1,190,1545,1355
7960,1,0,7,0,-7
7961,1,1,647,2168,1521
7962,1,0,107,0,-107
7963,0,0,20,0,-20
7964,0,0,89,0,-89
7965,1,0,24,0,-24
7966,1,1,127,1271,1144
7967,1,1,422,2544,2122
7968,0,0,31,0,-31
7969,0,0,92,0,-92
7970,1,1,368,1972,1604
7971,0,0,83,0,-83
7972,0,0,35,0,-35
7973,0,0,159,0,-159
7974,1,1,910,2698,1788
7975,1,1,380,1314,934
7976,0,0,19,0,-19
7977,1,1,57,1379,1322
7978,0,0,52,0,-52
7979,0,0,8,0,-8
7980,1,1,726,1851,1125
7981,1,1,34,1244,1210
7982,1,1,409,2173,1764
7983,1,1,754,2261,1507
7984,0,0,17,0,-17
7985,1,0,102,0,-102
7986,0,0,185,0,-185
7987,1,0,3,0,-3
7988,1,0,16,0,-16
7989,1,0,10,0,-10
7990,1,0,52,0,-52
7991,1,1,267,1543,1276
7992,0,0,24,0,-24
7993,1,1,2018,1802,-216
7994,0,0,65,0,-65
7995,0,0,51,0,-51
7996,0,0,43,0,-43
7997,1,1,123,1349,1226
7998,1,0,161,0,-161
7999,1,0,44,0,-44
8000,0,0,29,0,-29
8001,1,0,21,0,-21
8002,1,0,17,0,-17
8003,1,0,1,0,-1
8004,1,0,8,0,-8
8005,0,0,72,0,-72
8006,1,0,113,0,-113
8007,1,1,981,1304,323
8008,1,1,70,1356,1286
8009,0,0,79,0,-79
8010,1,0,62,0,-62
8011,1,0,98,0,-98
8012,1,1,531,1752,1221
8013,0,0,12,0,-12
8014,0,0,13,0,-13
8015,1,1,609,2577,1968
8016,0,0,26,0,-26
8017,1,0,23,0,-23
8018,1,0,9,0,-9
8019,1,0,13,0,-13
8020,1,0,25,0,-25
8021,1,1,394,1241,847
8022,1,0,93,0,-93
8023,0,0,3,0,-3
8024,1,1,1540,1305,-235
8025,0,0,27,0,-27
8026,0,0,166,0,-166
8027,0,0,52,0,-52
8028,1,1,528,2190,1662
8029,1,1,412,2100,1688
8030,1,0,100,0,-100
8031,1,0,73,0,-73
8032,1,0,49,0,-49
8033,0,0,38,0,-38
8034,1,1,266,2874,2608
8035,0,0,79,0,-79
8036,0,0,2,0,-2
8037,0,0,7,0,-7
8038,0,0,72,0,-72
8039,0,0,27,0,-27
8040,1,0,60,0,-60
8041,1,0,45,0,-45
8042,0,0,50,0,-50
8043,1,0,57,0,-57
8044,0,0,29,0,-29
8045,1,0,133,0,-133
8046,0,0,9,0,-9
8047,0,0,6,0,-6
8048,1,0,118,0,-118
8049,1,0,69,0,-69
8050,0,0,20,0,-20
8051,1,1,173,1395,1222
8052,1,1,104,1341,1237
8053,0,0,22,0,-22
8054,1,1,33,1255,1222
8055,0,0,38,0,-38
8056,0,0,121,0,-121
8057,0,0,87,0,-87
8058,0,0,27,0,-27
8059,0,0,5,0,-5
8060,1,1,313,1446,1133
8061,1,0,8,0,-8
8062,1,0,3,0,-3
8063,0,0,18,0,-18
8064,0,0,48,0,-48
8065,1,1,806,1605,799
8066,1,1,129,1314,1185
8067,1,1,238,2341,2103
8068,1,0,37,0,-37
8069,1,0,17,0,-17
8070,0,0,158,0,-158
8071,1,1,306,1360,1054
8072,1,0,150,0,-150
8073,0,0,18,0,-18
8074,1,1,578,1286,708
8075,1,1,153,1454,1301
8076,1,1,312,1258,946
8077,0,0,21,0,-21
8078,0,0,98,0,-98
8079,0,0,77,0,-77
8080,0,0,42,0,-42
8081,1,1,347,3330,2983
8082,1,0,19,0,-19
8083,0,0,53,0,-53
8084,1,0,0,0,0
8085,1,0,35,0,-35
8086,0,0,57,0,-57
8087,0,0,144,0,-144
8088,1,1,500,1559,1059
8089,1,0,78,0,-78
8090,1,0,42,0,-42
8091,1,1,634,1550,916
8092,1,0,37,0,-37
8093,1,0,15,0,-15
8094,1,0,64,0,-64
8095,0,0,68,0,-68
8096,0,0,41,0,-41
8097,1,0,63,0,-63
8098,1,0,103,0,-103
8099,1,0,2,0,-2
8100,0,0,25,0,-25
8101,0,0,57,0,-57
8102,0,0,137,0,-137
8103,1,1,557,1422,865
8104,0,0,1,0,-1
8105,1,0,2,0,-2
8106,1,1,118,1537,1419
8107,1,1,1151,1532,381
8108,1,0,4,0,-4
8109,1,1,197,1594,1397
8110,0,0,8,0,-8
8111,0,0,62,0,-62
8112,1,0,44,0,-44
8113,1,0,3,0,-3
8114,0,0,14,0,-14
8115,1,1,870,1293,423
8116,1,0,141,0,-141
8117,1,1,88,1479,1391
8118,1,1,128,1744,1616
8119,1,1,394,1403,1009
8120,1,1,135,1318,1183
8121,0,0,21,0,-21
8122,0,0,0,0,0
8123,0,0,32,0,-32
8124,1,1,633,2057,1424
8125,1,0,1,0,-1
8126,1,1,516,1397,881
8127,0,0,32,0,-32
8128,0,0,1,0,-1
8129,0,0,24,0,-24
8130,1,0,18,0,-18
8131,1,0,79,0,-79
8132,0,0,110,0,-110
8133,1,1,828,1422,594
8134,0,0,55,0,-55
8135,1,0,12,0,-12
8136,1,1,881,1453,572
8137,1,1,103,1821,1718
8138,0,0,15,0,-15
8139,1,0,35,0,-35
8140,0,0,26,0,-26
8141,0,0,67,0,-67
8142,1,0,70,0,-70
8143,1,0,19,0,-19
8144,0,0,160,0,-160
8145,0,0,7,0,-7
8146,1,1,267,1237,970
8147,1,0,18,0,-18
8148,1,1,265,2432,2167
8149,1,0,55,0,-55
8150,1,1,84,1243,1159
8151,1,1,727,2246,1519
8152,1,1,1286,1514,228
8153,1,0,60,0,-60
8154,0,0,64,0,-64
8155,0,0,11,0,-11
8156,0,0,32,0,-32
8157,0,0,76,0,-76
8158,0,0,14,0,-14
8159,0,0,33,0,-33
8160,1,1,1849,1784,-65
8161,1,1,354,1392,1038
8162,1,0,11,0,-11
8163,1,1,333,1437,1104
8164,0,0,261,0,-261
8165,1,0,261,0,-261
8166,1,1,291,1401,1110
8167,1,0,6,0,-6
8168,1,1,622,1769,1147
8169,0,0,92,0,-92
8170,0,0,44,0,-44
8171,1,1,605,1467,862
8172,1,0,4,0,-4
8173,0,0,78,0,-78
8174,0,0,70,0,-70
8175,1,0,113,0,-113
8176,1,0,22,0,-22
8177,0,0,6,0,-6
8178,1,0,19,0,-19
8179,0,0,27,0,-27
8180,1,1,2227,1429,-798
8181,0,0,24,0,-24
8182,1,0,15,0,-15
8183,0,0,43,0,-43
8184,0,0,96,0,-96
8185,1,1,908,1382,474
8186,1,0,86,0,-86
8187,1,1,379,1470,1091
8188,1,1,53,1270,1217
8189,1,1,200,1923,1723
8190,1,0,68,0,-68
8191,0,0,74,0,-74
8192,1,0,79,0,-79
8193,0,0,57,0,-57
8194,1,1,248,1708,1460
8195,1,0,99,0,-99
8196,0,0,141,0,-141
8197,1,1,114,2571,2457
8198,1,0,62,0,-62
8199,1,0,29,0,-29
8200,0,0,38,0,-38
8201,1,1,1820,1611,-209
8202,1,1,12,1348,1336
8203,0,0,18,0,-18
8204,0,0,38,0,-38
8205,1,1,198,2134,1936
8206,0,0,6,0,-6
8207,0,0,75,0,-75
8208,1,1,1180,1482,302
8209,1,1,78,1805,1727
8210,1,1,868,1357,489
8211,1,1,497,1630,1133
8212,0,0,72,0,-72
8213,0,0,18,0,-18
8214,1,1,14,1432,1418
8215,0,0,38,0,-38
8216,0,0,32,0,-32
8217,1,0,0,0,0
8218,1,0,10,0,-10
8219,1,0,43,0,-43
8220,0,0,12,0,-12
8221,1,1,185,1239,1054
8222,0,0,9,0,-9
8223,1,1,1047,1389,342
8224,0,0,48,0,-48
8225,1,0,5,0,-5
8226,1,1,525,1601,1076
8227,1,1,876,2739,1863
8228,0,0,157,0,-157
8229,1,1,182,1499,1317
8230,1,1,343,1258,915
8231,1,1,665,1537,872
8232,1,1,153,1543,1390
8233,0,0,0,0,0
8234,1,1,731,1277,546
8235,0,0,10,0,-10
8236,1,0,48,0,-48
8237,1,1,135,1630,1495
8238,1,0,24,0,-24
8239,1,0,17,0,-17
8240,1,1,422,1530,1108
8241,0,0,74,0,-74
8242,0,0,74,0,-74
8243,1,0,112,0,-112
8244,0,0,9,0,-9
8245,0,0,31,0,-31
8246,1,0,3,0,-3
8247,1,0,53,0,-53
8248,1,0,23,0,-23
8249,1,0,41,0,-41
8250,1,0,4,0,-4
8251,0,0,19,0,-19
8252,1,0,79,0,-79
8253,1,1,6,1341,1335
8254,1,1,112,1832,1720
8255,1,1,260,1328,1068
8256,1,0,69,0,-69
8257,0,0,20,0,-20
8258,0,0,10,0,-10
8259,1,0,96,0,-96
8260,0,0,21,0,-21
8261,0,0,13,0,-13
8262,0,0,77,0,-77
8263,0,0,21,0,-21
8264,0,0,15,0,-15
8265,0,0,36,0,-36
8266,0,0,60,0,-60
8267,1,1,240,1294,1054
8268,1,0,72,0,-72
8269,0,0,99,0,-99
8270,1,1,729,1481,752
8271,1,0,52,0,-52
8272,1,0,12,0,-12
8273,0,0,188,0,-188
8274,1,1,112,1479,1367
8275,1,1,141,1557,1416
8276,1,0,17,0,-17
8277,1,1,44,2110,2066
8278,1,0,21,0,-21
8279,1,1,78,1285,1207
8280,0,0,25,0,-25
8281,0,0,105,0,-105
8282,1,0,16,0,-16
8283,0,0,5,0,-5
8284,1,1,325,2403,2078
8285,1,1,322,1359,1037
8286,1,0,42,0,-42
8287,1,1,262,1248,986
8288,1,0,0,0,0
8289,0,0,69,0,-69
8290,1,1,176,5507,5331
8291,1,1,39,1411,1372
8292,1,1,469,1283,814
8293,1,1,215,2013,1798
8294,1,0,76,0,-76
8295,1,1,294,1819,1525
8296,1,0,29,0,-29
8297,0,0,77,0,-77
8298,1,0,12,0,-12
8299,1,1,811,1256,445
8300,0,0,21,0,-21
8301,0,0,81,0,-81
8302,1,0,20,0,-20
8303,0,0,298,0,-298
8304,1,1,831,1359,528
8305,1,0,35,0,-35
8306,1,0,27,0,-27
8307,0,0,101,0,-101
8308,0,0,4,0,-4
8309,0,0,8,0,-8
8310,1,1,76,3207,3131
8311,1,1,995,1247,252
8312,1,1,130,3074,2944
8313,1,1,75,1741,1666
8314,1,0,79,0,-79
8315,0,0,28,0,-28
8316,1,0,92,0,-92
8317,1,0,96,0,-96
8318,0,0,34,0,-34
8319,1,0,107,0,-107
8320,1,0,29,0,-29
8321,0,0,10,0,-10
8322,1,0,102,0,-102
8323,1,1,502,1642,1140
8324,0,0,141,0,-141
8325,1,1,161,2080,1919
8326,1,1,390,1972,1582
8327,0,0,31,0,-31
8328,1,0,76,0,-76
8329,1,1,672,1924,1252
8330,1,0,31,0,-31
8331,0,0,75,0,-75
8332,1,0,101,0,-101
8333,1,1,47,1523,1476
8334,1,1,217,1434,1217
8335,1,0,13,0,-13
8336,0,0,79,0,-79
8337,0,0,47,0,-47
8338,1,1,448,1241,793
8339,1,1,522,1384,862
8340,1,0,3,0,-3
8341,1,1,1447,1604,157
8342,0,0,35,0,-35
8343,0,0,33,0,-33
8344,1,0,23,0,-23
8345,1,0,8,0,-8
8346,1,0,34,0,-34
8347,1,1,243,1297,1054
8348,0,0,79,0,-79
8349,1,1,84,1354,1270
8350,0,0,1,0,-1
8351,1,0,62,0,-62
8352,1,1,506,1362,856
8353,0,0,74,0,-74
8354,0,0,75,0,-75
8355,1,0,1,0,-1
8356,1,1,90,1327,1237
8357,0,0,12,0,-12
8358,1,0,153,0,-153
8359,1,1,301,1289,988
8360,1,1,150,1980,1830
8361,0,0,27,0,-27
8362,1,0,33,0,-33
8363,1,0,31,0,-31
8364,0,0,19,0,-19
8365,0,0,3,0,-3
8366,0,0,89,0,-89
8367,0,0,23,0,-23
8368,0,0,55,0,-55
8369,1,1,1216,2624,1408
8370,0,0,42,0,-42
8371,1,1,71,1428,1357
8372,0,0,27,0,-27
8373,0,0,135,0,-135
8374,0,0,2,0,-2
8375,1,1,203,1373,1170
8376,1,0,18,0,-18
8377,1,1,57,1723,1666
8378,0,0,26,0,-26
8379,1,0,156,0,-156
8380,1,0,35,0,-35
8381,1,1,627,1266,639
8382,0,0,27,0,-27
8383,0,0,41,0,-41
8384,1,1,879,1381,502
8385,1,0,23,0,-23
8386,1,1,691,2061,1370
8387,1,1,2779,2287,-492
8388,1,0,37,0,-37
8389,1,1,245,1338,1093
8390,0,0,26,0,-26
8391,0,0,33,0,-33
8392,0,0,73,0,-73
8393,1,1,446,2038,1592
8394,1,1,124,2747,2623
8395,1,1,1430,1334,-96
8396,1,0,51,0,-51
8397,0,0,26,0,-26
8398,0,0,42,0,-42
8399,1,0,27,0,-27
8400,1,0,65,0,-65
8401,1,0,74,0,-74
8402,1,1,144,1557,1413
8403,1,1,153,1320,1167
8404,1,1,1181,1328,147
8405,0,0,37,0,-37
8406,0,0,0,0,0
8407,0,0,37,0,-37
8408,1,1,264,1657,1393
8409,0,0,8,0,-8
8410,0,0,5,0,-5
8411,0,0,21,0,-21
8412,0,0,80,0,-80
8413,0,0,48,0,-48
8414,1,1,1730,1253,-477
8415,1,1,175,2401,2226
8416,0,0,50,0,-50
8417,1,0,31,0,-31
8418,0,0,81,0,-81
8419,1,1,327,1476,1149
8420,1,1,654,1416,762
8421,1,0,24,0,-24
8422,0,0,17,0,-17
8423,1,1,695,1528,833
8424,1,0,3,0,-3
8425,0,0,27,0,-27
8426,0,0,4,0,-4
8427,1,0,51,0,-51
8428,1,1,187,1407,1220
8429,0,0,4,0,-4
8430,0,0,174,0,-174
8431,1,1,746,1367,621
8432,0,0,8,0,-8
8433,0,0,116,0,-116
8434,1,0,20,0,-20
8435,1,0,76,0,-76
8436,0,0,2,0,-2
8437,1,0,81,0,-81
8438,1,1,586,1711,1125
8439,1,1,314,1273,959
8440,0,0,61,0,-61
8441,0,0,16,0,-16
8442,1,1,398,1273,875
8443,1,1,70,1293,1223
8444,1,0,76,0,-76
8445,1,0,50,0,-50
8446,0,0,45,0,-45
8447,1,1,421,1492,1071
8448,0,0,39,0,-39
8449,1,1,158,1297,1139
8450,1,1,210,1634,1424
8451,1,0,10,0,-10
8452,1,1,335,1275,940
8453,1,0,64,0,-64
8454,1,0,220,0,-220
8455,1,0,13,0,-13
8456,1,0,24,0,-24
8457,1,1,133,1773,1640
8458,1,1,1203,1298,95
8459,1,0,66,0,-66
8460,1,1,1603,1294,-309
8461,1,0,82,0,-82
8462,0,0,16,0,-16
8463,0,0,5,0,-5
8464,0,0,74,0,-74
8465,1,1,30,1452,1422
8466,0,0,26,0,-26
8467,0,0,0,0,0
8468,0,0,29,0,-29
8469,0,0,31,0,-31
8470,0,0,20,0,-20
8471,0,0,14,0,-14
8472,1,1,126,1547,1421
8473,1,0,45,0,-45
8474,1,1,645,1265,620
8475,1,1,384,1381,997
8476,1,1,1331,1616,285
8477,1,0,30,0,-30
8478,1,1,186,1583,1397
8479,1,0,84,0,-84
8480,1,0,23,0,-23
8481,0,0,5,0,-5
8482,0,0,35,0,-35
8483,0,0,36,0,-36
8484,0,0,137,0,-137
8485,1,1,80,1343,1263
8486,1,0,35,0,-35
8487,0,0,34,0,-34
8488,1,1,210,1729,1519
8489,1,0,27,0,-27
8490,1,1,412,1303,891
8491,1,1,842,1358,516
8492,1,1,981,5028,4047
8493,1,0,12,0,-12
8494,0,0,45,0,-45
8495,1,0,66,0,-66
8496,1,0,204,0,-204
8497,0,0,48,0,-48
8498,1,1,154,1750,1596
8499,1,1,132,1325,1193
8500,0,0,92,0,-92
8501,0,0,51,0,-51
8502,0,0,19,0,-19
8503,0,0,10,0,-10
8504,0,0,36,0,-36
8505,1,0,5,0,-5
8506,1,0,94,0,-94
8507,0,0,42,0,-42
8508,1,1,487,1245,758
8509,1,1,112,1515,1403
8510,0,0,18,0,-18
8511,1,1,2071,1326,-745
8512,0,0,4,0,-4
8513,0,0,25,0,-25
8514,1,0,50,0,-50
8515,0,0,160,0,-160
8516,1,1,462,2109,1647
8517,0,0,220,0,-220
8518,1,0,25,0,-25
8519,1,1,1036,1708,672
8520,1,0,86,0,-86
8521,1,0,43,0,-43
8522,1,1,1293,1258,-35
8523,0,0,100,0,-100
8524,1,0,11,0,-11
8525,0,0,44,0,-44
8526,1,1,103,1650,1547
8527,1,1,370,1524,1154
8528,0,0,16,0,-16
8529,1,0,12,0,-12
8530,0,0,50,0,-50
8531,0,0,4,0,-4
8532,1,1,381,1256,875
8533,0,0,5,0,-5
8534,1,1,68,1463,1395
8535,1,0,108,0,-108
8536,1,1,208,1380,1172
8537,0,0,62,0,-62
8538,1,1,631,1722,1091
8539,1,1,273,1282,1009
8540,0,0,103,0,-103
8541,1,1,393,2042,1649
8542,1,0,17,0,-17
8543,0,0,36,0,-36
8544,1,0,6,0,-6
8545,1,0,71,0,-71
8546,0,0,13,0,-13
8547,1,1,75,1301,1226
8548,0,0,157,0,-157
8549,0,0,32,0,-32
8550,1,0,100,0,-100
8551,1,1,609,1429,820
8552,0,0,44,0,-44
8553,0,0,17,0,-17
8554,1,0,71,0,-71
8555,1,1,2256,1279,-977
8556,1,0,161,0,-161
8557,1,0,76,0,-76
8558,1,1,338,1649,1311
8559,1,1,61,2230,2169
8560,1,0,31,0,-31
8561,1,0,23,0,-23
8562,1,0,3,0,-3
8563,1,0,60,0,-60
8564,1,1,311,1487,1176
8565,1,0,4,0,-4
8566,1,1,96,1326,1230
8567,0,0,124,0,-124
8568,0,0,11,0,-11
8569,1,1,201,1406,1205
8570,1,1,52,1723,1671
8571,1,0,44,0,-44
8572,0,0,78,0,-78
8573,0,0,5,0,-5
8574,1,0,67,0,-67
8575,0,0,63,0,-63
8576,0,0,24,0,-24
8577,0,0,25,0,-25
8578,1,0,0,0,0
8579,0,0,63,0,-63
8580,1,0,1,0,-1
8581,0,0,13,0,-13
8582,1,1,260,1275,1015
8583,1,1,96,1260,1164
8584,1,0,214,0,-214
8585,0,0,52,0,-52
8586,0,0,36,0,-36
8587,1,0,92,0,-92
8588,0,0,12,0,-12
8589,1,0,26,0,-26
8590,1,1,143,1323,1180
8591,0,0,52,0,-52
8592,1,1,1961,1828,-133
8593,1,0,3,0,-3
8594,1,1,645,2612,1967
8595,1,1,177,1361,1184
8596,1,0,301,0,-301
8597,0,0,9,0,-9
8598,1,0,95,0,-95
8599,1,1,366,1266,900
8600,0,0,31,0,-31
8601,1,1,548,2333,1785
8602,1,0,3,0,-3
8603,0,0,2,0,-2
8604,0,0,8,0,-8
8605,1,0,20,0,-20
8606,0,0,30,0,-30
8607,1,1,488,1313,825
8608,0,0,48,0,-48
8609,0,0,222,0,-222
8610,1,1,973,1383,410
8611,1,1,732,1717,985
8612,0,0,8,0,-8
8613,1,0,55,0,-55
8614,1,1,1928,1375,-553
8615,1,0,32,0,-32
8616,1,1,196,1434,1238
8617,0,0,1,0,-1
8618,0,0,35,0,-35
8619,1,1,235,1360,1125
8620,1,0,44,0,-44
8621,0,0,85,0,-85
8622,0,0,16,0,-16
8623,1,1,560,1310,750
8624,1,1,393,1532,1139
8625,0,0,68,0,-68
8626,1,0,168,0,-168
8627,1,1,300,1307,1007
8628,1,1,501,1367,866
8629,1,1,604,1451,847
8630,1,1,201,1332,1131
8631,0,0,83,0,-83
8632,0,0,57,0,-57
8633,1,0,200,0,-200
8634,0,0,45,0,-45
8635,0,0,278,0,-278
8636,0,0,11,0,-11
8637,0,0,91,0,-91
8638,1,1,410,1513,1103
8639,0,0,36,0,-36
8640,0,0,66,0,-66
8641,1,0,1,0,-1
8642,0,0,280,0,-280
8643,1,1,299,1999,1700
8644,1,0,2,0,-2
8645,1,1,247,1333,1086
8646,1,1,54,2115,2061
8647,1,1,593,1919,1326
8648,1,1,255,1544,1289
8649,0,0,6,0,-6
8650,1,1,420,1969,1549
8651,1,0,6,0,-6
8652,0,0,49,0,-49
8653,0,0,2,0,-2
8654,0,0,27,0,-27
8655,1,0,116,0,-116
8656,1,1,1058,1640,582
8657,1,0,17,0,-17
8658,1,0,13,0,-13
8659,1,1,181,1242,1061
8660,1,1,456,1252,796
8661,1,0,2,0,-2
8662,0,0,68,0,-68
8663,0,0,9,0,-9
8664,1,0,115,0,-115
8665,1,1,368,1235,867
8666,0,0,25,0,-25
8667,1,0,52,0,-52
8668,0,0,49,0,-49
8669,0,0,165,0,-165
8670,0,0,15,0,-15
8671,1,1,645,1420,775
8672,1,0,18,0,-18
8673,0,0,8,0,-8
8674,0,0,15,0,-15
8675,0,0,16,0,-16
8676,0,0,23,0,-23
8677,0,0,10,0,-10
8678,0,0,1,0,-1
8679,1,0,58,0,-58
8680,1,0,78,0,-78
8681,1,1,1036,1985,949
8682,0,0,20,0,-20
8683,1,0,36,0,-36
8684,1,1,367,1508,1141
8685,0,0,21,0,-21
8686,1,1,140,3299,3159
8687,0,0,59,0,-59
8688,0,0,19,0,-19
8689,1,1,1827,1272,-555
8690,1,0,24,0,-24
8691,1,1,335,2140,1805
8692,1,0,26,0,-26
8693,1,1,1251,1629,378
8694,1,0,80,0,-80
8695,1,1,207,3665,3458
8696,1,0,52,0,-52
8697,0,0,63,0,-63
8698,1,0,118,0,-118
8699,0,0,35,0,-35
8700,1,1,506,1491,985
8701,1,1,614,1418,804
8702,0,0,78,0,-78
8703,1,0,51,0,-51
8704,0,0,139,0,-139
8705,0,0,17,0,-17
8706,1,1,145,1412,1267
8707,1,1,613,4102,3489
8708,1,0,17,0,-17
8709,0,0,71,0,-71
8710,0,0,97,0,-97
8711,1,0,48,0,-48
8712,1,0,52,0,-52
8713,1,1,317,1463,1146
8714,1,0,67,0,-67
8715,0,0,6,0,-6
8716,1,0,2,0,-2
8717,1,0,93,0,-93
8718,0,0,8,0,-8
8719,1,0,43,0,-43
8720,1,1,27,1322,1295
8721,1,0,28,0,-28
8722,1,1,988,1302,314
8723,1,1,109,1336,1227
8724,0,0,337,0,-337
8725,0,0,13,0,-13
8726,0,0,8,0,-8
8727,1,0,49,0,-49
8728,0,0,101,0,-101
8729,0,0,51,0,-51
8730,0,0,11,0,-11
8731,1,0,79,0,-79
8732,0,0,1,0,-1
8733,0,0,19,0,-19
8734,0,0,25,0,-25
8735,1,1,266,1367,1101
8736,1,0,164,0,-164
8737,1,1,673,1259,586
8738,0,0,91,0,-91
8739,1,1,171,1737,1566
8740,1,0,103,0,-103
8741,0,0,15,0,-15
8742,1,1,211,1783,1572
8743,1,0,29,0,-29
8744,0,0,5,0,-5
8745,1,1,431,1343,912
8746,1,1,374,1692,1318
8747,1,1,948,2348,1400
8748,0,0,34,0,-34
8749,0,0,111,0,-111
8750,1,0,104,0,-104
8751,0,0,0,0,0
8752,0,0,177,0,-177
8753,1,0,9,0,-9
8754,1,1,893,1811,918
8755,1,0,26,0,-26
8756,0,0,78,0,-78
8757,1,1,323,1621,1298
8758,1,0,66,0,-66
8759,0,0,14,0,-14
8760,0,0,44,0,-44
8761,1,0,68,0,-68
8762,0,0,2,0,-2
8763,1,1,645,1714,1069
8764,1,1,494,1993,1499
8765,0,0,82,0,-82
8766,0,0,6,0,-6
8767,0,0,24,0,-24
8768,1,1,1246,2687,1441
8769,1,1,441,6288,5847
8770,1,0,21,0,-21
8771,0,0,4,0,-4
8772,0,0,134,0,-134
8773,1,0,34,0,-34
8774,1,1,353,1544,1191
8775,1,1,810,1521,711
8776,1,1,104,1332,1228
8777,1,0,94,0,-94
8778,0,0,97,0,-97
8779,1,0,117,0,-117
8780,1,1,178,1537,1359
8781,0,0,40,0,-40
8782,0,0,49,0,-49
8783,0,0,79,0,-79
8784,1,1,85,1922,1837
8785,0,0,18,0,-18
8786,1,0,18,0,-18
8787,1,1,671,1317,646
8788,0,0,72,0,-72
8789,1,1,496,2520,2024
8790,1,1,238,1271,1033
8791,1,0,0,0,0
8792,1,1,207,1562,1355
8793,0,0,74,0,-74
8794,1,1,325,1569,1244
8795,0,0,9,0,-9
8796,1,0,19,0,-19
8797,0,0,21,0,-21
8798,1,1,1162,1568,406
8799,1,1,480,1650,1170
8800,1,0,16,0,-16
8801,1,1,154,1338,1184
8802,1,1,652,1533,881
8803,0,0,0,0,0
8804,1,1,859,1243,384
8805,0,0,126,0,-126
8806,1,0,159,0,-159
8807,1,0,40,0,-40
8808,1,0,30,0,-30
8809,1,0,11,0,-11
8810,1,0,126,0,-126
8811,1,0,112,0,-112
8812,1,0,86,0,-86
8813,1,0,17,0,-17
8814,0,0,133,0,-133
8815,1,0,11,0,-11
8816,1,0,72,0,-72
8817,0,0,394,0,-394
8818,1,0,17,0,-17
8819,1,0,141,0,-141
8820,1,1,83,1976,1893
8821,1,1,74,1396,1322
8822,1,0,23,0,-23
8823,0,0,0,0,0
8824,1,0,63,0,-63
8825,1,0,85,0,-85
8826,1,0,104,0,-104
8827,1,0,116,0,-116
8828,1,1,39,1455,1416
8829,0,0,40,0,-40
8830,1,1,698,1327,629
8831,1,1,455,1312,857
8832,1,0,139,0,-139
8833,1,1,785,1759,974
8834,1,0,35,0,-35
8835,0,0,55,0,-55
8836,0,0,5,0,-5
8837,1,0,27,0,-27
8838,0,0,8,0,-8
8839,1,1,1032,2313,1281
8840,1,0,117,0,-117
8841,1,0,16,0,-16
8842,1,0,0,0,0
8843,1,0,1,0,-1
8844,1,0,3,0,-3
8845,1,0,99,0,-99
8846,0,0,15,0,-15
8847,0,0,10,0,-10
8848,1,0,9,0,-9
8849,0,0,18,0,-18
8850,0,0,27,0,-27
8851,1,1,130,1407,1277
8852,0,0,108,0,-108
8853,0,0,67,0,-67
8854,1,1,542,1302,760
8855,1,1,428,1570,1142
8856,1,0,138,0,-138
8857,0,0,57,0,-57
8858,1,1,482,1276,794
8859,0,0,34,0,-34
8860,0,0,24,0,-24
8861,0,0,4,0,-4
8862,0,0,17,0,-17
8863,1,1,196,2642,2446
8864,0,0,62,0,-62
8865,1,1,180,1481,1301
8866,0,0,18,0,-18
8867,1,1,804,1403,599
8868,1,0,16,0,-16
8869,1,1,181,2094,1913
8870,1,0,48,0,-48
8871,1,0,30,0,-30
8872,0,0,28,0,-28
8873,0,0,21,0,-21
8874,0,0,59,0,-59
8875,1,0,23,0,-23
8876,1,0,64,0,-64
8877,0,0,13,0,-13
8878,1,1,518,1522,1004
8879,0,0,140,0,-140
8880,1,1,496,2073,1577
8881,1,0,19,0,-19
8882,1,0,6,0,-6
8883,0,0,2,0,-2
8884,1,1,25,1321,1296
8885,0,0,53,0,-53
8886,1,0,16,0,-16
8887,1,0,0,0,0
8888,1,1,351,1394,1043
8889,1,1,41,1631,1590
8890,0,0,107,0,-107
8891,0,0,20,0,-20
8892,0,0,13,0,-13
8893,1,1,180,1874,1694
8894,1,1,266,2002,1736
8895,1,1,61,1266,1205
8896,1,0,25,0,-25
8897,1,0,80,0,-80
8898,1,0,44,0,-44
8899,0,0,6,0,-6
8900,1,0,13,0,-13
8901,1,0,36,0,-36
8902,0,0,38,0,-38
8903,1,0,0,0,0
8904,0,0,13,0,-13
8905,1,0,91,0,-91
8906,0,0,92,0,-92
8907,0,0,33,0,-33
8908,1,0,39,0,-39
8909,1,0,16,0,-16
8910,0,0,112,0,-112
8911,0,0,26,0,-26
8912,0,0,7,0,-7
8913,0,0,170,0,-170
8914,0,0,19,0,-19
8915,0,0,64,0,-64
8916,1,0,43,0,-43
8917,1,1,248,1637,1389
8918,1,1,665,1408,743
8919,0,0,10,0,-10
8920,0,0,70,0,-70
8921,1,1,76,1236,1160
8922,1,0,169,0,-169
8923,1,1,1495,1329,-166
8924,1,1,348,1379,1031
8925,0,0,105,0,-105
8926,1,1,147,1305,1158
8927,0,0,44,0,-44
8928,1,1,51,2441,2390
8929,1,0,9,0,-9
8930,1,0,159,0,-159
8931,0,0,6,0,-6
8932,0,0,58,0,-58
8933,0,0,43,0,-43
8934,0,0,0,0,0
8935,1,1,1041,1278,237
8936,1,1,41,2205,2164
8937,1,1,352,1251,899
8938,0,0,19,0,-19
8939,1,0,32,0,-32
8940,0,0,15,0,-15
8941,1,0,62,0,-62
8942,0,0,52,0,-52
8943,0,0,7,0,-7
8944,1,0,15,0,-15
8945,1,1,81,1868,1787
8946,1,0,128,0,-128
8947,0,0,11,0,-11
8948,1,0,22,0,-22
8949,0,0,13,0,-13
8950,0,0,105,0,-105
8951,1,1,194,1247,1053
8952,0,0,16,0,-16
8953,0,0,16,0,-16
8954,1,0,48,0,-48
8955,1,0,36,0,-36
8956,1,1,956,1411,455
8957,0,0,26,0,-26
8958,1,0,131,0,-131
8959,0,0,16,0,-16
8960,1,1,441,1316,875
8961,1,0,90,0,-90
8962,0,0,4,0,-4
8963,1,1,328,1803,1475
8964,1,1,489,1259,770
8965,1,1,285,1507,1222
8966,0,0,39,0,-39
8967,1,0,18,0,-18
8968,1,1,444,1250,806
8969,1,1,1268,1339,71
8970,0,0,15,0,-15
8971,1,1,772,1306,534
8972,1,0,118,0,-118
8973,1,1,1434,1240,-194
8974,0,0,8,0,-8
8975,0,0,76,0,-76
8976,1,0,5,0,-5
8977,1,0,72,0,-72
8978,1,1,1405,1433,28
8979,0,0,22,0,-22
8980,1,1,269,2094,1825
8981,1,1,313,1239,926
8982,1,1,482,1402,920
8983,1,0,56,0,-56
8984,0,0,106,0,-106
8985,1,0,35,0,-35
8986,1,1,232,1465,1233
8987,1,0,70,0,-70
8988,1,1,21,1406,1385
8989,0,0,33,0,-33
8990,1,1,407,1280,873
8991,1,1,750,1418,668
8992,1,0,42,0,-42
8993,0,0,0,0,0
8994,1,0,60,0,-60
8995,0,0,34,0,-34
8996,1,1,427,3872,3445
8997,0,0,1,0,-1
8998,1,1,413,1249,836
8999,1,1,394,1301,907
9000,0,0,81,0,-81
9001,0,0,3,0,-3
9002,1,0,47,0,-47
9003,0,0,30,0,-30
9004,1,1,764,1337,573
9005,1,0,112,0,-112
9006,1,1,244,1968,1724
9007,0,0,14,0,-14
9008,1,0,42,0,-42
9009,0,0,67,0,-67
9010,1,0,33,0,-33
9011,0,0,200,0,-200
9012,0,0,111,0,-111
9013,1,1,207,2394,2187
9014,0,0,21,0,-21
9015,0,0,110,0,-110
9016,1,0,77,0,-77
9017,0,0,132,0,-132
9018,0,0,8,0,-8
9019,1,0,5,0,-5
9020,0,0,22,0,-22
9021,1,0,35,0,-35
9022,1,1,110,1555,1445
9023,0,0,51,0,-51
9024,1,0,41,0,-41
9025,1,1,128,1358,1230
9026,0,0,14,0,-14
9027,1,1,183,1446,1263
9028,1,1,646,1256,610
9029,1,0,22,0,-22
9030,1,1,323,1606,1283
9031,0,0,39,0,-39
9032,1,1,369,1389,1020
9033,0,0,45,0,-45
9034,1,0,7,0,-7
9035,0,0,9,0,-9
9036,1,0,229,0,-229
9037,0,0,21,0,-21
9038,1,1,123,1395,1272
9039,0,0,75,0,-75
9040,0,0,6,0,-6
9041,1,1,143,1529,1386
9042,0,0,32,0,-32
9043,0,0,9,0,-9
9044,1,1,959,1320,361
9045,0,0,49,0,-49
9046,0,0,59,0,-59
9047,0,0,61,0,-61
9048,1,0,24,0,-24
9049,0,0,14,0,-14
9050,1,0,125,0,-125
9051,1,1,701,1885,1184
9052,0,0,59,0,-59
9053,0,0,22,0,-22
9054,1,1,507,3357,2850
9055,1,1,516,2677,2161
9056,0,0,24,0,-24
9057,0,0,58,0,-58
9058,0,0,110,0,-110
9059,1,1,1160,1259,99
9060,1,1,1784,1391,-393
9061,1,1,32,1621,1589
9062,1,0,2,0,-2
9063,0,0,143,0,-143
9064,0,0,4,0,-4
9065,1,0,74,0,-74
9066,0,0,13,0,-13
9067,0,0,58,0,-58
9068,1,0,18,0,-18
9069,1,0,13,0,-13
9070,0,0,7,0,-7
9071,1,1,669,1354,685
9072,1,1,528,2727,2199
9073,1,1,534,1477,943
9074,1,0,117,0,-117
9075,0,0,39,0,-39
9076,1,1,1441,1792,351
9077,1,1,255,1602,1347
9078,0,0,93,0,-93
9079,1,1,289,1316,1027
9080,1,0,33,0,-33
9081,1,1,389,1783,1394
9082,1,1,1009,1447,438
9083,0,0,20,0,-20
9084,1,1,674,1334,660
9085,0,0,10,0,-10
9086,0,0,53,0,-53
9087,0,0,4,0,-4
9088,1,1,69,1769,1700
9089,1,1,268,1274,1006
9090,1,0,60,0,-60
9091,1,0,106,0,-106
9092,1,0,7,0,-7
9093,0,0,6,0,-6
9094,1,1,1314,1836,522
9095,1,0,0,0,0
9096,0,0,43,0,-43
9097,1,1,1046,1346,300
9098,1,1,302,2009,1707
9099,0,0,151,0,-151
9100,0,0,9,0,-9
9101,1,0,14,0,-14
9102,1,0,46,0,-46
9103,0,0,28,0,-28
9104,1,0,91,0,-91
9105,1,1,1536,1242,-294
9106,1,1,421,1267,846
9107,1,1,350,1366,1016
9108,0,0,13,0,-13
9109,1,0,14,0,-14
9110,1,1,997,2498,1501
9111,0,0,24,0,-24
9112,0,0,63,0,-63
9113,0,0,81,0,-81
9114,1,1,1848,1500,-348
9115,1,0,84,0,-84
9116,0,0,214,0,-214
9117,1,1,1100,1252,152
9118,1,1,1059,1866,807
9119,1,1,285,1253,968
9120,0,0,8,0,-8
9121,0,0,142,0,-142
9122,0,0,26,0,-26
9123,0,0,145,0,-145
9124,0,0,108,0,-108
9125,1,1,197,1632,1435
9126,1,0,65,0,-65
9127,1,0,5,0,-5
9128,1,0,87,0,-87
9129,0,0,17,0,-17
9130,0,0,116,0,-116
9131,0,0,9,0,-9
9132,0,0,12,0,-12
9133,0,0,49,0,-49
9134,0,0,21,0,-21
9135,0,0,22,0,-22
9136,1,0,20,0,-20
9137,0,0,21,0,-21
9138,1,1,133,1780,1647
9139,0,0,3,0,-3
9140,1,0,28,0,-28
9141,0,0,14,0,-14
9142,1,0,44,0,-44
9143,0,0,121,0,-121
9144,1,0,7,0,-7
9145,1,0,89,0,-89
9146,0,0,134,0,-134
9147,1,1,1534,1285,-249
9148,1,0,5,0,-5
9149,0,0,3,0,-3
9150,0,0,125,0,-125
9151,1,0,52,0,-52
9152,1,0,35,0,-35
9153,1,0,9,0,-9
9154,1,1,1282,1496,214
9155,0,0,3,0,-3
9156,0,0,69,0,-69
9157,1,0,22,0,-22
9158,1,0,42,0,-42
9159,0,0,5,0,-5
9160,1,1,177,1763,1586
9161,1,1,98,5029,4931
9162,1,1,784,1857,1073
9163,1,1,101,1352,1251
9164,0,0,171,0,-171
9165,0,0,82,0,-82
9166,1,0,95,0,-95
9167,1,1,251,2048,1797
9168,1,1,153,1281,1128
9169,0,0,31,0,-31
9170,0,0,16,0,-16
9171,1,1,17,1275,1258
9172,1,0,59,0,-59
9173,0,0,14,0,-14
9174,1,1,235,1301,1066
9175,1,0,24,0,-24
9176,1,0,60,0,-60
9177,1,0,25,0,-25
9178,1,1,95,1311,1216
9179,0,0,41,0,-41
9180,1,0,6,0,-6
9181,0,0,4,0,-4
9182,1,1,1225,2004,779
9183,1,1,964,1303,339
9184,0,0,101,0,-101
9185,1,1,478,1258,780
9186,1,1,811,1369,558
9187,1,0,19,0,-19
9188,1,0,220,0,-220
9189,0,0,99,0,-99
9190,1,0,23,0,-23
9191,0,0,42,0,-42
9192,0,0,23,0,-23
9193,0,0,1,0,-1
9194,1,0,84,0,-84
9195,1,1,583,1466,883
9196,1,0,40,0,-40
9197,0,0,21,0,-21
9198,1,0,91,0,-91
9199,0,0,25,0,-25
9200,0,0,30,0,-30
9201,0,0,3,0,-3
9202,1,0,94,0,-94
9203,1,1,136,1424,1288
9204,1,0,17,0,-17
9205,0,0,56,0,-56
9206,1,0,7,0,-7
9207,0,0,59,0,-59
9208,1,1,408,2865,2457
9209,1,1,588,1279,691
9210,1,1,512,1463,951
9211,1,0,51,0,-51
9212,1,1,109,2095,1986
9213,0,0,71,0,-71
9214,0,0,49,0,-49
9215,1,1,92,1273,1181
9216,0,0,159,0,-159
9217,1,1,285,1285,1000
9218,1,0,18,0,-18
9219,1,1,56,2301,2245
9220,0,0,66,0,-66
9221,1,1,834,2040,1206
9222,1,1,182,1295,1113
9223,1,1,159,1358,1199
9224,0,0,14,0,-14
9225,0,0,55,0,-55
9226,1,1,975,1352,377
9227,0,0,20,0,-20
9228,1,0,19,0,-19
9229,1,0,44,0,-44
9230,1,1,556,1341,785
9231,1,0,19,0,-19
9232,0,0,53,0,-53
9233,0,0,69,0,-69
9234,0,0,105,0,-105
9235,1,0,2,0,-2
9236,1,0,32,0,-32
9237,0,0,53,0,-53
9238,1,1,1011,1407,396
9239,1,1,314,1274,960
9240,1,0,22,0,-22
9241,1,1,579,1801,1222
9242,0,0,6,0,-6
9243,1,0,13,0,-13
9244,1,0,43,0,-43
9245,1,0,14,0,-14
9246,1,0,2,0,-2
9247,1,0,91,0,-91
9248,0,0,78,0,-78
9249,1,0,52,0,-52
9250,0,0,64,0,-64
9251,1,0,45,0,-45
9252,0,0,13,0,-13
9253,1,1,416,1830,1414
9254,1,0,72,0,-72
9255,0,0,72,0,-72
9256,0,0,62,0,-62
9257,0,0,43,0,-43
9258,1,0,69,0,-69
9259,1,0,4,0,-4
9260,1,0,8,0,-8
9261,1,0,31,0,-31
9262,1,0,67,0,-67
9263,1,1,225,1295,1070
9264,1,1,525,3648,3123
9265,1,1,128,1362,1234
9266,1,0,91,0,-91
9267,1,0,98,0,-98
9268,1,1,22,1345,1323
9269,0,0,59,0,-59
9270,0,0,116,0,-116
9271,1,1,621,1404,783
9272,1,0,2,0,-2
9273,1,1,143,2325,2182
9274,0,0,17,0,-17
9275,1,0,37,0,-37
9276,1,0,36,0,-36
9277,1,0,82,0,-82
9278,1,1,566,1302,736
9279,1,0,20,0,-20
9280,0,0,8,0,-8
9281,1,1,1020,1338,318
9282,0,0,47,0,-47
9283,0,0,17,0,-17
9284,1,0,5,0,-5
9285,1,0,23,0,-23
9286,1,1,200,1875,1675
9287,1,1,188,1363,1175
9288,1,1,1162,1865,703
9289,1,0,96,0,-96
9290,1,0,70,0,-70
9291,1,1,892,1268,376
9292,1,0,22,0,-22
9293,1,1,629,1237,608
9294,1,0,40,0,-40
9295,1,0,52,0,-52
9296,0,0,45,0,-45
9297,1,1,532,1285,753
9298,1,1,498,1839,1341
9299,1,0,10,0,-10
9300,0,0,69,0,-69
9301,1,0,1,0,-1
9302,0,0,6,0,-6
9303,1,0,5,0,-5
9304,0,0,21,0,-21
9305,1,1,251,1267,1016
9306,1,0,55,0,-55
9307,1,0,54,0,-54
9308,0,0,23,0,-23
9309,1,0,35,0,-35
9310,0,0,170,0,-170
9311,1,1,345,2118,1773
9312,0,0,97,0,-97
9313,0,0,111,0,-111
9314,1,0,133,0,-133
9315,0,0,40,0,-40
9316,1,1,533,1369,836
9317,0,0,11,0,-11
9318,0,0,15,0,-15
9319,1,0,65,0,-65
9320,1,1,457,1930,1473
9321,0,0,27,0,-27
9322,1,1,30,1241,1211
9323,1,0,26,0,-26
9324,1,0,3,0,-3
9325,1,0,28,0,-28
9326,0,0,94,0,-94
9327,1,1,993,1398,405
9328,1,0,201,0,-201
9329,0,0,62,0,-62
9330,1,1,344,1519,1175
9331,0,0,108,0,-108
9332,1,0,36,0,-36
9333,0,0,113,0,-113
9334,1,0,24,0,-24
9335,0,0,79,0,-79
9336,1,1,109,1485,1376
9337,1,0,5,0,-5
9338,1,1,438,1272,834
9339,0,0,15,0,-15
9340,1,0,26,0,-26
9341,0,0,5,0,-5
9342,0,0,1,0,-1
9343,0,0,144,0,-144
9344,0,0,66,0,-66
9345,1,0,125,0,-125
9346,1,1,1361,1492,131
9347,0,0,5,0,-5
9348,1,0,190,0,-190
9349,0,0,48,0,-48
9350,1,0,73,0,-73
9351,1,1,255,1634,1379
9352,1,0,147,0,-147
9353,1,0,46,0,-46
9354,0,0,67,0,-67
9355,0,0,54,0,-54
9356,1,1,784,2086,1302
9357,0,0,101,0,-101
9358,0,0,61,0,-61
9359,0,0,27,0,-27
9360,1,1,203,1535,1332
9361,0,0,56,0,-56
9362,0,0,22,0,-22
9363,1,0,11,0,-11
9364,0,0,74,0,-74
9365,0,0,34,0,-34
9366,0,0,182,0,-182
9367,1,1,345,1570,1225
9368,0,0,28,0,-28
9369,0,0,144,0,-144
9370,1,1,901,1272,371
9371,1,1,188,1363,1175
9372,0,0,1,0,-1
9373,0,0,29,0,-29
9374,1,0,1,0,-1
9375,1,1,1682,3737,2055
9376,0,0,184,0,-184
9377,0,0,5,0,-5
9378,1,0,2,0,-2
9379,0,0,151,0,-151
9380,0,0,0,0,0
9381,0,0,105,0,-105
9382,0,0,17,0,-17
9383,0,0,236,0,-236
9384,0,0,79,0,-79
9385,0,0,5,0,-5
9386,1,1,895,2252,1357
9387,1,1,45,1360,1315
9388,0,0,20,0,-20
9389,1,1,803,1336,533
9390,1,0,43,0,-43
9391,0,0,103,0,-103
9392,1,0,8,0,-8
9393,1,1,211,1342,1131
9394,1,1,54,1896,1842
9395,1,1,352,1328,976
9396,1,1,598,1474,876
9397,1,0,6,0,-6
9398,1,0,15,0,-15
9399,0,0,48,0,-48
9400,1,1,297,3350,3053
9401,1,0,14,0,-14
9402,1,1,241,1318,1077
9403,1,0,35,0,-35
9404,1,0,15,0,-15
9405,0,0,2,0,-2
9406,1,0,41,0,-41
9407,1,0,80,0,-80
9408,0,0,37,0,-37
9409,0,0,26,0,-26
9410,1,0,56,0,-56
9411,0,0,13,0,-13
9412,0,0,3,0,-3
9413,1,1,908,2000,1092
9414,0,0,11,0,-11
9415,0,0,11,0,-11
9416,0,0,112,0,-112
9417,1,1,831,1945,1114
9418,0,0,26,0,-26
9419,0,0,25,0,-25
9420,1,0,45,0,-45
9421,0,0,12,0,-12
9422,1,0,29,0,-29
9423,0,0,174,0,-174
9424,1,1,574,1549,975
9425,1,0,8,0,-8
9426,1,1,263,1430,1167
9427,1,0,23,0,-23
9428,1,0,3,0,-3
9429,1,0,19,0,-19
9430,1,1,533,1563,1030
9431,1,1,164,1518,1354
9432,0,0,41,0,-41
9433,1,0,78,0,-78
9434,0,0,40,0,-40
9435,1,1,1994,2157,163
9436,1,0,11,0,-11
9437,1,0,24,0,-24
9438,0,0,118,0,-118
9439,0,0,49,0,-49
9440,1,0,110,0,-110
9441,1,0,100,0,-100
9442,1,1,433,1868,1435
9443,0,0,43,0,-43
9444,1,0,40,0,-40
9445,1,0,7,0,-7
9446,0,0,10,0,-10
9447,0,0,4,0,-4
9448,1,0,105,0,-105
9449,0,0,9,0,-9
9450,1,1,100,1376,1276
9451,0,0,101,0,-101
9452,1,0,14,0,-14
9453,1,0,50,0,-50
9454,1,0,6,0,-6
9455,0,0,36,0,-36
9456,0,0,17,0,-17
9457,1,1,1744,1368,-376
9458,1,1,196,1554,1358
9459,1,0,1,0,-1
9460,0,0,19,0,-19
9461,0,0,49,0,-49
9462,1,1,2215,1315,-900
9463,0,0,6,0,-6
9464,1,1,277,1965,1688
9465,1,1,300,2075,1775
9466,0,0,12,0,-12
9467,0,0,26,0,-26
9468,1,0,63,0,-63
9469,0,0,19,0,-19
9470,1,0,44,0,-44
9471,0,0,2,0,-2
9472,0,0,35,0,-35
9473,1,1,304,1691,1387
9474,0,0,24,0,-24
9475,1,1,1419,1323,-96
9476,1,0,23,0,-23
9477,0,0,46,0,-46
9478,0,0,176,0,-176
9479,1,0,45,0,-45
9480,0,0,28,0,-28
9481,1,0,23,0,-23
9482,1,0,13,0,-13
9483,0,0,3,0,-3
9484,1,1,259,1349,1090
9485,0,0,21,0,-21
9486,0,0,18,0,-18
9487,0,0,28,0,-28
9488,0,0,41,0,-41
9489,1,1,364,1372,1008
9490,0,0,5,0,-5
9491,1,1,151,1370,1219
9492,0,0,124,0,-124
9493,1,0,7,0,-7
9494,0,0,34,0,-34
9495,0,0,94,0,-94
9496,0,0,34,0,-34
9497,1,0,275,0,-275
9498,0,0,34,0,-34
9499,0,0,16,0,-16
9500,0,0,25,0,-25
9501,1,1,156,1474,1318
9502,1,1,711,1786,1075
9503,1,1,526,3373,2847
9504,0,0,7,0,-7
9505,1,0,7,0,-7
9506,0,0,131,0,-131
9507,1,0,24,0,-24
9508,0,0,23,0,-23
9509,1,0,80,0,-80
9510,1,0,13,0,-13
9511,1,0,128,0,-128
9512,1,0,41,0,-41
9513,0,0,60,0,-60
9514,1,0,28,0,-28
9515,0,0,6,0,-6
9516,1,0,171,0,-171
9517,1,1,438,1361,923
9518,1,1,371,1270,899
9519,1,1,387,1485,1098
9520,1,0,71,0,-71
9521,1,1,656,1483,827
9522,1,1,216,1276,1060
9523,0,0,19,0,-19
9524,1,1,276,1905,1629
9525,1,0,43,0,-43
9526,0,0,28,0,-28
9527,1,1,256,1780,1524
9528,1,0,40,0,-40
9529,1,0,8,0,-8
9530,1,1,877,1314,437
9531,0,0,8,0,-8
9532,1,0,93,0,-93
9533,1,0,45,0,-45
9534,0,0,12,0,-12
9535,1,1,875,1337,462
9536,1,1,575,1319,744
9537,1,0,89,0,-89
9538,1,0,20,0,-20
9539,1,0,60,0,-60
9540,1,0,8,0,-8
9541,0,0,28,0,-28
9542,1,1,16,1674,1658
9543,1,1,97,1561,1464
9544,1,1,497,1430,933
9545,1,0,59,0,-59
9546,1,0,63,0,-63
9547,0,0,245,0,-245
9548,1,0,105,0,-105
9549,0,0,40,0,-40
9550,0,0,25,0,-25
9551,1,0,16,0,-16
9552,1,0,11,0,-11
9553,1,0,8,0,-8
9554,0,0,77,0,-77
9555,0,0,8,0,-8
9556,0,0,24,0,-24
9557,0,0,14,0,-14
9558,0,0,119,0,-119
9559,0,0,22,0,-22
9560,1,0,51,0,-51
9561,1,0,29,0,-29
9562,1,0,158,0,-158
9563,1,0,94,0,-94
9564,1,0,47,0,-47
9565,1,1,460,1777,1317
9566,1,1,818,1522,704
9567,1,0,48,0,-48
9568,0,0,73,0,-73
9569,1,1,189,1972,1783
9570,0,0,92,0,-92
9571,1,0,51,0,-51
9572,0,0,40,0,-40
9573,1,1,18,1376,1358
9574,0,0,34,0,-34
9575,1,1,245,1984,1739
9576,1,0,7,0,-7
9577,1,0,35,0,-35
9578,1,1,289,1235,946
9579,1,0,53,0,-53
9580,0,0,13,0,-13
9581,1,1,406,1972,1566
9582,0,0,162,0,-162
9583,0,0,248,0,-248
9584,1,1,720,1369,649
9585,1,0,36,0,-36
9586,0,0,6,0,-6
9587,1,0,11,0,-11
9588,1,1,762,1295,533
9589,0,0,11,0,-11
9590,0,0,6,0,-6
9591,1,1,80,1243,1163
9592,1,1,420,1258,838
9593,1,1,1081,1400,319
9594,1,1,740,1507,767
9595,0,0,20,0,-20
9596,1,1,174,1672,1498
9597,1,0,128,0,-128
9598,1,1,99,1496,1397
9599,1,0,68,0,-68
9600,1,1,220,1599,1379
9601,1,1,2027,1298,-729
9602,1,1,29,2372,2343
9603,1,0,215,0,-215
9604,0,0,108,0,-108
9605,0,0,76,0,-76
9606,0,0,15,0,-15
9607,0,0,35,0,-35
9608,0,0,7,0,-7
9609,0,0,61,0,-61
9610,0,0,69,0,-69
9611,1,0,23,0,-23
9612,0,0,125,0,-125
9613,1,1,845,1500,655
9614,1,1,821,2468,1647
9615,1,0,3,0,-3
9616,0,0,45,0,-45
9617,1,1,710,1265,555
9618,1,1,264,1752,1488
9619,1,0,34,0,-34
9620,1,1,332,1236,904
9621,0,0,25,0,-25
9622,1,1,788,1267,479
9623,0,0,67,0,-67
9624,0,0,173,0,-173
9625,1,1,300,1409,1109
9626,1,0,5,0,-5
9627,1,1,688,1469,781
9628,1,0,29,0,-29
9629,0,0,13,0,-13
9630,0,0,53,0,-53
9631,1,1,681,2194,1513
9632,1,0,15,0,-15
9633,0,0,16,0,-16
9634,1,0,19,0,-19
9635,1,1,598,1667,1069
9636,0,0,0,0,0
9637,0,0,44,0,-44
9638,0,0,12,0,-12
9639,1,1,2176,1308,-868
9640,0,0,39,0,-39
9641,1,1,9,1378,1369
9642,1,1,107,1576,1469
9643,1,0,13,0,-13
9644,1,0,1,0,-1
9645,1,0,25,0,-25
9646,1,0,22,0,-22
9647,0,0,44,0,-44
9648,1,1,456,1260,804
9649,0,0,59,0,-59
9650,1,0,53,0,-53
9651,1,0,90,0,-90
9652,0,0,70,0,-70
9653,1,1,274,1341,1067
9654,1,0,6,0,-6
9655,1,0,132,0,-132
9656,1,1,103,1821,1718
9657,1,0,33,0,-33
9658,1,1,1443,1369,-74
9659,0,0,34,0,-34
9660,0,0,20,0,-20
9661,0,0,97,0,-97
9662,1,0,29,0,-29
9663,0,0,11,0,-11
9664,1,1,444,1390,946
9665,0,0,20,0,-20
9666,1,0,105,0,-105
9667,0,0,29,0,-29
9668,0,0,32,0,-32
9669,1,0,46,0,-46
9670,1,1,900,2047,1147
9671,0,0,20,0,-20
9672,0,0,27,0,-27
9673,0,0,41,0,-41
9674,1,0,31,0,-31
9675,1,0,68,0,-68
9676,1,1,149,1469,1320
9677,0,0,3,0,-3
9678,0,0,24,0,-24
9679,1,0,33,0,-33
9680,0,0,28,0,-28
9681,1,0,2,0,-2
9682,0,0,4,0,-4
9683,0,0,27,0,-27
9684,1,0,22,0,-22
9685,0,0,64,0,-64
9686,1,1,18,1830,1812
9687,1,0,30,0,-30
9688,1,1,365,1682,1317
9689,1,1,381,1444,1063
9690,1,1,61,1515,1454
9691,1,1,500,1341,841
9692,1,1,992,1628,636
9693,0,0,9,0,-9
9694,0,0,9,0,-9
9695,0,0,67,0,-67
9696,1,0,50,0,-50
9697,0,0,11,0,-11
9698,1,1,167,1313,1146
9699,0,0,12,0,-12
9700,1,0,2,0,-2
9701,0,0,35,0,-35
9702,1,1,891,1308,417
9703,0,0,23,0,-23
9704,0,0,42,0,-42
9705,0,0,5,0,-5
9706,0,0,16,0,-16
9707,0,0,67,0,-67
9708,1,1,876,1423,547
9709,0,0,22,0,-22
9710,1,0,26,0,-26
9711,1,1,183,1474,1291
9712,1,0,96,0,-96
9713,0,0,20,0,-20
9714,0,0,1,0,-1
9715,1,0,125,0,-125
9716,1,1,556,1255,699
9717,1,0,158,0,-158
9718,0,0,48,0,-48
9719,1,1,1772,2152,380
9720,1,1,968,1652,684
9721,0,0,19,0,-19
9722,1,1,190,1772,1582
9723,0,0,143,0,-143
9724,0,0,32,0,-32
9725,0,0,87,0,-87
9726,0,0,32,0,-32
9727,0,0,45,0,-45
9728,0,0,113,0,-113
9729,0,0,59,0,-59
9730,0,0,90,0,-90
9731,0,0,160,0,-160
9732,0,0,83,0,-83
9733,0,0,37,0,-37
9734,0,0,30,0,-30
9735,1,0,48,0,-48
9736,1,0,164,0,-164
9737,1,1,3753,1267,-2486
9738,1,1,216,1436,1220
9739,0,0,23,0,-23
9740,0,0,115,0,-115
9741,0,0,30,0,-30
9742,1,0,53,0,-53
9743,0,0,33,0,-33
9744,0,0,4,0,-4
9745,0,0,37,0,-37
9746,1,1,503,1282,779
9747,1,0,51,0,-51
9748,0,0,62,0,-62
9749,1,1,175,1912,1737
9750,1,1,51,1374,1323
9751,1,0,13,0,-13
9752,0,0,25,0,-25
9753,1,0,14,0,-14
9754,1,1,1212,1354,142
9755,1,0,65,0,-65
9756,0,0,28,0,-28
9757,1,1,826,2140,1314
9758,1,1,235,1560,1325
9759,0,0,68,0,-68
9760,1,1,807,1645,838
9761,0,0,26,0,-26
9762,0,0,68,0,-68
9763,0,0,22,0,-22
9764,0,0,76,0,-76
9765,0,0,28,0,-28
9766,1,0,9,0,-9
9767,1,1,645,1392,747
9768,1,1,276,1298,1022
9769,0,0,23,0,-23
9770,0,0,31,0,-31
9771,1,0,29,0,-29
9772,0,0,103,0,-103
9773,1,1,661,1401,740
9774,0,0,30,0,-30
9775,0,0,68,0,-68
9776,0,0,10,0,-10
9777,1,0,5,0,-5
9778,1,0,34,0,-34
9779,0,0,67,0,-67
9780,0,0,51,0,-51
9781,1,0,13,0,-13
9782,0,0,40,0,-40
9783,0,0,9,0,-9
9784,0,0,24,0,-24
9785,1,0,60,0,-60
9786,1,1,669,1267,598
9787,0,0,1,0,-1
9788,0,0,36,0,-36
9789,0,0,73,0,-73
9790,0,0,113,0,-113
9791,1,0,0,0,0
9792,1,1,828,1459,631
9793,0,0,12,0,-12
9794,0,0,77,0,-77
9795,1,0,32,0,-32
9796,1,1,103,1473,1370
9797,1,0,20,0,-20
9798,1,1,548,2040,1492
9799,1,1,527,1849,1322
9800,0,0,8,0,-8
9801,0,0,225,0,-225
9802,1,0,9,0,-9
9803,0,0,23,0,-23
9804,0,0,30,0,-30
9805,1,0,0,0,0
9806,1,0,59,0,-59
9807,0,0,8,0,-8
9808,1,1,290,1281,991
9809,0,0,43,0,-43
9810,0,0,31,0,-31
9811,1,0,24,0,-24
9812,1,0,61,0,-61
9813,1,1,248,1942,1694
9814,0,0,58,0,-58
9815,1,1,1310,2046,736
9816,1,0,7,0,-7
9817,0,0,41,0,-41
9818,0,0,113,0,-113
9819,1,0,53,0,-53
9820,1,1,249,1536,1287
9821,1,0,13,0,-13
9822,0,0,14,0,-14
9823,1,1,439,1706,1267
9824,1,1,416,1441,1025
9825,1,1,157,1715,1558
9826,1,1,408,1707,1299
9827,0,0,185,0,-185
9828,1,1,320,1397,1077
9829,0,0,134,0,-134
9830,1,0,7,0,-7
9831,0,0,20,0,-20
9832,1,0,108,0,-108
9833,0,0,2,0,-2
9834,0,0,50,0,-50
9835,1,0,155,0,-155
9836,1,0,74,0,-74
9837,1,0,85,0,-85
9838,0,0,11,0,-11
9839,0,0,51,0,-51
9840,1,0,18,0,-18
9841,0,0,18,0,-18
9842,1,1,438,1540,1102
9843,1,0,23,0,-23
9844,0,0,31,0,-31
9845,1,0,25,0,-25
9846,0,0,3,0,-3
9847,1,1,771,2583,1812
9848,0,0,20,0,-20
9849,1,1,16,1435,1419
9850,1,1,786,1337,551
9851,1,1,135,1257,1122
9852,1,0,9,0,-9
9853,1,1,127,1470,1343
9854,0,0,58,0,-58
9855,0,0,55,0,-55
9856,0,0,15,0,-15
9857,1,1,1059,1606,547
9858,0,0,1,0,-1
9859,1,1,439,1644,1205
9860,0,0,169,0,-169
9861,0,0,35,0,-35
9862,0,0,17,0,-17
9863,1,1,309,1395,1086
9864,1,0,52,0,-52
9865,1,0,118,0,-118
9866,0,0,8,0,-8
9867,0,0,138,0,-138
9868,1,0,178,0,-178
9869,0,0,7,0,-7
9870,1,0,326,0,-326
9871,0,0,12,0,-12
9872,1,1,287,1244,957
9873,0,0,15,0,-15
9874,1,0,52,0,-52
9875,1,0,2,0,-2
9876,1,0,13,0,-13
9877,1,0,25,0,-25
9878,1,1,635,1239,604
9879,0,0,43,0,-43
9880,1,1,149,1341,1192
9881,1,0,108,0,-108
9882,0,0,11,0,-11
9883,0,0,84,0,-84
9884,1,1,240,1280,1040
9885,1,0,325,0,-325
9886,1,1,1259,1400,141
9887,1,1,215,2346,2131
9888,0,0,51,0,-51
9889,0,0,23,0,-23
9890,0,0,23,0,-23
9891,1,0,25,0,-25
9892,1,0,42,0,-42
9893,0,0,3,0,-3
9894,0,0,7,0,-7
9895,0,0,147,0,-147
9896,1,0,39,0,-39
9897,0,0,27,0,-27
9898,0,0,178,0,-178
9899,0,0,23,0,-23
9900,1,0,234,0,-234
9901,1,0,1,0,-1
9902,1,0,5,0,-5
9903,1,0,12,0,-12
9904,0,0,7,0,-7
9905,0,0,12,0,-12
9906,1,1,340,2528,2188
9907,1,0,5,0,-5
9908,0,0,44,0,-44
9909,1,0,27,0,-27
9910,1,1,760,1667,907
9911,1,1,470,1668,1198
9912,1,0,202,0,-202
9913,1,0,51,0,-51
9914,1,1,1513,1709,196
9915,0,0,6,0,-6
9916,1,0,1,0,-1
9917,1,1,152,1291,1139
9918,1,1,257,1378,1121
9919,1,0,8,0,-8
9920,1,1,357,1710,1353
9921,0,0,55,0,-55
9922,1,0,11,0,-11
9923,0,0,7,0,-7
9924,1,1,348,1337,989
9925,1,0,33,0,-33
9926,0,0,45,0,-45
9927,1,1,1147,1578,431
9928,0,0,30,0,-30
9929,1,1,73,2357,2284
9930,0,0,6,0,-6
9931,0,0,32,0,-32
9932,1,0,26,0,-26
9933,1,1,1289,4131,2842
9934,0,0,26,0,-26
9935,0,0,26,0,-26
9936,1,0,87,0,-87
9937,0,0,12,0,-12
9938,1,1,264,1265,1001
9939,0,0,74,0,-74
9940,0,0,107,0,-107
9941,1,0,144,0,-144
9942,1,1,770,2915,2145
9943,0,0,7,0,-7
9944,1,1,70,1407,1337
9945,1,0,71,0,-71
9946,1,0,34,0,-34
9947,1,1,735,1333,598
9948,1,0,32,0,-32
9949,0,0,165,0,-165
9950,0,0,83,0,-83
9951,1,0,43,0,-43
9952,0,0,63,0,-63
9953,1,1,276,3361,3085
9954,1,1,19,1367,1348
9955,1,1,194,1235,1041
9956,1,0,35,0,-35
9957,1,1,1942,1605,-337
9958,1,0,63,0,-63
9959,1,0,17,0,-17
9960,1,1,167,1405,1238
9961,1,0,10,0,-10
9962,1,1,347,1294,947
9963,1,0,30,0,-30
9964,0,0,67,0,-67
9965,1,1,545,1247,702
9966,1,0,53,0,-53
9967,0,0,1,0,-1
9968,0,0,26,0,-26
9969,1,0,18,0,-18
9970,1,0,157,0,-157
9971,0,0,29,0,-29
9972,1,0,18,0,-18
9973,0,0,38,0,-38
9974,0,0,146,0,-146
9975,1,0,16,0,-16
9976,0,0,21,0,-21
9977,0,0,45,0,-45
9978,1,0,95,0,-95
9979,1,1,212,1285,1073
9980,1,0,2,0,-2
9981,1,0,70,0,-70
9982,0,0,115,0,-115
9983,1,0,15,0,-15
9984,1,1,376,1976,1600
9985,0,0,12,0,-12
9986,1,1,62,1252,1190
9987,1,1,69,2308,2239
9988,1,1,77,1280,1203
9989,1,0,21,0,-21
9990,0,0,20,0,-20
9991,1,0,44,0,-44
9992,0,0,75,0,-75
9993,0,0,25,0,-25
9994,1,0,26,0,-26
9995,0,0,6,0,-6
9996,0,0,89,0,-89
9997,0,0,6,0,-6
9998,0,0,18,0,-18
9999,1,1,401,1693,1292
10000,1,0,17,0,-17
10001,0,0,5,0,-5
10002,1,0,33,0,-33
10003,1,1,700,1384,684
10004,0,0,22,0,-22
10005,0,0,205,0,-205
10006,1,1,996,3732,2736
10007,0,0,36,0,-36
10008,0,0,7,0,-7
10009,0,0,6,0,-6
10010,0,0,1,0,-1
10011,1,1,41,1540,1499
10012,1,1,638,1237,599
10013,0,0,58,0,-58
10014,1,1,351,1518,1167
10015,1,0,6,0,-6
10016,0,0,43,0,-43
10017,1,0,67,0,-67
10018,1,1,47,1633,1586
10019,1,1,581,1260,679
10020,0,0,130,0,-130
10021,1,0,48,0,-48
10022,1,1,65,1488,1423
10023,1,1,1020,1316,296
10024,1,0,23,0,-23
10025,1,1,339,1549,1210
10026,1,1,1056,1301,245
10027,1,1,1478,1236,-242
10028,1,0,19,0,-19
10029,0,0,152,0,-152
10030,0,0,1,0,-1
10031,0,0,45,0,-45
10032,0,0,1,0,-1
10033,1,1,404,1407,1003
10034,1,0,18,0,-18
10035,1,1,1017,1451,434
10036,1,0,1,0,-1
10037,1,1,191,2089,1898
10038,0,0,14,0,-14
10039,1,1,1208,1350,142
10040,1,0,37,0,-37
10041,1,0,102,0,-102
10042,1,1,89,1462,1373
10043,1,0,73,0,-73
10044,1,1,1635,1237,-398
10045,0,0,46,0,-46
10046,0,0,20,0,-20
10047,0,0,31,0,-31
10048,0,0,84,0,-84
10049,1,1,150,1290,1140
10050,0,0,28,0,-28
10051,1,0,24,0,-24
10052,0,0,42,0,-42
10053,1,0,17,0,-17
10054,1,0,37,0,-37
10055,0,0,194,0,-194
10056,1,0,94,0,-94
10057,1,0,20,0,-20
10058,1,0,19,0,-19
10059,1,0,31,0,-31
10060,0,0,34,0,-34
10061,0,0,279,0,-279
10062,0,0,24,0,-24
10063,1,1,1390,1770,380
10064,0,0,21,0,-21
10065,1,1,929,1304,375
10066,0,0,5,0,-5
10067,1,1,971,2039,1068
10068,1,0,76,0,-76
10069,1,1,841,1355,514
10070,1,0,23,0,-23
10071,0,0,34,0,-34
10072,1,0,2,0,-2
10073,1,1,2034,1518,-516
10074,1,1,498,1296,798
10075,1,0,54,0,-54
10076,0,0,48,0,-48
10077,1,1,578,1267,689
10078,1,0,25,0,-25
10079,1,0,35,0,-35
10080,1,0,5,0,-5
10081,1,1,62,1300,1238
10082,1,0,50,0,-50
10083,0,0,48,0,-48
10084,0,0,24,0,-24
10085,0,0,11,0,-11
10086,1,0,17,0,-17
10087,0,0,40,0,-40
10088,0,0,27,0,-27
10089,0,0,105,0,-105
10090,1,1,159,1312,1153
10091,1,1,189,1806,1617
10092,0,0,69,0,-69
10093,1,0,21,0,-21
10094,1,1,1125,1603,478
10095,1,0,23,0,-23
10096,0,0,29,0,-29
10097,1,1,197,1557,1360
10098,0,0,51,0,-51
10099,1,1,587,1251,664
10100,1,0,3,0,-3
10101,1,1,958,1459,501
10102,0,0,50,0,-50
10103,1,0,10,0,-10
10104,1,0,145,0,-145
10105,0,0,69,0,-69
10106,1,1,823,1590,767
10107,1,0,4,0,-4
10108,1,1,538,1522,984
10109,1,0,30,0,-30
10110,0,0,66,0,-66
10111,1,0,33,0,-33
10112,1,1,252,1921,1669
10113,1,1,355,1330,975
10114,1,0,75,0,-75
10115,1,1,599,1429,830
10116,1,0,8,0,-8
10117,1,1,640,2563,1923
10118,1,1,132,1327,1195
10119,0,0,29,0,-29
10120,1,1,449,1394,945
10121,1,0,117,0,-117
10122,1,0,35,0,-35
10123,0,0,61,0,-61
10124,1,0,114,0,-114
10125,0,0,0,0,0
10126,0,0,9,0,-9
10127,0,0,32,0,-32
10128,1,1,739,1257,518
10129,1,1,65,1280,1215
10130,0,0,45,0,-45
10131,0,0,174,0,-174
10132,0,0,3,0,-3
10133,1,1,444,1321,877
10134,1,0,10,0,-10
10135,0,0,66,0,-66
10136,0,0,4,0,-4
10137,0,0,14,0,-14
10138,0,0,26,0,-26
10139,1,0,3,0,-3
10140,0,0,1,0,-1
10141,1,1,1335,2693,1358
10142,1,1,1534,1592,58
10143,1,0,87,0,-87
10144,1,0,126,0,-126
10145,0,0,16,0,-16
10146,0,0,123,0,-123
10147,1,1,1171,1354,183
10148,0,0,0,0,0
10149,1,1,625,1377,752
10150,0,0,53,0,-53
10151,1,0,50,0,-50
10152,1,1,303,1522,1219
10153,0,0,44,0,-44
10154,0,0,37,0,-37
10155,1,1,209,1442,1233
10156,1,1,1216,1252,36
10157,1,1,248,1587,1339
10158,1,0,9,0,-9
10159,0,0,78,0,-78
10160,1,0,12,0,-12
10161,0,0,60,0,-60
10162,0,0,34,0,-34
10163,1,0,60,0,-60
10164,0,0,36,0,-36
10165,1,1,173,2456,2283
10166,1,0,45,0,-45
10167,1,1,1377,1902,525
10168,0,0,36,0,-36
10169,0,0,32,0,-32
10170,1,1,216,1355,1139
10171,1,1,160,1365,1205
10172,1,0,25,0,-25
10173,1,0,157,0,-157
10174,1,0,12,0,-12
10175,0,0,38,0,-38
10176,0,0,11,0,-11
10177,1,0,12,0,-12
10178,0,0,50,0,-50
10179,0,0,3,0,-3
10180,1,1,297,2254,1957
10181,1,0,33,0,-33
10182,0,0,116,0,-116
10183,0,0,19,0,-19
10184,0,0,29,0,-29
10185,0,0,33,0,-33
10186,0,0,102,0,-102
10187,1,1,369,1451,1082
10188,1,1,330,1434,1104
10189,0,0,105,0,-105
10190,0,0,187,0,-187
10191,1,1,490,1267,777
10192,0,0,51,0,-51
10193,0,0,9,0,-9
10194,0,0,21,0,-21
10195,0,0,78,0,-78
10196,1,0,37,0,-37
10197,0,0,51,0,-51
10198,1,1,546,1295,749
10199,1,0,30,0,-30
10200,1,0,3,0,-3
10201,0,0,278,0,-278
10202,0,0,1,0,-1
10203,1,0,31,0,-31
10204,0,0,20,0,-20
10205,0,0,42,0,-42
10206,1,0,11,0,-11
10207,1,1,452,2098,1646
10208,1,0,71,0,-71
10209,0,0,36,0,-36
10210,0,0,64,0,-64
10211,1,0,48,0,-48
10212,0,0,9,0,-9
10213,1,0,132,0,-132
10214,1,0,4,0,-4
10215,0,0,51,0,-51
10216,1,1,312,1310,998
10217,1,1,679,2385,1706
10218,1,0,29,0,-29
10219,1,1,115,1336,1221
10220,1,1,1658,1288,-370
10221,0,0,17,0,-17
10222,1,1,436,2610,2174
10223,1,0,4,0,-4
10224,0,0,20,0,-20
10225,0,0,3,0,-3
10226,1,1,1571,1450,-121
10227,0,0,56,0,-56
10228,1,0,221,0,-221
10229,1,1,62,1322,1260
10230,0,0,19,0,-19
10231,1,0,63,0,-63
10232,1,0,9,0,-9
10233,1,0,67,0,-67
10234,1,0,10,0,-10
10235,1,1,1396,1348,-48
10236,1,1,388,1469,1081
10237,0,0,160,0,-160
10238,0,0,153,0,-153
10239,0,0,77,0,-77
10240,0,0,30,0,-30
10241,0,0,155,0,-155
10242,0,0,14,0,-14
10243,1,0,138,0,-138
10244,1,1,1044,1632,588
10245,0,0,81,0,-81
10246,0,0,61,0,-61
10247,1,1,194,1595,1401
10248,1,1,412,1687,1275
10249,0,0,11,0,-11
10250,1,0,20,0,-20
10251,0,0,10,0,-10
10252,1,1,401,1412,1011
10253,1,1,1004,1963,959
10254,0,0,199,0,-199
10255,1,0,19,0,-19
10256,1,0,12,0,-12
10257,1,0,187,0,-187
10258,1,0,9,0,-9
10259,0,0,62,0,-62
10260,0,0,10,0,-10
10261,0,0,23,0,-23
10262,0,0,56,0,-56
10263,0,0,1,0,-1
10264,0,0,7,0,-7
10265,1,1,311,1341,1030
10266,0,0,23,0,-23
10267,1,1,405,1987,1582
10268,0,0,60,0,-60
10269,0,0,6,0,-6
10270,0,0,166,0,-166
10271,0,0,83,0,-83
10272,0,0,88,0,-88
10273,1,1,492,1936,1444
10274,1,1,278,1286,1008
10275,1,1,226,2239,2013
10276,1,0,17,0,-17
10277,1,1,200,1289,1089
10278,1,1,878,3575,2697
10279,0,0,7,0,-7
10280,1,1,325,1300,975
10281,0,0,18,0,-18
10282,1,0,17,0,-17
10283,1,0,9,0,-9
10284,1,1,587,1310,723
10285,1,1,111,1415,1304
10286,1,1,466,1816,1350
10287,1,1,240,1276,1036
10288,0,0,5,0,-5
10289,1,1,744,1249,505
10290,0,0,16,0,-16
10291,1,0,75,0,-75
10292,0,0,2,0,-2
10293,1,1,744,1386,642
10294,0,0,4,0,-4
10295,1,0,46,0,-46
10296,0,0,34,0,-34
10297,0,0,20,0,-20
10298,0,0,21,0,-21
10299,0,0,15,0,-15
10300,1,1,1391,1381,-10
10301,1,1,297,1248,951
10302,1,1,530,1339,809
10303,1,0,9,0,-9
10304,0,0,42,0,-42
10305,0,0,39,0,-39
10306,1,0,68,0,-68
10307,0,0,62,0,-62
10308,0,0,23,0,-23
10309,1,1,108,1904,1796
10310,1,1,141,1332,1191
10311,0,0,14,0,-14
10312,1,0,62,0,-62
10313,1,0,5,0,-5
10314,0,0,11,0,-11
10315,1,0,59,0,-59
10316,1,1,298,1305,1007
10317,0,0,34,0,-34
10318,1,1,1349,1331,-18
10319,1,1,131,1427,1296
10320,1,1,254,1523,1269
10321,1,1,222,1401,1179
10322,0,0,32,0,-32
10323,0,0,32,0,-32
10324,1,1,520,2528,2008
10325,1,0,163,0,-163
10326,0,0,23,0,-23
10327,0,0,7,0,-7
10328,1,0,118,0,-118
10329,0,0,23,0,-23
10330,0,0,48,0,-48
10331,0,0,70,0,-70
10332,0,0,3,0,-3
10333,1,1,1095,2353,1258
10334,0,0,18,0,-18
10335,0,0,8,0,-8
10336,0,0,28,0,-28
10337,0,0,39,0,-39
10338,1,1,51,1620,1569
10339,1,0,133,0,-133
10340,1,0,74,0,-74
10341,0,0,30,0,-30
10342,0,0,1,0,-1
10343,1,0,17,0,-17
10344,0,0,13,0,-13
10345,1,1,72,1585,1513
10346,0,0,3,0,-3
10347,1,0,35,0,-35
10348,0,0,19,0,-19
10349,1,0,40,0,-40
10350,0,0,76,0,-76
10351,1,1,352,1434,1082
10352,1,0,11,0,-11
10353,0,0,49,0,-49
10354,1,0,10,0,-10
10355,0,0,162,0,-162
10356,1,1,508,1341,833
10357,1,1,470,1648,1178
10358,1,0,12,0,-12
10359,1,1,727,1275,548
10360,1,1,2765,1704,-1061
10361,0,0,16,0,-16
10362,0,0,13,0,-13
10363,0,0,22,0,-22
10364,1,1,410,6039,5629
10365,0,0,92,0,-92
10366,0,0,6,0,-6
10367,1,1,159,1257,1098
10368,0,0,94,0,-94
10369,1,1,531,1361,830
10370,0,0,85,0,-85
10371,0,0,136,0,-136
10372,1,1,97,1808,1711
10373,1,0,2,0,-2
10374,1,1,834,1384,550
10375,1,1,65,1948,1883
10376,0,0,16,0,-16
10377,1,0,9,0,-9
10378,0,0,106,0,-106
10379,0,0,20,0,-20
10380,0,0,60,0,-60
10381,1,1,404,1300,896
10382,1,0,53,0,-53
10383,0,0,34,0,-34
10384,0,0,15,0,-15
10385,0,0,11,0,-11
10386,0,0,113,0,-113
10387,0,0,261,0,-261
10388,0,0,48,0,-48
10389,1,1,1088,1252,164
10390,0,0,80,0,-80
10391,1,0,127,0,-127
10392,0,0,73,0,-73
10393,0,0,91,0,-91
10394,1,1,147,1419,1272
10395,1,0,35,0,-35
10396,1,0,30,0,-30
10397,1,0,12,0,-12
10398,1,1,125,2048,1923
10399,1,0,16,0,-16
10400,1,0,10,0,-10
10401,0,0,47,0,-47
10402,1,1,332,1505,1173
10403,1,0,36,0,-36
10404,0,0,113,0,-113
10405,0,0,2,0,-2
10406,1,0,60,0,-60
10407,0,0,24,0,-24
10408,0,0,123,0,-123
10409,1,1,1118,1488,370
10410,1,0,43,0,-43
10411,0,0,46,0,-46
10412,0,0,56,0,-56
10413,1,0,139,0,-139
10414,1,1,286,2568,2282
10415,0,0,11,0,-11
10416,1,0,81,0,-81
10417,1,1,716,1274,558
10418,1,1,720,1256,536
10419,1,1,252,1789,1537
10420,1,0,10,0,-10
10421,1,1,150,1281,1131
10422,1,0,54,0,-54
10423,1,0,4,0,-4
10424,1,1,271,2078,1807
10425,1,1,158,1599,1441
10426,1,1,125,1474,1349
10427,0,0,21,0,-21
10428,0,0,11,0,-11
10429,1,0,128,0,-128
10430,1,0,122,0,-122
10431,0,0,75,0,-75
10432,1,1,104,1610,1506
10433,1,1,211,1277,1066
10434,0,0,90,0,-90
10435,0,0,94,0,-94
10436,0,0,20,0,-20
10437,1,1,1377,1314,-63
10438,1,0,240,0,-240
10439,0,0,54,0,-54
10440,1,0,16,0,-16
10441,1,1,301,3462,3161
10442,1,0,0,0,0
10443,0,0,89,0,-89
10444,1,1,209,1647,1438
10445,0,0,65,0,-65
10446,0,0,3,0,-3
10447,0,0,16,0,-16
10448,1,0,46,0,-46
10449,0,0,90,0,-90
10450,1,0,35,0,-35
10451,1,0,18,0,-18
10452,0,0,29,0,-29
10453,1,0,21,0,-21
10454,1,1,315,1319,1004
10455,1,1,53,1601,1548
10456,1,1,50,2316,2266
10457,1,1,604,1324,720
10458,1,1,235,1249,1014
10459,0,0,20,0,-20
10460,0,0,13,0,-13
10461,1,1,727,1330,603
10462,0,0,86,0,-86
10463,1,0,46,0,-46
10464,0,0,4,0,-4
10465,0,0,43,0,-43
10466,1,1,114,1297,1183
10467,1,1,202,1341,1139
10468,1,0,27,0,-27
10469,0,0,113,0,-113
10470,0,0,4,0,-4
10471,1,1,90,1238,1148
10472,1,0,46,0,-46
10473,1,0,27,0,-27
10474,0,0,41,0,-41
10475,1,1,1127,1383,256
10476,1,0,25,0,-25
10477,1,1,1089,1243,154
10478,0,0,29,0,-29
10479,1,1,198,1253,1055
10480,1,1,92,1478,1386
10481,0,0,79,0,-79
10482,1,0,78,0,-78
10483,1,0,1,0,-1
10484,1,1,440,2504,2064
10485,1,1,256,2662,2406
10486,1,0,4,0,-4
10487,0,0,7,0,-7
10488,1,0,51,0,-51
10489,0,0,22,0,-22
10490,1,0,36,0,-36
10491,0,0,78,0,-78
10492,0,0,7,0,-7
10493,1,0,2,0,-2
10494,1,1,73,1482,1409
10495,0,0,128,0,-128
10496,1,1,136,1651,1515
10497,1,1,396,2025,1629
10498,0,0,75,0,-75
10499,0,0,205,0,-205
10500,1,0,58,0,-58
10501,1,1,20,1637,1617
10502,0,0,85,0,-85
10503,0,0,48,0,-48
10504,0,0,79,0,-79
10505,1,0,72,0,-72
10506,0,0,69,0,-69
10507,0,0,21,0,-21
10508,0,0,10,0,-10
10509,0,0,71,0,-71
10510,1,0,17,0,-17
10511,1,0,88,0,-88
10512,0,0,19,0,-19
10513,1,0,149,0,-149
10514,0,0,36,0,-36
10515,1,0,10,0,-10
10516,1,1,591,1410,819
10517,1,0,223,0,-223
10518,1,1,114,2376,2262
10519,0,0,14,0,-14
10520,1,1,373,1295,922
10521,0,0,72,0,-72
10522,0,0,94,0,-94
10523,1,1,153,1286,1133
10524,1,0,113,0,-113
10525,0,0,6,0,-6
10526,1,0,31,0,-31
10527,1,0,100,0,-100
10528,0,0,4,0,-4
10529,1,0,14,0,-14
10530,1,0,29,0,-29
10531,0,0,0,0,0
10532,0,0,27,0,-27
10533,1,0,26,0,-26
10534,1,0,8,0,-8
10535,1,1,688,1347,659
10536,1,1,157,2174,2017
10537,1,1,487,1264,777
10538,1,1,379,1312,933
10539,1,0,4,0,-4
10540,1,1,163,1476,1313
10541,0,0,119,0,-119
10542,1,1,260,1877,1617
10543,0,0,46,0,-46
10544,0,0,2,0,-2
10545,1,0,2,0,-2
10546,1,1,522,2641,2119
10547,0,0,86,0,-86
10548,1,0,27,0,-27
10549,1,0,2,0,-2
10550,0,0,22,0,-22
10551,1,1,373,1269,896
10552,0,0,36,0,-36
10553,0,0,20,0,-20
10554,1,0,23,0,-23
10555,1,1,1062,1299,237
10556,0,0,154,0,-154
10557,1,0,33,0,-33
10558,1,1,356,1493,1137
10559,0,0,26,0,-26
10560,1,0,34,0,-34
10561,1,1,217,1299,1082
10562,0,0,9,0,-9
10563,1,1,371,1374,1003
10564,0,0,12,0,-12
10565,1,0,12,0,-12
10566,0,0,19,0,-19
10567,0,0,125,0,-125
10568,1,1,40,1278,1238
10569,1,1,167,1520,1353
10570,1,0,30,0,-30
10571,1,0,79,0,-79
10572,1,0,44,0,-44
10573,0,0,135,0,-135
10574,1,0,70,0,-70
10575,0,0,10,0,-10
10576,1,0,14,0,-14
10577,0,0,67,0,-67
10578,0,0,40,0,-40
10579,1,0,33,0,-33
10580,1,1,181,1272,1091
10581,0,0,2,0,-2
10582,1,1,57,1346,1289
10583,0,0,162,0,-162
10584,0,0,19,0,-19
10585,1,1,1170,1651,481
10586,0,0,6,0,-6
10587,1,1,717,1279,562
10588,1,1,717,1779,1062
10589,1,0,59,0,-59
10590,0,0,40,0,-40
10591,0,0,21,0,-21
10592,0,0,90,0,-90
10593,1,0,11,0,-11
10594,1,1,210,1687,1477
10595,1,0,33,0,-33
10596,0,0,23,0,-23
10597,0,0,3,0,-3
10598,1,1,321,1341,1020
10599,1,1,411,2167,1756
10600,0,0,21,0,-21
10601,0,0,26,0,-26
10602,0,0,26,0,-26
10603,0,0,56,0,-56
10604,0,0,76,0,-76
10605,1,1,412,1421,1009
10606,0,0,67,0,-67
10607,1,1,56,1355,1299
10608,0,0,55,0,-55
10609,0,0,26,0,-26
10610,0,0,33,0,-33
10611,0,0,18,0,-18
10612,1,1,575,1582,1007
10613,1,1,572,1460,888
10614,1,1,512,1256,744
10615,0,0,3,0,-3
10616,1,1,1070,1513,443
10617,1,0,2,0,-2
10618,1,0,18,0,-18
10619,1,1,864,1366,502
10620,0,0,39,0,-39
10621,1,1,230,1442,1212
10622,1,1,383,1262,879
10623,0,0,0,0,0
10624,0,0,134,0,-134
10625,1,0,54,0,-54
10626,1,1,1727,1742,15
10627,0,0,62,0,-62
10628,1,1,98,1279,1181
10629,0,0,112,0,-112
10630,1,0,7,0,-7
10631,0,0,39,0,-39
10632,0,0,31,0,-31
10633,0,0,98,0,-98
10634,1,1,134,2001,1867
10635,1,1,329,1241,912
10636,1,1,170,1389,1219
10637,0,0,60,0,-60
10638,0,0,81,0,-81
10639,1,0,133,0,-133
10640,1,0,207,0,-207
10641,1,0,37,0,-37
10642,0,0,111,0,-111
10643,1,1,933,1322,389
10644,0,0,8,0,-8
10645,1,1,58,1780,1722
10646,1,0,56,0,-56
10647,1,1,238,1905,1667
10648,1,1,197,1351,1154
10649,1,1,249,3558,3309
10650,0,0,56,0,-56
10651,1,0,81,0,-81
10652,0,0,55,0,-55
10653,0,0,40,0,-40
10654,1,0,74,0,-74
10655,0,0,9,0,-9
10656,0,0,17,0,-17
10657,0,0,216,0,-216
10658,1,1,397,2703,2306
10659,0,0,19,0,-19
10660,1,0,90,0,-90
10661,1,0,12,0,-12
10662,1,1,417,1587,1170
10663,1,1,532,1997,1465
10664,1,0,9,0,-9
10665,0,0,69,0,-69
10666,0,0,81,0,-81
10667,0,0,5,0,-5
10668,1,0,35,0,-35
10669,1,1,582,1398,816
10670,0,0,23,0,-23
10671,1,0,7,0,-7
10672,0,0,116,0,-116
10673,1,0,68,0,-68
10674,0,0,63,0,-63
10675,1,0,8,0,-8
10676,1,0,26,0,-26
10677,1,0,3,0,-3
10678,1,1,68,1327,1259
10679,0,0,22,0,-22
10680,0,0,38,0,-38
10681,0,0,14,0,-14
10682,1,0,6,0,-6
10683,1,0,69,0,-69
10684,0,0,39,0,-39
10685,1,1,72,1266,1194
10686,1,0,8,0,-8
10687,0,0,6,0,-6
10688,1,0,50,0,-50
10689,0,0,1,0,-1
10690,1,1,54,1327,1273
10691,0,0,79,0,-79
10692,0,0,37,0,-37
10693,1,1,1723,3547,1824
10694,1,1,182,1372,1190
10695,1,0,173,0,-173
10696,1,0,21,0,-21
10697,1,0,20,0,-20
10698,0,0,22,0,-22
10699,1,0,330,0,-330
10700,0,0,0,0,0
10701,1,0,28,0,-28
10702,0,0,8,0,-8
10703,1,1,586,1466,880
10704,1,1,195,1261,1066
10705,0,0,106,0,-106
10706,1,1,305,1928,1623
10707,1,1,1082,1288,206
10708,1,1,431,1254,823
10709,1,1,370,1523,1153
10710,0,0,6,0,-6
10711,1,0,25,0,-25
10712,0,0,47,0,-47
10713,1,0,15,0,-15
10714,0,0,40,0,-40
10715,1,1,201,1981,1780
10716,0,0,33,0,-33
10717,0,0,178,0,-178
10718,1,0,117,0,-117
10719,0,0,12,0,-12
10720,1,1,187,1355,1168
10721,0,0,256,0,-256
10722,0,0,4,0,-4
10723,1,0,2,0,-2
10724,0,0,48,0,-48
10725,0,0,9,0,-9
10726,0,0,23,0,-23
10727,1,0,20,0,-20
10728,1,0,14,0,-14
10729,1,0,38,0,-38
10730,0,0,13,0,-13
10731,1,0,3,0,-3
10732,0,0,237,0,-237
10733,0,0,52,0,-52
10734,1,0,16,0,-16
10735,0,0,18,0,-18
10736,1,0,75,0,-75
10737,1,1,722,1664,942
10738,0,0,63,0,-63
10739,0,0,47,0,-47
10740,1,0,140,0,-140
10741,1,0,38,0,-38
10742,1,1,89,1636,1547
10743,1,0,33,0,-33
10744,0,0,26,0,-26
10745,1,1,193,2339,2146
10746,0,0,132,0,-132
10747,1,1,172,2005,1833
10748,0,0,3,0,-3
10749,0,0,10,0,-10
10750,1,0,130,0,-130
10751,1,1,479,1654,1175
10752,1,1,207,1659,1452
10753,1,0,31,0,-31
10754,1,0,106,0,-106
10755,1,0,1,0,-1
10756,1,1,518,1296,778
10757,0,0,4,0,-4
10758,1,1,1814,1394,-420
10759,1,1,714,1380,666
10760,0,0,9,0,-9
10761,1,0,38,0,-38
10762,0,0,28,0,-28
10763,0,0,10,0,-10
10764,1,0,117,0,-117
10765,1,0,22,0,-22
10766,0,0,50,0,-50
10767,0,0,27,0,-27
10768,1,1,123,1634,1511
10769,0,0,61,0,-61
10770,1,1,308,1565,1257
10771,0,0,19,0,-19
10772,0,0,11,0,-11
10773,1,0,161,0,-161
10774,0,0,5,0,-5
10775,1,1,369,1257,888
10776,1,1,80,7720,7640
10777,1,0,94,0,-94
10778,0,0,1,0,-1
10779,0,0,66,0,-66
10780,0,0,10,0,-10
10781,0,0,58,0,-58
10782,0,0,14,0,-14
10783,1,1,503,1512,1009
10784,0,0,70,0,-70
10785,1,1,400,1523,1123
10786,1,1,1167,1257,90
10787,0,0,8,0,-8
10788,1,0,20,0,-20
10789,0,0,11,0,-11
10790,1,1,413,1502,1089
10791,0,0,15,0,-15
10792,0,0,200,0,-200
10793,1,0,44,0,-44
10794,1,1,1046,1615,569
10795,1,0,50,0,-50
10796,1,0,89,0,-89
10797,1,0,20,0,-20
10798,0,0,64,0,-64
10799,1,0,162,0,-162
10800,1,1,91,1753,1662
10801,0,0,58,0,-58
10802,0,0,68,0,-68
10803,0,0,1,0,-1
10804,1,1,937,1625,688
10805,1,0,46,0,-46
10806,1,1,230,1449,1219
10807,0,0,16,0,-16
10808,1,0,55,0,-55
10809,1,1,221,1318,1097
10810,1,0,43,0,-43
10811,0,0,66,0,-66
10812,0,0,51,0,-51
10813,1,1,225,1352,1127
10814,0,0,0,0,0
10815,1,0,24,0,-24
10816,1,0,14,0,-14
10817,1,1,521,3832,3311
10818,1,1,902,1259,357
10819,0,0,61,0,-61
10820,1,0,5,0,-5
10821,1,1,724,1952,1228
10822,1,0,37,0,-37
10823,1,1,236,2057,1821
10824,1,1,382,1990,1608
10825,1,1,332,1786,1454
10826,1,1,816,2217,1401
10827,1,0,136,0,-136
10828,1,0,25,0,-25
10829,1,0,8,0,-8
10830,1,0,60,0,-60
10831,0,0,123,0,-123
10832,0,0,48,0,-48
10833,0,0,17,0,-17
10834,1,0,19,0,-19
10835,0,0,293,0,-293
10836,0,0,21,0,-21
10837,0,0,49,0,-49
10838,1,1,560,1504,944
10839,1,0,62,0,-62
10840,0,0,2,0,-2
10841,0,0,105,0,-105
10842,1,0,114,0,-114
10843,0,0,10,0,-10
10844,1,0,11,0,-11
10845,0,0,0,0,0
10846,0,0,96,0,-96
10847,1,0,84,0,-84
10848,0,0,0,0,0
10849,1,0,56,0,-56
10850,0,0,6,0,-6
10851,1,0,0,0,0
10852,1,1,364,1844,1480
10853,1,0,2,0,-2
10854,0,0,316,0,-316
10855,1,1,19,1478,1459
10856,1,1,1859,1240,-619
10857,1,0,134,0,-134
10858,1,0,30,0,-30
10859,1,1,1210,1352,142
10860,1,1,478,1315,837
10861,1,1,756,1283,527
10862,0,0,52,0,-52
10863,0,0,124,0,-124
10864,0,0,43,0,-43
10865,1,0,5,0,-5
10866,0,0,0,0,0
10867,0,0,4,0,-4
10868,1,0,15,0,-15
10869,0,0,78,0,-78
10870,1,1,70,1770,1700
10871,1,0,48,0,-48
10872,0,0,2,0,-2
10873,1,1,405,1358,953
10874,1,0,233,0,-233
10875,1,1,598,1359,761
10876,0,0,24,0,-24
10877,0,0,8,0,-8
10878,0,0,11,0,-11
10879,1,1,429,1573,1144
10880,1,1,592,1308,716
10881,1,1,430,1270,840
10882,1,1,407,1390,983
10883,1,1,1048,1283,235
10884,0,0,6,0,-6
10885,0,0,64,0,-64
10886,0,0,88,0,-88
10887,0,0,89,0,-89
10888,1,0,1,0,-1
10889,0,0,6,0,-6
10890,1,0,22,0,-22
10891,1,1,1967,1310,-657
10892,0,0,13,0,-13
10893,1,1,1244,1486,242
10894,1,0,208,0,-208
10895,0,0,87,0,-87
10896,0,0,40,0,-40
10897,1,0,54,0,-54
10898,0,0,9,0,-9
10899,0,0,67,0,-67
10900,1,1,691,1267,576
10901,0,0,73,0,-73
10902,0,0,2,0,-2
10903,1,1,114,1718,1604
10904,1,1,350,1605,1255
10905,1,0,10,0,-10
10906,1,1,350,1238,888
10907,0,0,28,0,-28
10908,1,0,5,0,-5
10909,0,0,71,0,-71
10910,0,0,93,0,-93
10911,1,0,104,0,-104
10912,1,0,28,0,-28
10913,1,1,342,1754,1412
10914,0,0,14,0,-14
10915,1,0,103,0,-103
10916,0,0,0,0,0
10917,1,0,36,0,-36
10918,1,1,469,1621,1152
10919,1,1,1025,1384,359
10920,1,1,671,1259,588
10921,1,1,1219,1390,171
10922,0,0,46,0,-46
10923,1,0,23,0,-23
10924,1,0,26,0,-26
10925,1,0,140,0,-140
10926,1,0,98,0,-98
10927,1,0,232,0,-232
10928,1,1,263,1422,1159
10929,1,1,321,1429,1108
10930,1,1,279,1538,1259
10931,1,1,395,1545,1150
10932,1,1,116,1882,1766
10933,0,0,43,0,-43
10934,1,1,468,1325,857
10935,0,0,196,0,-196
10936,1,0,95,0,-95
10937,0,0,37,0,-37
10938,0,0,10,0,-10
10939,1,0,134,0,-134
10940,1,1,86,1296,1210
10941,1,0,130,0,-130
10942,0,0,42,0,-42
10943,1,1,129,1804,1675
10944,1,1,912,1431,519
10945,1,1,1177,1255,78
10946,1,0,94,0,-94
10947,1,0,45,0,-45
10948,1,0,32,0,-32
10949,1,0,31,0,-31
10950,0,0,81,0,-81
10951,1,0,113,0,-113
10952,1,0,16,0,-16
10953,1,0,90,0,-90
10954,1,1,506,1868,1362
10955,0,0,30,0,-30
10956,1,1,1980,1522,-458
10957,0,0,49,0,-49
10958,0,0,59,0,-59
10959,0,0,129,0,-129
10960,0,0,31,0,-31
10961,0,0,24,0,-24
10962,0,0,195,0,-195
10963,0,0,45,0,-45
10964,0,0,308,0,-308
10965,1,0,68,0,-68
10966,0,0,24,0,-24
10967,1,1,166,1402,1236
10968,1,0,218,0,-218
10969,1,1,163,2571,2408
10970,1,0,21,0,-21
10971,1,0,177,0,-177
10972,1,0,18,0,-18
10973,0,0,178,0,-178
10974,0,0,12,0,-12
10975,1,0,25,0,-25
10976,1,0,0,0,0
10977,1,0,9,0,-9
10978,1,0,2,0,-2
10979,0,0,5,0,-5
10980,1,1,346,1309,963
10981,1,0,54,0,-54
10982,0,0,25,0,-25
10983,0,0,98,0,-98
10984,0,0,2,0,-2
10985,1,0,38,0,-38
10986,1,1,1121,1579,458
10987,0,0,61,0,-61
10988,0,0,68,0,-68
10989,0,0,29,0,-29
10990,1,1,542,1272,730
10991,1,0,7,0,-7
10992,0,0,30,0,-30
10993,1,1,870,1467,597
10994,1,0,132,0,-132
10995,1,0,59,0,-59
10996,1,1,467,1595,1128
10997,1,1,105,2092,1987
10998,0,0,89,0,-89
10999,1,0,61,0,-61
11000,1,0,20,0,-20
11001,0,0,17,0,-17
11002,0,0,67,0,-67
11003,1,1,646,1285,639
11004,1,0,51,0,-51
11005,1,1,731,2381,1650
11006,1,0,36,0,-36
11007,1,0,60,0,-60
11008,1,0,3,0,-3
11009,1,0,17,0,-17
11010,0,0,100,0,-100
11011,1,0,0,0,0
11012,0,0,18,0,-18
11013,0,0,37,0,-37
11014,0,0,22,0,-22
11015,1,0,34,0,-34
11016,1,0,18,0,-18
11017,0,0,200,0,-200
11018,1,0,6,0,-6
11019,1,0,29,0,-29
11020,1,1,936,1377,441
11021,1,0,33,0,-33
11022,0,0,63,0,-63
11023,0,0,18,0,-18
11024,1,0,4,0,-4
11025,1,0,2,0,-2
11026,0,0,71,0,-71
11027,0,0,46,0,-46
11028,0,0,123,0,-123
11029,0,0,28,0,-28
11030,0,0,35,0,-35
11031,1,1,201,1410,1209
11032,1,0,2,0,-2
11033,1,1,443,1847,1404
11034,0,0,16,0,-16
11035,1,0,14,0,-14
11036,1,1,582,1784,1202
11037,0,0,58,0,-58
11038,1,1,457,4541,4084
11039,0,0,12,0,-12
11040,1,0,67,0,-67
11041,1,0,179,0,-179
11042,0,0,32,0,-32
11043,0,0,13,0,-13
11044,0,0,74,0,-74
11045,1,1,450,4075,3625
11046,1,1,624,2019,1395
11047,1,0,98,0,-98
11048,0,0,118,0,-118
11049,1,0,133,0,-133
11050,0,0,129,0,-129
11051,0,0,13,0,-13
11052,1,0,31,0,-31
11053,1,0,72,0,-72
11054,0,0,26,0,-26
11055,1,1,267,1315,1048
11056,1,1,166,1497,1331
11057,0,0,103,0,-103
11058,1,1,101,1411,1310
11059,0,0,143,0,-143
11060,1,0,104,0,-104
11061,1,1,537,1251,714
11062,1,0,53,0,-53
11063,1,0,182,0,-182
11064,1,0,11,0,-11
11065,1,0,31,0,-31
11066,1,0,86,0,-86
11067,1,1,434,1367,933
11068,1,1,2341,1237,-1104
11069,1,1,348,1278,930
11070,1,1,210,1574,1364
11071,1,0,109,0,-109
11072,1,1,75,1504,1429
11073,1,0,82,0,-82
11074,1,0,63,0,-63
11075,0,0,64,0,-64
11076,1,0,5,0,-5
11077,0,0,28,0,-28
11078,1,1,577,1316,739
11079,1,0,53,0,-53
11080,1,0,73,0,-73
11081,0,0,40,0,-40
11082,1,0,9,0,-9
11083,0,0,31,0,-31
11084,0,0,45,0,-45
11085,1,0,2,0,-2
11086,0,0,13,0,-13
11087,0,0,43,0,-43
11088,1,0,16,0,-16
11089,0,0,135,0,-135
11090,0,0,10,0,-10
11091,1,0,15,0,-15
11092,1,1,100,1385,1285
11093,1,0,11,0,-11
11094,1,0,2,0,-2
11095,0,0,50,0,-50
11096,1,1,589,1364,775
11097,1,1,637,1298,661
11098,1,0,4,0,-4
11099,0,0,101,0,-101
11100,1,1,50,1961,1911
11101,0,0,48,0,-48
11102,0,0,54,0,-54
11103,0,0,48,0,-48
11104,0,0,12,0,-12
11105,1,1,982,1246,264
11106,0,0,0,0,0
11107,1,1,158,1506,1348
11108,0,0,39,0,-39
11109,1,1,1409,1385,-24
11110,1,1,111,1560,1449
11111,1,0,25,0,-25
11112,1,1,1265,1451,186
11113,0,0,1,0,-1
11114,1,1,672,1548,876
11115,0,0,66,0,-66
11116,0,0,8,0,-8
11117,1,1,891,1638,747
11118,1,0,7,0,-7
11119,0,0,110,0,-110
11120,1,0,21,0,-21
11121,1,0,29,0,-29
11122,1,1,319,1335,1016
11123,0,0,64,0,-64
11124,0,0,2,0,-2
11125,0,0,26,0,-26
11126,0,0,59,0,-59
11127,0,0,100,0,-100
11128,1,1,1870,1570,-300
11129,0,0,44,0,-44
11130,0,0,7,0,-7
11131,1,1,576,1582,1006
11132,1,1,372,1469,1097
11133,1,0,4,0,-4
11134,1,1,200,1902,1702
11135,1,1,224,1245,1021
11136,1,1,101,1643,1542
11137,1,0,133,0,-133
11138,1,1,907,1284,377
11139,1,1,838,1690,852
11140,0,0,36,0,-36
11141,0,0,213,0,-213
11142,1,0,22,0,-22
11143,0,0,21,0,-21
11144,1,1,375,1526,1151
11145,1,0,38,0,-38
11146,0,0,4,0,-4
11147,0,0,209,0,-209
11148,1,0,58,0,-58
11149,0,0,71,0,-71
11150,1,0,62,0,-62
11151,1,1,404,1373,969
11152,0,0,7,0,-7
11153,1,0,29,0,-29
11154,1,1,461,1803,1342
11155,0,0,24,0,-24
11156,0,0,31,0,-31
11157,1,0,5,0,-5
11158,1,0,2,0,-2
11159,1,1,335,1456,1121
11160,1,1,1143,2558,1415
11161,1,1,272,2146,1874
11162,0,0,73,0,-73
11163,1,1,693,3660,2967
11164,1,1,815,1444,629
11165,1,1,268,2662,2394
11166,1,1,1252,1594,342
11167,0,0,114,0,-114
11168,1,0,12,0,-12
11169,1,1,510,1504,994
11170,0,0,51,0,-51
11171,0,0,57,0,-57
11172,0,0,13,0,-13
11173,1,0,19,0,-19
11174,1,0,77,0,-77
11175,0,0,5,0,-5
11176,1,0,63,0,-63
11177,1,1,483,1587,1104
11178,1,0,3,0,-3
11179,0,0,27,0,-27
11180,0,0,97,0,-97
11181,0,0,32,0,-32
11182,1,1,249,1544,1295
11183,0,0,80,0,-80
11184,1,0,61,0,-61
11185,0,0,111,0,-111
11186,0,0,28,0,-28
11187,1,0,225,0,-225
11188,0,0,15,0,-15
11189,1,0,91,0,-91
11190,0,0,119,0,-119
11191,1,0,1,0,-1
11192,0,0,18,0,-18
11193,1,0,19,0,-19
11194,1,0,130,0,-130
11195,1,0,148,0,-148
11196,1,0,74,0,-74
11197,0,0,125,0,-125
11198,0,0,22,0,-22
11199,0,0,55,0,-55
11200,0,0,32,0,-32
11201,1,0,24,0,-24
11202,0,0,4,0,-4
11203,0,0,3,0,-3
11204,0,0,126,0,-126
11205,1,0,80,0,-80
11206,1,1,431,1339,908
11207,0,0,8,0,-8
11208,0,0,10,0,-10
11209,0,0,30,0,-30
11210,1,0,47,0,-47
11211,0,0,165,0,-165
11212,1,1,318,2562,2244
11213,1,1,356,1323,967
11214,1,0,54,0,-54
11215,1,1,2896,2680,-216
11216,1,1,472,1732,1260
11217,0,0,101,0,-101
11218,0,0,14,0,-14
11219,1,1,249,1873,1624
11220,1,0,69,0,-69
11221,1,0,3,0,-3
11222,1,1,258,1475,1217
11223,1,0,90,0,-90
11224,1,1,175,1325,1150
11225,0,0,80,0,-80
11226,0,0,3,0,-3
11227,1,1,298,2250,1952
11228,0,0,16,0,-16
11229,1,1,481,1373,892
11230,0,0,74,0,-74
11231,1,0,166,0,-166
11232,1,0,54,0,-54
11233,1,1,276,1320,1044
11234,0,0,17,0,-17
11235,1,1,1715,1243,-472
11236,1,1,121,2098,1977
11237,1,1,1340,1557,217
11238,1,0,244,0,-244
11239,1,1,159,1961,1802
11240,0,0,14,0,-14
11241,1,1,560,1958,1398
11242,0,0,53,0,-53
11243,1,1,31,1375,1344
11244,1,1,405,1418,1013
11245,1,0,59,0,-59
11246,1,1,348,2622,2274
11247,0,0,11,0,-11
11248,1,0,5,0,-5
11249,1,1,866,1271,405
11250,1,0,2,0,-2
11251,1,0,48,0,-48
11252,0,0,53,0,-53
11253,1,0,9,0,-9
11254,1,0,103,0,-103
11255,1,0,139,0,-139
11256,0,0,10,0,-10
11257,1,0,28,0,-28
11258,1,1,225,1403,1178
11259,0,0,15,0,-15
11260,0,0,78,0,-78
11261,1,0,2,0,-2
11262,0,0,60,0,-60
11263,1,1,211,1650,1439
11264,0,0,14,0,-14
11265,1,1,260,1257,997
11266,1,0,24,0,-24
11267,1,1,53,2414,2361
11268,1,0,12,0,-12
11269,0,0,103,0,-103
11270,1,1,309,1437,1128
11271,1,1,206,1622,1416
11272,1,1,846,1423,577
11273,1,0,35,0,-35
11274,1,1,69,1280,1211
11275,1,1,199,1387,1188
11276,1,1,988,1351,363
11277,1,1,104,1616,1512
11278,1,0,23,0,-23
11279,1,1,117,1486,1369
11280,0,0,1,0,-1
11281,0,0,10,0,-10
11282,1,1,743,1508,765
11283,0,0,36,0,-36
11284,0,0,70,0,-70
11285,1,1,507,1502,995
11286,0,0,2,0,-2
11287,0,0,2,0,-2
11288,0,0,21,0,-21
11289,0,0,39,0,-39
11290,1,1,132,1493,1361
11291,0,0,22,0,-22
11292,0,0,28,0,-28
11293,1,1,555,1257,702
11294,1,1,246,1251,1005
11295,0,0,17,0,-17
11296,0,0,33,0,-33
11297,0,0,69,0,-69
11298,0,0,123,0,-123
11299,1,1,299,1244,945
11300,0,0,11,0,-11
11301,0,0,52,0,-52
11302,0,0,131,0,-131
11303,1,1,182,1601,1419
11304,0,0,90,0,-90
11305,0,0,50,0,-50
11306,1,0,132,0,-132
11307,0,0,36,0,-36
11308,1,0,68,0,-68
11309,1,0,79,0,-79
11310,1,1,213,1618,1405
11311,0,0,25,0,-25
11312,1,1,558,1302,744
11313,0,0,113,0,-113
11314,1,1,540,1265,725
11315,1,0,20,0,-20
11316,0,0,21,0,-21
11317,1,1,1922,1296,-626
11318,0,0,58,0,-58
11319,1,1,477,1529,1052
11320,1,0,128,0,-128
11321,1,0,28,0,-28
11322,1,1,249,1756,1507
11323,1,1,398,1535,1137
11324,0,0,93,0,-93
11325,0,0,145,0,-145
11326,0,0,127,0,-127
11327,1,0,91,0,-91
11328,0,0,51,0,-51
11329,1,1,579,1432,853
11330,1,1,1118,1315,197
11331,0,0,11,0,-11
11332,1,0,36,0,-36
11333,1,1,200,1333,1133
11334,0,0,4,0,-4
11335,1,0,11,0,-11
11336,1,1,101,2011,1910
11337,1,1,279,1758,1479
11338,0,0,15,0,-15
11339,0,0,30,0,-30
11340,0,0,86,0,-86
11341,1,1,866,1393,527
11342,0,0,4,0,-4
11343,1,1,15,1683,1668
11344,0,0,43,0,-43
11345,1,0,5,0,-5
11346,1,0,5,0,-5
11347,0,0,16,0,-16
11348,1,0,33,0,-33
11349,1,1,1136,1266,130
11350,1,0,0,0,0
11351,1,1,1144,1944,800
11352,1,0,88,0,-88
11353,1,0,13,0,-13
11354,0,0,0,0,0
11355,1,0,41,0,-41
11356,1,1,313,1782,1469
11357,1,1,956,2390,1434
11358,0,0,1,0,-1
11359,1,0,5,0,-5
11360,1,1,271,1409,1138
11361,1,1,157,1742,1585
11362,1,0,9,0,-9
11363,0,0,24,0,-24
11364,0,0,28,0,-28
11365,0,0,152,0,-152
11366,1,0,5,0,-5
11367,1,0,53,0,-53
11368,0,0,34,0,-34
11369,0,0,7,0,-7
11370,0,0,10,0,-10
11371,1,0,7,0,-7
11372,0,0,0,0,0
11373,1,1,171,1253,1082
11374,1,0,76,0,-76
11375,1,0,14,0,-14
11376,0,0,118,0,-118
11377,1,0,37,0,-37
11378,0,0,92,0,-92
11379,0,0,46,0,-46
11380,1,1,354,1487,1133
11381,1,0,44,0,-44
11382,1,0,102,0,-102
11383,0,0,27,0,-27
11384,0,0,142,0,-142
11385,0,0,6,0,-6
11386,1,0,4,0,-4
11387,0,0,3,0,-3
11388,1,1,217,1475,1258
11389,1,1,123,1525,1402
11390,0,0,23,0,-23
11391,1,1,699,1255,556
11392,0,0,86,0,-86
11393,0,0,172,0,-172
11394,1,0,57,0,-57
11395,1,0,63,0,-63
11396,1,0,11,0,-11
11397,0,0,83,0,-83
11398,1,0,21,0,-21
11399,0,0,3,0,-3
11400,1,0,32,0,-32
11401,1,1,79,1461,1382
11402,0,0,223,0,-223
11403,1,0,26,0,-26
11404,1,1,369,1550,1181
11405,1,0,22,0,-22
11406,1,1,866,1998,1132
11407,1,1,1730,2837,1107
11408,1,1,289,1317,1028
11409,1,1,92,1282,1190
11410,1,0,23,0,-23
11411,0,0,7,0,-7
11412,1,1,336,1951,1615
11413,0,0,17,0,-17
11414,1,0,28,0,-28
11415,1,1,4,1717,1713
11416,1,1,670,1470,800
11417,1,1,777,1664,887
11418,1,0,83,0,-83
11419,1,0,3,0,-3
11420,1,1,1031,2020,989
11421,1,0,59,0,-59
11422,0,0,86,0,-86
11423,1,1,308,1328,1020
11424,0,0,16,0,-16
11425,0,0,94,0,-94
11426,0,0,4,0,-4
11427,0,0,110,0,-110
11428,0,0,20,0,-20
11429,1,1,2397,1451,-946
11430,0,0,89,0,-89
11431,0,0,76,0,-76
11432,0,0,20,0,-20
11433,0,0,19,0,-19
11434,1,0,3,0,-3
11435,1,0,33,0,-33
11436,0,0,1,0,-1
11437,1,1,1052,1424,372
11438,0,0,73,0,-73
11439,1,0,52,0,-52
11440,1,1,373,1358,985
11441,1,1,438,1285,847
11442,1,1,88,2754,2666
11443,1,1,297,1261,964
11444,0,0,12,0,-12
11445,1,0,58,0,-58
11446,1,0,15,0,-15
11447,0,0,52,0,-52
11448,1,0,249,0,-249
11449,1,1,1414,1267,-147
11450,1,1,661,1291,630
11451,0,0,16,0,-16
11452,0,0,28,0,-28
11453,0,0,9,0,-9
11454,1,1,1114,2043,929
11455,0,0,17,0,-17
11456,1,0,2,0,-2
11457,1,1,1034,1326,292
11458,1,1,687,1541,854
11459,1,1,213,1644,1431
11460,0,0,18,0,-18
11461,1,0,24,0,-24
11462,1,1,73,1328,1255
11463,1,0,75,0,-75
11464,1,1,282,1420,1138
11465,1,0,41,0,-41
11466,1,0,6,0,-6
11467,0,0,102,0,-102
11468,1,0,22,0,-22
11469,1,1,271,2284,2013
11470,1,0,7,0,-7
11471,0,0,71,0,-71
11472,1,0,86,0,-86
11473,1,0,94,0,-94
11474,1,0,80,0,-80
11475,1,1,96,1296,1200
11476,1,1,32,1386,1354
11477,1,1,785,1615,830
11478,1,0,0,0,0
11479,0,0,5,0,-5
11480,0,0,23,0,-23
11481,0,0,19,0,-19
11482,1,0,141,0,-141
11483,1,0,4,0,-4
11484,1,1,119,1444,1325
11485,1,1,529,1314,785
11486,1,0,101,0,-101
11487,1,0,247,0,-247
11488,1,1,242,1860,1618
11489,1,1,10,1711,1701
11490,0,0,45,0,-45
11491,0,0,10,0,-10
11492,1,1,185,1528,1343
11493,0,0,80,0,-80
11494,1,0,97,0,-97
11495,1,0,26,0,-26
11496,0,0,17,0,-17
11497,1,1,480,1506,1026
11498,1,1,1390,1321,-69
11499,1,0,114,0,-114
11500,0,0,4,0,-4
11501,1,1,515,1244,729
11502,1,1,1094,2364,1270
11503,1,1,57,2328,2271
11504,0,0,26,0,-26
11505,0,0,43,0,-43
11506,0,0,24,0,-24
11507,1,1,148,1587,1439
11508,0,0,119,0,-119
11509,1,1,403,1270,867
11510,1,1,105,1257,1152
11511,0,0,7,0,-7
11512,1,1,45,1453,1408
11513,0,0,78,0,-78
11514,0,0,78,0,-78
11515,1,0,96,0,-96
11516,1,0,10,0,-10
11517,1,1,125,1296,1171
11518,1,0,5,0,-5
11519,1,1,173,1415,1242
11520,0,0,6,0,-6
11521,0,0,8,0,-8
11522,0,0,0,0,0
11523,0,0,6,0,-6
11524,0,0,54,0,-54
11525,1,0,16,0,-16
11526,1,0,7,0,-7
11527,0,0,65,0,-65
11528,0,0,26,0,-26
11529,1,1,108,3078,2970
11530,0,0,23,0,-23
11531,1,0,105,0,-105
11532,0,0,113,0,-113
11533,0,0,94,0,-94
11534,0,0,11,0,-11
11535,0,0,45,0,-45
11536,0,0,114,0,-114
11537,1,0,1,0,-1
11538,0,0,202,0,-202
11539,1,1,170,1594,1424
11540,0,0,124,0,-124
11541,0,0,11,0,-11
11542,1,0,18,0,-18
11543,1,1,1129,1271,142
11544,0,0,27,0,-27
11545,1,0,43,0,-43
11546,0,0,67,0,-67
11547,1,0,55,0,-55
11548,0,0,52,0,-52
11549,0,0,65,0,-65
11550,0,0,31,0,-31
11551,0,0,2,0,-2
11552,0,0,3,0,-3
11553,1,0,5,0,-5
11554,0,0,63,0,-63
11555,0,0,100,0,-100
11556,1,0,12,0,-12
11557,1,1,215,1364,1149
11558,0,0,12,0,-12
11559,1,1,1212,1764,552
11560,0,0,102,0,-102
11561,0,0,100,0,-100
11562,1,1,419,1857,1438
11563,0,0,6,0,-6
11564,1,0,11,0,-11
11565,1,0,5,0,-5
11566,1,1,463,2525,2062
11567,1,1,1231,1904,673
11568,0,0,82,0,-82
11569,1,1,95,1899,1804
11570,1,0,28,0,-28
11571,1,1,368,2985,2617
11572,0,0,37,0,-37
11573,0,0,161,0,-161
11574,1,0,99,0,-99
11575,1,0,106,0,-106
11576,1,1,219,1919,1700
11577,0,0,8,0,-8
11578,1,1,388,1483,1095
11579,1,1,195,1360,1165
11580,1,0,59,0,-59
11581,1,1,1012,1694,682
11582,0,0,1,0,-1
11583,0,0,12,0,-12
11584,0,0,65,0,-65
11585,0,0,11,0,-11
11586,0,0,89,0,-89
11587,0,0,55,0,-55
11588,1,0,40,0,-40
11589,0,0,32,0,-32
11590,0,0,35,0,-35
11591,1,0,50,0,-50
11592,1,0,7,0,-7
11593,0,0,15,0,-15
11594,1,1,390,1251,861
11595,0,0,22,0,-22
11596,1,1,155,1405,1250
11597,0,0,12,0,-12
11598,0,0,11,0,-11
11599,0,0,254,0,-254
11600,1,1,193,1281,1088
11601,0,0,4,0,-4
11602,1,0,105,0,-105
11603,1,0,6,0,-6
11604,0,0,29,0,-29
11605,0,0,15,0,-15
11606,1,1,1495,1246,-249
11607,1,0,22,0,-22
11608,0,0,155,0,-155
11609,0,0,15,0,-15
11610,1,0,159,0,-159
11611,1,1,1013,1337,324
11612,1,1,155,1617,1462
11613,1,0,49,0,-49
11614,1,0,210,0,-210
11615,1,0,12,0,-12
11616,0,0,9,0,-9
11617,1,1,209,1311,1102
11618,0,0,58,0,-58
11619,1,1,686,1426,740
11620,0,0,65,0,-65
11621,1,0,49,0,-49
11622,0,0,14,0,-14
11623,0,0,31,0,-31
11624,1,1,112,1390,1278
11625,1,1,243,1654,1411
11626,1,1,95,1689,1594
11627,0,0,111,0,-111
11628,1,0,21,0,-21
11629,1,0,20,0,-20
11630,0,0,5,0,-5
11631,0,0,41,0,-41
11632,1,1,112,1693,1581
11633,0,0,21,0,-21
11634,1,0,7,0,-7
11635,1,1,774,1466,692
11636,1,0,82,0,-82
11637,0,0,22,0,-22
11638,0,0,43,0,-43
11639,1,1,495,1440,945
11640,1,0,34,0,-34
11641,1,1,1771,1475,-296
11642,1,1,888,1267,379
11643,1,1,2377,1581,-796
11644,0,0,19,0,-19
11645,1,0,212,0,-212
11646,1,1,494,1338,844
11647,0,0,5,0,-5
11648,1,0,48,0,-48
11649,1,1,430,1536,1106
11650,1,0,0,0,0
11651,1,1,113,3496,3383
11652,1,1,480,2369,1889
11653,0,0,107,0,-107
11654,1,0,72,0,-72
11655,0,0,119,0,-119
11656,1,0,31,0,-31
11657,1,1,726,1524,798
11658,0,0,37,0,-37
11659,1,1,296,1814,1518
11660,0,0,8,0,-8
11661,1,0,1,0,-1
11662,0,0,103,0,-103
11663,0,0,13,0,-13
11664,1,0,18,0,-18
11665,0,0,22,0,-22
11666,1,0,97,0,-97
11667,1,1,626,1687,1061
11668,0,0,7,0,-7
11669,1,0,28,0,-28
11670,0,0,42,0,-42
11671,1,1,300,1418,1118
11672,0,0,46,0,-46
11673,1,0,162,0,-162
11674,0,0,31,0,-31
11675,0,0,5,0,-5
11676,0,0,4,0,-4
11677,0,0,117,0,-117
11678,0,0,46,0,-46
11679,1,1,306,3032,2726
11680,1,1,1588,1384,-204
11681,1,1,136,1414,1278
11682,1,0,2,0,-2
11683,1,0,4,0,-4
11684,1,0,143,0,-143
11685,1,0,170,0,-170
11686,0,0,43,0,-43
11687,1,1,116,1277,1161
11688,0,0,50,0,-50
11689,1,1,970,1533,563
11690,0,0,48,0,-48
11691,0,0,129,0,-129
11692,1,0,124,0,-124
11693,0,0,59,0,-59
11694,0,0,3,0,-3
11695,0,0,6,0,-6
11696,1,0,118,0,-118
11697,0,0,7,0,-7
11698,0,0,4,0,-4
11699,0,0,48,0,-48
11700,0,0,46,0,-46
11701,0,0,130,0,-130
11702,1,1,737,1586,849
11703,0,0,43,0,-43
11704,0,0,56,0,-56
11705,0,0,79,0,-79
11706,1,1,201,1623,1422
11707,1,0,7,0,-7
11708,0,0,24,0,-24
11709,0,0,2,0,-2
11710,0,0,54,0,-54
11711,1,1,135,1294,1159
11712,1,1,10,1306,1296
11713,1,1,120,1248,1128
11714,1,1,127,1287,1160
11715,0,0,11,0,-11
11716,1,1,394,1482,1088
11717,0,0,121,0,-121
11718,0,0,1,0,-1
11719,0,0,34,0,-34
11720,1,1,802,4176,3374
11721,1,1,1317,1387,70
11722,0,0,219,0,-219
11723,1,0,245,0,-245
11724,1,0,2,0,-2
11725,1,0,4,0,-4
11726,1,0,20,0,-20
11727,1,0,45,0,-45
11728,0,0,25,0,-25
11729,0,0,102,0,-102
11730,0,0,60,0,-60
11731,0,0,14,0,-14
11732,1,1,790,1957,1167
11733,1,0,0,0,0
11734,0,0,33,0,-33
11735,0,0,27,0,-27
11736,1,1,226,1242,1016
11737,0,0,119,0,-119
11738,0,0,30,0,-30
11739,0,0,65,0,-65
11740,0,0,26,0,-26
11741,1,1,582,1267,685
11742,1,0,9,0,-9
11743,1,1,270,1327,1057
11744,1,0,16,0,-16
11745,1,1,397,2267,1870
11746,1,1,255,1536,1281
11747,0,0,9,0,-9
11748,0,0,36,0,-36
11749,1,0,28,0,-28
11750,0,0,38,0,-38
11751,1,1,62,1359,1297
11752,1,1,889,1545,656
11753,1,1,220,1478,1258
11754,0,0,50,0,-50
11755,1,0,124,0,-124
11756,1,1,281,1343,1062
11757,1,0,24,0,-24
11758,0,0,23,0,-23
11759,1,1,83,1456,1373
11760,0,0,40,0,-40
11761,1,1,201,1960,1759
11762,1,1,133,1651,1518
11763,1,1,204,1260,1056
11764,0,0,114,0,-114
11765,1,1,250,1323,1073
11766,0,0,107,0,-107
11767,0,0,22,0,-22
11768,1,1,230,1483,1253
11769,1,0,14,0,-14
11770,1,0,22,0,-22
11771,0,0,222,0,-222
11772,0,0,80,0,-80
11773,0,0,98,0,-98
11774,0,0,9,0,-9
11775,0,0,51,0,-51
11776,1,1,56,1787,1731
11777,1,0,54,0,-54
11778,0,0,95,0,-95
11779,0,0,37,0,-37
11780,0,0,25,0,-25
11781,1,1,588,1276,688
11782,0,0,123,0,-123
11783,1,1,197,1346,1149
11784,0,0,67,0,-67
11785,0,0,36,0,-36
11786,1,0,9,0,-9
11787,0,0,10,0,-10
11788,1,0,15,0,-15
11789,1,0,32,0,-32
11790,1,0,175,0,-175
11791,1,0,1,0,-1
11792,0,0,52,0,-52
11793,1,0,12,0,-12
11794,1,1,299,2358,2059
11795,0,0,192,0,-192
11796,0,0,54,0,-54
11797,1,0,13,0,-13
11798,1,1,987,1899,912
11799,1,0,64,0,-64
11800,0,0,94,0,-94
11801,1,0,119,0,-119
11802,0,0,72,0,-72
11803,0,0,0,0,0
11804,1,1,218,1402,1184
11805,1,0,92,0,-92
11806,1,1,256,1319,1063
11807,1,1,1638,1568,-70
11808,1,0,48,0,-48
11809,1,0,34,0,-34
11810,1,0,15,0,-15
11811,1,0,80,0,-80
11812,0,0,4,0,-4
11813,0,0,1,0,-1
11814,1,0,40,0,-40
11815,1,1,87,1277,1190
11816,1,0,4,0,-4
11817,1,0,299,0,-299
11818,1,1,335,1502,1167
11819,0,0,7,0,-7
11820,0,0,97,0,-97
11821,1,0,114,0,-114
11822,0,0,23,0,-23
11823,1,0,17,0,-17
11824,1,1,373,1331,958
11825,1,0,44,0,-44
11826,1,1,724,1687,963
11827,1,1,76,2703,2627
11828,1,1,951,1286,335
11829,0,0,126,0,-126
11830,0,0,5,0,-5
11831,1,0,18,0,-18
11832,1,0,8,0,-8
11833,1,1,106,1361,1255
11834,0,0,31,0,-31
11835,1,0,0,0,0
11836,1,1,870,1272,402
11837,0,0,2,0,-2
11838,1,1,607,1372,765
11839,1,0,11,0,-11
11840,0,0,6,0,-6
11841,0,0,57,0,-57
11842,1,1,879,1361,482
11843,1,0,28,0,-28
11844,0,0,35,0,-35
11845,0,0,18,0,-18
11846,1,0,35,0,-35
11847,1,0,6,0,-6
11848,0,0,69,0,-69
11849,0,0,1,0,-1
11850,1,0,29,0,-29
11851,0,0,55,0,-55
11852,1,0,63,0,-63
11853,1,1,692,1267,575
11854,0,0,18,0,-18
11855,1,1,925,2553,1628
11856,1,0,53,0,-53
11857,1,0,175,0,-175
11858,1,0,15,0,-15
11859,1,1,145,1485,1340
11860,1,1,118,1511,1393
11861,1,0,36,0,-36
11862,0,0,84,0,-84
11863,0,0,33,0,-33
11864,1,1,226,1521,1295
11865,1,0,15,0,-15
11866,1,1,910,1279,369
11867,1,1,980,1372,392
11868,1,1,33,2043,2010
11869,0,0,0,0,0
11870,0,0,12,0,-12
11871,1,0,76,0,-76
11872,1,0,9,0,-9
11873,1,1,281,5109,4828
11874,0,0,39,0,-39
11875,0,0,58,0,-58
11876,0,0,42,0,-42
11877,0,0,93,0,-93
11878,1,1,450,2319,1869
11879,1,0,123,0,-123
11880,0,0,104,0,-104
11881,1,0,167,0,-167
11882,1,1,722,1269,547
11883,0,0,58,0,-58
11884,1,1,402,1238,836
11885,0,0,226,0,-226
11886,1,0,56,0,-56
11887,1,1,401,1306,905
11888,0,0,13,0,-13
11889,1,0,58,0,-58
11890,0,0,44,0,-44
11891,1,1,527,1393,866
11892,1,0,10,0,-10
11893,1,0,18,0,-18
11894,1,1,277,1552,1275
11895,1,1,271,3217,2946
11896,1,0,78,0,-78
11897,0,0,26,0,-26
11898,0,0,129,0,-129
11899,1,1,61,1433,1372
11900,0,0,71,0,-71
11901,0,0,19,0,-19
11902,1,0,137,0,-137
11903,0,0,37,0,-37
11904,1,1,672,2043,1371
11905,1,1,999,1729,730
11906,0,0,315,0,-315
11907,0,0,53,0,-53
11908,1,1,48,1303,1255
11909,0,0,5,0,-5
11910,1,0,26,0,-26
11911,1,1,411,1360,949
11912,1,1,272,1547,1275
11913,0,0,29,0,-29
11914,1,0,144,0,-144
11915,1,0,60,0,-60
11916,1,0,14,0,-14
11917,0,0,45,0,-45
11918,1,1,763,1373,610
11919,1,1,815,7096,6281
11920,1,0,61,0,-61
11921,0,0,0,0,0
11922,1,0,15,0,-15
11923,0,0,53,0,-53
11924,1,0,36,0,-36
11925,1,0,99,0,-99
11926,0,0,69,0,-69
11927,0,0,10,0,-10
11928,1,0,29,0,-29
11929,0,0,89,0,-89
11930,1,0,9,0,-9
11931,1,1,508,1341,833
11932,1,0,14,0,-14
11933,1,0,11,0,-11
11934,0,0,97,0,-97
11935,1,0,244,0,-244
11936,1,1,67,1551,1484
11937,1,1,161,1289,1128
11938,1,1,504,1447,943
11939,1,0,56,0,-56
11940,0,0,27,0,-27
11941,0,0,24,0,-24
11942,0,0,1,0,-1
11943,1,0,57,0,-57
11944,1,0,70,0,-70
11945,1,1,398,1291,893
11946,0,0,0,0,0
11947,1,1,138,1455,1317
11948,1,1,845,1560,715
11949,1,1,1200,1392,192
11950,0,0,65,0,-65
11951,0,0,2,0,-2
11952,1,1,1050,1376,326
11953,1,1,108,1480,1372
11954,1,0,7,0,-7
11955,1,0,5,0,-5
11956,1,1,2204,1460,-744
11957,1,1,1344,2600,1256
11958,1,1,992,1353,361
11959,1,1,522,1810,1288
11960,0,0,94,0,-94
11961,0,0,77,0,-77
11962,1,1,179,1301,1122
11963,1,0,1,0,-1
11964,1,1,1124,1308,184
11965,1,1,1212,1469,257
11966,1,0,48,0,-48
11967,0,0,46,0,-46
11968,1,1,174,2526,2352
11969,1,1,439,1445,1006
11970,1,1,194,1320,1126
11971,0,0,30,0,-30
11972,1,0,10,0,-10
11973,1,1,667,1312,645
11974,0,0,164,0,-164
11975,1,1,476,1250,774
11976,0,0,4,0,-4
11977,0,0,69,0,-69
11978,0,0,23,0,-23
11979,1,1,89,1257,1168
11980,1,1,621,1275,654
11981,1,0,109,0,-109
11982,1,1,770,1273,503
11983,1,1,1210,1383,173
11984,1,0,124,0,-124
11985,1,1,525,2031,1506
11986,0,0,0,0,0
11987,0,0,24,0,-24
11988,0,0,25,0,-25
11989,0,0,20,0,-20
11990,1,1,597,1800,1203
11991,0,0,14,0,-14
11992,0,0,68,0,-68
11993,0,0,187,0,-187
11994,0,0,18,0,-18
11995,1,1,1694,1276,-418
11996,0,0,107,0,-107
11997,1,0,2,0,-2
11998,1,0,40,0,-40
11999,1,0,84,0,-84
12000,1,1,80,1439,1359
12001,0,0,107,0,-107
12002,0,0,35,0,-35
12003,0,0,16,0,-16
12004,0,0,8,0,-8
12005,0,0,31,0,-31
12006,0,0,77,0,-77
12007,1,0,115,0,-115
12008,1,1,370,1241,871
12009,1,1,729,1255,526
12010,0,0,35,0,-35
12011,1,0,2,0,-2
12012,1,1,785,2241,1456
12013,1,0,2,0,-2
12014,1,1,66,1353,1287
12015,0,0,37,0,-37
12016,0,0,18,0,-18
12017,1,0,29,0,-29
12018,1,0,56,0,-56
12019,1,1,217,1241,1024
12020,0,0,161,0,-161
12021,0,0,220,0,-220
12022,0,0,26,0,-26
12023,1,1,28,1252,1224
12024,1,0,45,0,-45
12025,1,1,360,1248,888
12026,1,0,10,0,-10
12027,1,1,687,1278,591
12028,1,1,834,1326,492
12029,0,0,86,0,-86
12030,0,0,2,0,-2
12031,1,1,180,1315,1135
12032,1,1,857,3129,2272
12033,0,0,25,0,-25
12034,0,0,11,0,-11
12035,1,0,60,0,-60
12036,1,0,23,0,-23
12037,1,1,243,1679,1436
12038,0,0,4,0,-4
12039,1,0,16,0,-16
12040,1,0,77,0,-77
12041,0,0,220,0,-220
12042,1,1,158,1314,1156
12043,1,1,953,1460,507
12044,0,0,63,0,-63
12045,1,1,419,1711,1292
12046,0,0,63,0,-63
12047,0,0,18,0,-18
12048,0,0,35,0,-35
12049,1,0,107,0,-107
12050,0,0,26,0,-26
12051,1,0,62,0,-62
12052,1,0,101,0,-101
12053,1,0,0,0,0
12054,0,0,30,0,-30
12055,1,0,36,0,-36
12056,1,1,118,1998,1880
12057,1,0,68,0,-68
12058,0,0,2,0,-2
12059,1,0,82,0,-82
12060,0,0,9,0,-9
12061,1,0,51,0,-51
12062,0,0,36,0,-36
12063,1,1,302,1826,1524
12064,0,0,5,0,-5
12065,0,0,32,0,-32
12066,1,1,853,1349,496
12067,1,1,616,1591,975
12068,1,1,354,1271,917
12069,1,1,1533,1400,-133
12070,1,1,190,1830,1640
12071,1,0,16,0,-16
12072,1,0,41,0,-41
12073,0,0,131,0,-131
12074,0,0,55,0,-55
12075,0,0,36,0,-36
12076,1,1,76,1863,1787
12077,0,0,82,0,-82
12078,1,0,30,0,-30
12079,1,1,788,1364,576
12080,0,0,37,0,-37
12081,0,0,62,0,-62
12082,0,0,20,0,-20
12083,1,0,29,0,-29
12084,0,0,45,0,-45
12085,0,0,14,0,-14
12086,1,0,4,0,-4
12087,1,1,103,1427,1324
12088,1,0,26,0,-26
12089,0,0,36,0,-36
12090,1,0,101,0,-101
12091,1,1,266,1513,1247
12092,1,0,91,0,-91
12093,0,0,19,0,-19
12094,1,1,843,1258,415
12095,1,1,296,1352,1056
12096,0,0,62,0,-62
12097,0,0,28,0,-28
12098,1,1,222,1676,1454
12099,1,1,2708,1635,-1073
12100,1,0,54,0,-54
12101,1,0,105,0,-105
12102,1,0,44,0,-44
12103,1,1,297,1564,1267
12104,0,0,21,0,-21
12105,0,0,149,0,-149
12106,1,1,203,1241,1038
12107,1,0,70,0,-70
12108,0,0,34,0,-34
12109,0,0,60,0,-60
12110,1,0,59,0,-59
12111,1,1,530,1728,1198
12112,0,0,29,0,-29
12113,1,1,380,1275,895
12114,1,1,774,1421,647
12115,0,0,81,0,-81
12116,0,0,59,0,-59
12117,0,0,35,0,-35
12118,0,0,117,0,-117
12119,0,0,24,0,-24
12120,0,0,4,0,-4
12121,0,0,2,0,-2
12122,1,1,65,1308,1243
12123,1,1,198,2441,2243
12124,1,0,42,0,-42
12125,1,0,8,0,-8
12126,0,0,12,0,-12
12127,1,0,0,0,0
12128,1,0,86,0,-86
12129,0,0,88,0,-88
12130,0,0,5,0,-5
12131,0,0,32,0,-32
12132,1,1,1248,1954,706
12133,1,0,47,0,-47
12134,0,0,82,0,-82
12135,1,0,89,0,-89
12136,1,0,106,0,-106
12137,0,0,35,0,-35
12138,1,0,35,0,-35
12139,1,1,541,1414,873
12140,0,0,33,0,-33
12141,1,1,247,2508,2261
12142,0,0,23,0,-23
12143,1,0,110,0,-110
12144,0,0,27,0,-27
12145,1,0,46,0,-46
12146,1,1,604,1591,987
12147,0,0,40,0,-40
12148,1,0,11,0,-11
12149,0,0,27,0,-27
12150,0,0,53,0,-53
12151,1,0,35,0,-35
12152,0,0,10,0,-10
12153,0,0,13,0,-13
12154,1,1,253,1364,1111
12155,1,1,1133,1875,742
12156,0,0,25,0,-25
12157,1,0,3,0,-3
12158,1,1,1541,1638,97
12159,1,0,18,0,-18
12160,0,0,18,0,-18
12161,0,0,43,0,-43
12162,1,0,111,0,-111
12163,1,0,20,0,-20
12164,0,0,27,0,-27
12165,1,1,585,1513,928
12166,0,0,62,0,-62
12167,1,0,25,0,-25
12168,0,0,1,0,-1
12169,1,0,38,0,-38
12170,1,1,718,1849,1131
12171,0,0,65,0,-65
12172,1,1,81,1771,1690
12173,1,0,0,0,0
12174,0,0,61,0,-61
12175,1,1,548,1749,1201
12176,0,0,36,0,-36
12177,1,0,144,0,-144
12178,0,0,183,0,-183
12179,1,0,45,0,-45
12180,1,0,1,0,-1
12181,1,0,29,0,-29
12182,0,0,12,0,-12
12183,0,0,104,0,-104
12184,1,0,15,0,-15
12185,1,0,16,0,-16
12186,1,1,67,1551,1484
12187,1,1,919,5085,4166
12188,1,1,488,1252,764
12189,1,0,59,0,-59
12190,1,0,45,0,-45
12191,1,0,5,0,-5
12192,0,0,42,0,-42
12193,1,0,45,0,-45
12194,1,1,247,1256,1009
12195,1,1,604,1263,659
12196,0,0,58,0,-58
12197,1,1,1692,1770,78
12198,1,1,794,1593,799
12199,1,1,750,1885,1135
12200,1,1,416,2373,1957
12201,1,1,1129,1920,791
12202,1,0,43,0,-43
12203,1,0,162,0,-162
12204,0,0,77,0,-77
12205,0,0,57,0,-57
12206,1,0,105,0,-105
12207,1,1,584,1661,1077
12208,1,0,39,0,-39
12209,1,0,51,0,-51
12210,1,0,48,0,-48
12211,1,0,40,0,-40
12212,1,0,84,0,-84
12213,1,0,27,0,-27
12214,1,1,121,1454,1333
12215,1,1,226,1446,1220
12216,0,0,55,0,-55
12217,1,0,51,0,-51
12218,1,1,1258,1719,461
12219,1,0,25,0,-25
12220,0,0,11,0,-11
12221,0,0,11,0,-11
12222,1,0,26,0,-26
12223,1,1,444,1514,1070
12224,1,0,67,0,-67
12225,1,1,569,1386,817
12226,1,1,509,1980,1471
12227,1,1,1622,1738,116
12228,1,1,345,6616,6271
12229,1,1,1458,2660,1202
12230,1,0,9,0,-9
12231,1,0,7,0,-7
12232,1,0,103,0,-103
12233,1,0,32,0,-32
12234,1,0,107,0,-107
12235,0,0,25,0,-25
12236,0,0,52,0,-52
12237,1,1,633,1764,1131
12238,0,0,101,0,-101
12239,1,1,241,1563,1322
12240,0,0,67,0,-67
12241,0,0,37,0,-37
12242,0,0,30,0,-30
12243,0,0,8,0,-8
12244,0,0,42,0,-42
12245,1,0,13,0,-13
12246,1,0,49,0,-49
12247,1,1,677,1383,706
12248,1,1,969,2041,1072
12249,0,0,146,0,-146
12250,1,0,61,0,-61
12251,1,0,42,0,-42
12252,1,0,16,0,-16
12253,1,0,0,0,0
12254,0,0,10,0,-10
12255,0,0,3,0,-3
12256,1,0,87,0,-87
12257,1,0,3,0,-3
12258,1,0,92,0,-92
12259,0,0,72,0,-72
12260,1,0,46,0,-46
12261,1,1,514,2223,1709
12262,0,0,49,0,-49
12263,1,1,170,1474,1304
12264,1,1,83,1426,1343
12265,1,0,35,0,-35
12266,1,1,314,1380,1066
12267,1,1,402,1392,990
12268,1,0,8,0,-8
12269,0,0,24,0,-24
12270,1,0,81,0,-81
12271,1,0,112,0,-112
12272,1,0,83,0,-83
12273,1,0,57,0,-57
12274,0,0,12,0,-12
12275,0,0,32,0,-32
12276,0,0,8,0,-8
12277,1,1,570,1437,867
12278,1,1,150,1973,1823
12279,0,0,172,0,-172
12280,1,1,1487,1411,-76
12281,1,1,47,1258,1211
12282,1,1,406,2173,1767
12283,1,0,0,0,0
12284,1,0,62,0,-62
12285,1,0,27,0,-27
12286,0,0,18,0,-18
12287,0,0,20,0,-20
12288,0,0,45,0,-45
12289,1,1,275,1253,978
12290,0,0,69,0,-69
12291,0,0,22,0,-22
12292,0,0,17,0,-17
12293,0,0,99,0,-99
12294,0,0,40,0,-40
12295,1,0,92,0,-92
12296,0,0,34,0,-34
12297,0,0,6,0,-6
12298,0,0,53,0,-53
12299,0,0,36,0,-36
12300,1,1,2311,1390,-921
12301,1,0,24,0,-24
12302,1,1,270,1235,965
12303,1,0,16,0,-16
12304,0,0,42,0,-42
12305,1,1,760,1354,594
12306,1,1,1011,1300,289
12307,0,0,58,0,-58
12308,0,0,32,0,-32
12309,0,0,19,0,-19
12310,1,1,113,1263,1150
12311,1,0,33,0,-33
12312,1,1,168,1299,1131
12313,1,1,282,2714,2432
12314,1,0,1,0,-1
12315,0,0,20,0,-20
12316,1,1,595,1420,825
12317,1,1,483,1502,1019
12318,0,0,134,0,-134
12319,1,0,39,0,-39
12320,1,1,1104,1491,387
12321,1,0,14,0,-14
12322,0,0,71,0,-71
12323,0,0,1,0,-1
12324,0,0,3,0,-3
12325,0,0,79,0,-79
12326,1,1,332,1422,1090
12327,0,0,73,0,-73
12328,1,0,81,0,-81
12329,0,0,4,0,-4
12330,1,1,588,1700,1112
12331,1,1,293,1420,1127
12332,0,0,4,0,-4
12333,1,0,25,0,-25
12334,1,1,123,1763,1640
12335,0,0,11,0,-11
12336,1,0,45,0,-45
12337,1,1,118,1379,1261
12338,1,0,86,0,-86
12339,1,1,477,1545,1068
12340,1,1,1266,1269,3
12341,1,0,47,0,-47
12342,1,1,2594,1732,-862
12343,0,0,0,0,0
12344,0,0,23,0,-23
12345,1,0,1,0,-1
12346,1,1,618,1405,787
12347,0,0,81,0,-81
12348,1,1,185,1928,1743
12349,1,1,585,1461,876
12350,1,0,2,0,-2
12351,1,1,272,1580,1308
12352,0,0,85,0,-85
12353,1,1,90,1649,1559
12354,1,1,1537,1306,-231
12355,1,0,9,0,-9
12356,0,0,2,0,-2
12357,0,0,75,0,-75
12358,1,0,261,0,-261
12359,1,0,50,0,-50
12360,1,1,682,1669,987
12361,0,0,24,0,-24
12362,0,0,92,0,-92
12363,1,0,202,0,-202
12364,1,1,1968,1317,-651
12365,0,0,270,0,-270
12366,1,0,42,0,-42
12367,1,0,41,0,-41
12368,0,0,17,0,-17
12369,1,0,32,0,-32
12370,1,1,450,1661,1211
12371,1,0,66,0,-66
12372,0,0,17,0,-17
12373,1,0,31,0,-31
12374,0,0,33,0,-33
12375,1,0,78,0,-78
12376,1,0,58,0,-58
12377,1,0,4,0,-4
12378,1,1,509,1433,924
12379,0,0,128,0,-128
12380,1,1,119,1521,1402
12381,0,0,44,0,-44
12382,1,0,17,0,-17
12383,0,0,7,0,-7
12384,1,1,592,1261,669
12385,0,0,47,0,-47
12386,1,1,1544,1393,-151
12387,0,0,58,0,-58
12388,0,0,6,0,-6
12389,0,0,66,0,-66
12390,1,0,36,0,-36
12391,1,0,17,0,-17
12392,0,0,26,0,-26
12393,0,0,37,0,-37
12394,1,1,1236,1541,305
12395,1,0,16,0,-16
12396,1,0,102,0,-102
12397,1,0,7,0,-7
12398,0,0,27,0,-27
12399,0,0,196,0,-196
12400,1,0,87,0,-87
12401,0,0,28,0,-28
12402,1,0,79,0,-79
12403,1,1,333,1348,1015
12404,1,1,977,1727,750
12405,0,0,37,0,-37
12406,1,1,381,2761,2380
12407,0,0,36,0,-36
12408,0,0,40,0,-40
12409,1,0,61,0,-61
12410,1,1,371,1278,907
12411,0,0,77,0,-77
12412,1,0,135,0,-135
12413,1,1,112,1747,1635
12414,1,0,18,0,-18
12415,0,0,41,0,-41
12416,0,0,68,0,-68
12417,0,0,49,0,-49
12418,1,0,14,0,-14
12419,0,0,82,0,-82
12420,0,0,31,0,-31
12421,0,0,59,0,-59
12422,1,1,45,1427,1382
12423,0,0,236,0,-236
12424,1,1,1287,1272,-15
12425,0,0,16,0,-16
12426,1,0,152,0,-152
12427,0,0,10,0,-10
12428,0,0,104,0,-104
12429,1,0,6,0,-6
12430,0,0,29,0,-29
12431,1,0,119,0,-119
12432,0,0,37,0,-37
12433,1,1,690,2548,1858
12434,0,0,22,0,-22
12435,1,1,122,1664,1542
12436,1,0,138,0,-138
12437,1,1,208,1449,1241
12438,1,0,50,0,-50
12439,0,0,45,0,-45
12440,1,0,98,0,-98
12441,1,0,34,0,-34
12442,0,0,95,0,-95
12443,1,0,31,0,-31
12444,1,1,3252,1458,-1794
12445,1,1,485,2345,1860
12446,1,0,44,0,-44
12447,1,0,80,0,-80
12448,1,0,13,0,-13
12449,1,1,325,1237,912
12450,1,1,278,1346,1068
12451,0,0,87,0,-87
12452,1,0,11,0,-11
12453,0,0,17,0,-17
12454,1,0,27,0,-27
12455,0,0,14,0,-14
12456,1,0,36,0,-36
12457,1,1,290,1463,1173
12458,0,0,81,0,-81
12459,1,0,63,0,-63
12460,0,0,23,0,-23
12461,1,1,85,1574,1489
12462,1,0,31,0,-31
12463,1,1,41,1490,1449
12464,1,1,740,2093,1353
12465,1,1,428,1996,1568
12466,1,1,259,1243,984
12467,1,1,241,1250,1009
12468,0,0,182,0,-182
12469,0,0,1,0,-1
12470,0,0,46,0,-46
12471,1,0,33,0,-33
12472,1,0,62,0,-62
12473,1,0,199,0,-199
12474,1,0,10,0,-10
12475,1,1,1801,1885,84
12476,1,0,11,0,-11
12477,1,0,36,0,-36
12478,0,0,101,0,-101
12479,1,0,49,0,-49
12480,1,0,18,0,-18
12481,1,0,128,0,-128
12482,0,0,44,0,-44
12483,1,0,89,0,-89
12484,1,1,813,1410,597
12485,0,0,9,0,-9
12486,1,0,22,0,-22
12487,1,1,355,1243,888
12488,1,1,159,1340,1181
12489,1,1,1567,1552,-15
12490,0,0,43,0,-43
12491,0,0,40,0,-40
12492,1,1,1636,1427,-209
12493,1,0,4,0,-4
12494,1,0,35,0,-35
12495,1,1,617,1572,955
12496,0,0,47,0,-47
12497,0,0,31,0,-31
12498,0,0,27,0,-27
12499,0,0,39,0,-39
12500,0,0,28,0,-28
12501,0,0,14,0,-14
12502,0,0,369,0,-369
12503,1,0,37,0,-37
12504,1,0,41,0,-41
12505,0,0,54,0,-54
12506,0,0,47,0,-47
12507,1,0,50,0,-50
12508,1,0,23,0,-23
12509,0,0,20,0,-20
12510,0,0,10,0,-10
12511,1,0,22,0,-22
12512,1,0,57,0,-57
12513,1,1,824,1265,441
12514,0,0,138,0,-138
12515,1,1,668,1406,738
12516,1,0,9,0,-9
12517,0,0,75,0,-75
12518,1,1,388,1841,1453
12519,0,0,4,0,-4
12520,1,1,180,1757,1577
12521,0,0,9,0,-9
12522,0,0,27,0,-27
12523,1,0,100,0,-100
12524,0,0,68,0,-68
12525,0,0,47,0,-47
12526,1,0,42,0,-42
12527,1,1,288,1792,1504
12528,0,0,95,0,-95
12529,0,0,12,0,-12
12530,0,0,44,0,-44
12531,1,0,272,0,-272
12532,0,0,65,0,-65
12533,0,0,61,0,-61
12534,1,1,674,1514,840
12535,0,0,66,0,-66
12536,1,1,380,1653,1273
12537,1,0,13,0,-13
12538,0,0,137,0,-137
12539,0,0,40,0,-40
12540,1,0,18,0,-18
12541,1,1,2913,2010,-903
12542,0,0,63,0,-63
12543,1,1,749,1501,752
12544,0,0,13,0,-13
12545,0,0,54,0,-54
12546,1,0,42,0,-42
12547,1,1,269,1358,1089
12548,1,1,573,1449,876
12549,0,0,74,0,-74
12550,1,1,157,1333,1176
12551,1,0,24,0,-24
12552,1,1,329,1390,1061
12553,1,1,1664,1813,149
12554,0,0,15,0,-15
12555,1,0,31,0,-31
12556,1,1,362,1269,907
12557,0,0,8,0,-8
12558,1,1,67,1702,1635
12559,1,0,36,0,-36
12560,1,1,1206,2218,1012
12561,1,0,19,0,-19
12562,1,1,46,1683,1637
12563,0,0,19,0,-19
12564,0,0,29,0,-29
12565,0,0,67,0,-67
12566,0,0,13,0,-13
12567,0,0,5,0,-5
12568,1,0,137,0,-137
12569,1,1,648,1809,1161
12570,0,0,27,0,-27
12571,1,1,484,1263,779
12572,0,0,50,0,-50
12573,1,1,255,2534,2279
12574,0,0,58,0,-58
12575,0,0,47,0,-47
12576,0,0,133,0,-133
12577,1,1,301,1265,964
12578,1,0,95,0,-95
12579,1,0,114,0,-114
12580,1,1,39,1240,1201
12581,1,1,499,1450,951
12582,1,1,768,2438,1670
12583,0,0,76,0,-76
12584,0,0,64,0,-64
12585,1,1,445,1501,1056
12586,1,1,1457,1291,-166
12587,0,0,55,0,-55
12588,1,0,70,0,-70
12589,1,0,19,0,-19
12590,0,0,3,0,-3
12591,0,0,36,0,-36
12592,0,0,97,0,-97
12593,1,1,709,1571,862
12594,0,0,47,0,-47
12595,0,0,8,0,-8
12596,1,1,133,2252,2119
12597,1,0,24,0,-24
12598,0,0,80,0,-80
12599,1,1,873,1412,539
12600,0,0,37,0,-37
12601,1,1,446,1235,789
12602,0,0,103,0,-103
12603,1,1,311,1257,946
12604,0,0,24,0,-24
12605,1,1,252,2689,2437
12606,1,1,967,1308,341
12607,1,1,717,1326,609
12608,1,0,208,0,-208
12609,0,0,41,0,-41
12610,0,0,60,0,-60
12611,0,0,25,0,-25
12612,1,0,4,0,-4
12613,0,0,11,0,-11
12614,1,0,58,0,-58
12615,1,0,14,0,-14
12616,0,0,8,0,-8
12617,1,1,294,1281,987
12618,1,0,6,0,-6
12619,1,1,92,1450,1358
12620,1,0,9,0,-9
12621,0,0,20,0,-20
12622,1,0,21,0,-21
12623,1,0,9,0,-9
12624,0,0,25,0,-25
12625,0,0,94,0,-94
12626,0,0,5,0,-5
12627,1,1,654,2215,1561
12628,0,0,36,0,-36
12629,1,1,409,1738,1329
12630,1,1,352,1299,947
12631,0,0,25,0,-25
12632,1,0,58,0,-58
12633,1,1,79,1235,1156
12634,1,0,95,0,-95
12635,1,0,63,0,-63
12636,1,0,106,0,-106
12637,0,0,8,0,-8
12638,1,1,262,1468,1206
12639,1,1,411,1275,864
12640,1,1,266,1236,970
12641,0,0,30,0,-30
12642,0,0,33,0,-33
12643,0,0,62,0,-62
12644,1,0,65,0,-65
12645,1,1,299,1569,1270
12646,0,0,87,0,-87
12647,0,0,16,0,-16
12648,0,0,50,0,-50
12649,0,0,288,0,-288
12650,1,1,256,1821,1565
12651,1,0,38,0,-38
12652,0,0,10,0,-10
12653,1,0,194,0,-194
12654,0,0,20,0,-20
12655,1,1,118,1579,1461
12656,0,0,8,0,-8
12657,1,1,368,1328,960
12658,1,0,81,0,-81
12659,0,0,8,0,-8
12660,0,0,51,0,-51
12661,1,1,613,1420,807
12662,1,0,48,0,-48
12663,0,0,10,0,-10
12664,1,1,225,1287,1062
12665,1,1,158,1825,1667
12666,1,1,588,1431,843
12667,1,0,148,0,-148
12668,0,0,91,0,-91
12669,1,1,216,1267,1051
12670,1,1,562,1350,788
12671,0,0,5,0,-5
12672,1,0,14,0,-14
12673,1,0,33,0,-33
12674,0,0,21,0,-21
12675,1,0,9,0,-9
12676,0,0,19,0,-19
12677,1,0,105,0,-105
12678,1,1,146,1785,1639
12679,1,0,86,0,-86
12680,1,0,24,0,-24
12681,0,0,22,0,-22
12682,1,1,519,1651,1132
12683,1,1,638,1282,644
12684,1,1,1722,1515,-207
12685,1,0,5,0,-5
12686,1,0,54,0,-54
12687,1,1,598,1382,784
12688,1,1,982,1493,511
12689,1,0,115,0,-115
12690,1,0,53,0,-53
12691,0,0,23,0,-23
12692,1,1,130,1402,1272
12693,1,1,1033,1278,245
12694,0,0,70,0,-70
12695,1,0,9,0,-9
12696,1,0,8,0,-8
12697,0,0,1,0,-1
12698,1,0,75,0,-75
12699,1,0,27,0,-27
12700,1,1,2518,1640,-878
12701,0,0,9,0,-9
12702,1,1,457,1705,1248
12703,0,0,87,0,-87
12704,1,0,0,0,0
12705,1,0,73,0,-73
12706,1,1,1451,2050,599
12707,0,0,5,0,-5
12708,0,0,4,0,-4
12709,1,0,62,0,-62
12710,1,1,614,1709,1095
12711,1,0,17,0,-17
12712,0,0,12,0,-12
12713,0,0,67,0,-67
12714,1,0,137,0,-137
12715,1,1,230,2684,2454
12716,1,1,2562,1255,-1307
12717,0,0,46,0,-46
12718,0,0,73,0,-73
12719,0,0,116,0,-116
12720,0,0,86,0,-86
12721,1,0,97,0,-97
12722,1,1,610,2562,1952
12723,1,0,77,0,-77
12724,1,0,51,0,-51
12725,1,0,28,0,-28
12726,1,1,405,1249,844
12727,0,0,58,0,-58
12728,1,1,331,1538,1207
12729,0,0,73,0,-73
12730,0,0,39,0,-39
12731,1,0,34,0,-34
12732,1,0,8,0,-8
12733,1,0,11,0,-11
12734,1,0,130,0,-130
12735,0,0,70,0,-70
12736,0,0,74,0,-74
12737,1,1,93,4632,4539
12738,0,0,82,0,-82
12739,1,1,254,1422,1168
12740,1,1,729,1569,840
12741,1,1,658,1303,645
12742,1,0,7,0,-7
12743,1,1,178,1257,1079
12744,0,0,12,0,-12
12745,0,0,17,0,-17
12746,0,0,3,0,-3
12747,0,0,145,0,-145
12748,1,0,32,0,-32
12749,1,0,10,0,-10
12750,1,1,110,1348,1238
12751,0,0,9,0,-9
12752,0,0,0,0,0
12753,0,0,12,0,-12
12754,0,0,8,0,-8
12755,1,1,726,1506,780
12756,1,0,77,0,-77
12757,1,0,12,0,-12
12758,1,1,918,1682,764
12759,1,1,286,1270,984
12760,0,0,7,0,-7
12761,1,1,207,1343,1136
12762,1,1,779,1966,1187
12763,0,0,11,0,-11
12764,1,0,210,0,-210
12765,1,0,144,0,-144
12766,0,0,30,0,-30
12767,1,0,7,0,-7
12768,1,1,458,1249,791
12769,1,1,175,1306,1131
12770,0,0,29,0,-29
12771,0,0,24,0,-24
12772,1,0,34,0,-34
12773,1,0,77,0,-77
12774,1,0,31,0,-31
12775,0,0,232,0,-232
12776,1,0,128,0,-128
12777,1,0,41,0,-41
12778,1,0,24,0,-24
12779,0,0,22,0,-22
12780,1,0,10,0,-10
12781,0,0,0,0,0
12782,1,0,118,0,-118
12783,1,0,52,0,-52
12784,0,0,24,0,-24
12785,0,0,4,0,-4
12786,0,0,9,0,-9
12787,1,0,18,0,-18
12788,1,0,38,0,-38
12789,0,0,7,0,-7
12790,0,0,22,0,-22
12791,0,0,48,0,-48
12792,0,0,27,0,-27
12793,1,0,43,0,-43
12794,1,1,633,1941,1308
12795,0,0,37,0,-37
12796,0,0,47,0,-47
12797,0,0,8,0,-8
12798,1,0,34,0,-34
12799,0,0,78,0,-78
12800,1,0,98,0,-98
12801,1,0,1,0,-1
12802,1,0,56,0,-56
12803,1,1,306,1275,969
12804,0,0,8,0,-8
12805,0,0,102,0,-102
12806,0,0,18,0,-18
12807,0,0,290,0,-290
12808,1,1,283,2671,2388
12809,1,0,186,0,-186
12810,1,0,158,0,-158
12811,1,0,74,0,-74
12812,1,1,191,1287,1096
12813,1,0,70,0,-70
12814,1,0,5,0,-5
12815,1,1,166,1560,1394
12816,1,1,268,1271,1003
12817,0,0,28,0,-28
12818,1,0,1,0,-1
12819,1,1,103,2016,1913
12820,1,0,46,0,-46
12821,1,0,32,0,-32
12822,1,1,103,1308,1205
12823,1,0,18,0,-18
12824,0,0,18,0,-18
12825,1,1,163,1806,1643
12826,1,1,148,1794,1646
12827,1,0,16,0,-16
12828,0,0,14,0,-14
12829,0,0,18,0,-18
12830,1,1,803,1521,718
12831,1,0,4,0,-4
12832,1,1,656,1570,914
12833,1,1,115,1462,1347
12834,0,0,219,0,-219
12835,0,0,315,0,-315
12836,1,0,23,0,-23
12837,1,1,169,3214,3045
12838,0,0,181,0,-181
12839,1,1,499,2099,1600
12840,1,0,118,0,-118
12841,0,0,89,0,-89
12842,1,0,100,0,-100
12843,1,0,57,0,-57
12844,1,1,496,2168,1672
12845,0,0,15,0,-15
12846,1,0,22,0,-22
12847,0,0,79,0,-79
12848,0,0,37,0,-37
12849,0,0,13,0,-13
12850,1,0,117,0,-117
12851,1,0,58,0,-58
12852,1,0,40,0,-40
12853,0,0,54,0,-54
12854,1,0,0,0,0
12855,1,1,599,1714,1115
12856,0,0,61,0,-61
12857,0,0,18,0,-18
12858,1,0,65,0,-65
12859,0,0,34,0,-34
12860,1,0,25,0,-25
12861,1,1,564,1336,772
12862,1,1,414,1863,1449
12863,0,0,146,0,-146
12864,1,0,10,0,-10
12865,1,1,839,1439,600
12866,0,0,84,0,-84
12867,1,0,89,0,-89
12868,1,1,649,1520,871
12869,1,1,104,1248,1144
12870,0,0,8,0,-8
12871,1,1,1062,1435,373
12872,0,0,18,0,-18
12873,1,0,133,0,-133
12874,1,0,27,0,-27
12875,0,0,6,0,-6
12876,1,1,559,1308,749
12877,0,0,65,0,-65
12878,1,1,694,2525,1831
12879,0,0,67,0,-67
12880,1,0,35,0,-35
12881,0,0,72,0,-72
12882,0,0,53,0,-53
12883,0,0,12,0,-12
12884,1,1,250,1544,1294
12885,1,0,44,0,-44
12886,0,0,107,0,-107
12887,1,1,975,1918,943
12888,1,1,760,3459,2699
12889,1,0,56,0,-56
12890,0,0,112,0,-112
12891,0,0,3,0,-3
12892,0,0,17,0,-17
12893,1,0,11,0,-11
12894,1,0,130,0,-130
12895,1,0,150,0,-150
12896,1,0,25,0,-25
12897,0,0,36,0,-36
12898,1,0,77,0,-77
12899,1,0,7,0,-7
12900,1,0,68,0,-68
12901,1,0,1,0,-1
12902,1,0,32,0,-32
12903,1,0,4,0,-4
12904,1,1,2283,1928,-355
12905,1,0,21,0,-21
12906,1,1,87,1237,1150
12907,0,0,28,0,-28
12908,0,0,31,0,-31
12909,0,0,31,0,-31
12910,0,0,88,0,-88
12911,1,0,79,0,-79
12912,1,0,79,0,-79
12913,0,0,61,0,-61
12914,1,1,442,1292,850
12915,0,0,71,0,-71
12916,1,0,14,0,-14
12917,1,1,409,1505,1096
12918,0,0,125,0,-125
12919,1,0,43,0,-43
12920,1,1,64,2347,2283
12921,1,1,372,1235,863
12922,0,0,37,0,-37
12923,0,0,1,0,-1
12924,1,1,423,2288,1865
12925,1,1,532,1668,1136
12926,0,0,32,0,-32
12927,1,1,233,1891,1658
12928,0,0,33,0,-33
12929,1,1,956,1445,489
12930,0,0,5,0,-5
12931,1,0,33,0,-33
12932,1,1,27,1307,1280
12933,0,0,103,0,-103
12934,1,1,171,1310,1139
12935,1,0,62,0,-62
12936,1,0,18,0,-18
12937,1,1,643,1547,904
12938,1,0,59,0,-59
12939,1,0,139,0,-139
12940,0,0,44,0,-44
12941,1,0,41,0,-41
12942,1,1,852,1333,481
12943,0,0,68,0,-68
12944,0,0,11,0,-11
12945,0,0,23,0,-23
12946,1,1,337,1346,1009
12947,0,0,3,0,-3
12948,0,0,54,0,-54
12949,1,1,828,1332,504
12950,1,0,1,0,-1
12951,0,0,31,0,-31
12952,1,1,923,1632,709
12953,0,0,61,0,-61
12954,0,0,4,0,-4
12955,1,1,25,1397,1372
12956,1,1,119,1404,1285
12957,0,0,55,0,-55
12958,0,0,9,0,-9
12959,0,0,50,0,-50
12960,1,0,101,0,-101
12961,1,0,85,0,-85
12962,0,0,30,0,-30
12963,1,1,1216,1481,265
12964,0,0,16,0,-16
12965,1,1,361,2337,1976
12966,0,0,95,0,-95
12967,1,0,4,0,-4
12968,1,0,66,0,-66
12969,1,0,33,0,-33
12970,1,1,350,1742,1392
12971,1,1,105,1837,1732
12972,0,0,7,0,-7
12973,1,1,242,1323,1081
12974,1,0,33,0,-33
12975,1,1,301,1541,1240
12976,1,1,795,2247,1452
12977,0,0,5,0,-5
12978,1,0,27,0,-27
12979,1,1,1312,2097,785
12980,0,0,98,0,-98
12981,1,1,89,1434,1345
12982,0,0,27,0,-27
12983,1,1,301,2022,1721
12984,1,0,7,0,-7
12985,1,1,313,1243,930
12986,1,1,2289,2320,31
12987,0,0,146,0,-146
12988,0,0,59,0,-59
12989,1,1,757,1339,582
12990,1,1,424,1835,1411
12991,0,0,90,0,-90
12992,1,1,130,1381,1251
12993,0,0,68,0,-68
12994,0,0,64,0,-64
12995,0,0,32,0,-32
12996,1,1,342,1411,1069
12997,0,0,38,0,-38
12998,0,0,139,0,-139
12999,1,1,389,1270,881
13000,0,0,68,0,-68
13001,1,1,1217,1457,240
13002,1,0,38,0,-38
13003,1,0,45,0,-45
13004,0,0,29,0,-29
13005,1,0,80,0,-80
13006,0,0,111,0,-111
13007,1,0,23,0,-23
13008,1,0,36,0,-36
13009,0,0,24,0,-24
13010,1,1,330,3743,3413
13011,1,0,250,0,-250
13012,0,0,9,0,-9
13013,1,1,182,1421,1239
13014,1,1,826,1290,464
13015,1,0,2,0,-2
13016,1,0,46,0,-46
13017,1,0,21,0,-21
13018,0,0,24,0,-24
13019,1,1,98,2411,2313
13020,1,0,7,0,-7
13021,1,1,1510,1551,41
13022,1,1,607,1416,809
13023,0,0,98,0,-98
13024,1,0,21,0,-21
13025,1,0,30,0,-30
13026,1,1,416,1289,873
13027,0,0,49,0,-49
13028,1,1,295,1631,1336
13029,0,0,93,0,-93
13030,0,0,34,0,-34
13031,1,0,55,0,-55
13032,0,0,62,0,-62
13033,0,0,46,0,-46
13034,0,0,23,0,-23
13035,1,0,39,0,-39
13036,1,1,107,1561,1454
13037,0,0,6,0,-6
13038,1,0,36,0,-36
13039,0,0,37,0,-37
13040,1,1,201,2193,1992
13041,0,0,1,0,-1
13042,1,0,11,0,-11
13043,0,0,30,0,-30
13044,0,0,56,0,-56
13045,0,0,28,0,-28
13046,0,0,49,0,-49
13047,0,0,81,0,-81
13048,1,1,89,1454,1365
13049,0,0,85,0,-85
13050,1,0,69,0,-69
13051,0,0,11,0,-11
13052,1,1,1418,1433,15
13053,0,0,60,0,-60
13054,0,0,80,0,-80
13055,0,0,33,0,-33
13056,1,1,102,1336,1234
13057,0,0,42,0,-42
13058,0,0,83,0,-83
13059,1,0,251,0,-251
13060,1,0,3,0,-3
13061,0,0,20,0,-20
13062,0,0,7,0,-7
13063,0,0,81,0,-81
13064,0,0,53,0,-53
13065,0,0,20,0,-20
13066,0,0,13,0,-13
13067,1,1,591,1252,661
13068,1,0,4,0,-4
13069,0,0,17,0,-17
13070,0,0,22,0,-22
13071,1,1,346,1661,1315
13072,1,1,1665,1332,-333
13073,1,1,657,1521,864
13074,0,0,10,0,-10
13075,1,1,622,1530,908
13076,1,1,1753,1790,37
13077,1,1,923,1799,876
13078,1,1,218,1333,1115
13079,1,0,30,0,-30
13080,1,1,201,1912,1711
13081,1,0,60,0,-60
13082,0,0,7,0,-7
13083,1,1,680,2053,1373
13084,1,1,1644,1377,-267
13085,0,0,29,0,-29
13086,0,0,97,0,-97
13087,0,0,26,0,-26
13088,1,0,112,0,-112
13089,0,0,49,0,-49
13090,0,0,59,0,-59
13091,0,0,104,0,-104
13092,0,0,4,0,-4
13093,1,1,1082,1399,317
13094,1,0,48,0,-48
13095,0,0,60,0,-60
13096,1,0,26,0,-26
13097,1,1,79,1406,1327
13098,1,1,1245,2277,1032
13099,0,0,20,0,-20
13100,0,0,106,0,-106
13101,0,0,154,0,-154
13102,1,0,41,0,-41
13103,1,0,89,0,-89
13104,1,1,1325,1756,431
13105,1,0,10,0,-10
13106,1,0,16,0,-16
13107,0,0,91,0,-91
13108,0,0,16,0,-16
13109,1,0,22,0,-22
13110,1,0,114,0,-114
13111,1,0,60,0,-60
13112,1,1,56,1936,1880
13113,0,0,44,0,-44
13114,1,0,62,0,-62
13115,1,0,15,0,-15
13116,0,0,34,0,-34
13117,0,0,58,0,-58
13118,1,0,72,0,-72
13119,0,0,2,0,-2
13120,0,0,75,0,-75
13121,0,0,98,0,-98
13122,1,0,44,0,-44
13123,0,0,58,0,-58
13124,1,1,324,1273,949
13125,1,1,44,1436,1392
13126,1,1,557,1244,687
13127,1,0,144,0,-144
13128,0,0,127,0,-127
13129,1,0,93,0,-93
13130,1,0,9,0,-9
13131,1,1,858,1298,440
13132,1,0,19,0,-19
13133,0,0,33,0,-33
13134,0,0,43,0,-43
13135,1,0,18,0,-18
13136,0,0,47,0,-47
13137,0,0,9,0,-9
13138,1,0,28,0,-28
13139,1,1,450,1509,1059
13140,0,0,112,0,-112
13141,1,0,32,0,-32
13142,1,0,94,0,-94
13143,0,0,21,0,-21
13144,1,0,28,0,-28
13145,1,1,1014,1246,232
13146,1,0,58,0,-58
13147,0,0,38,0,-38
13148,1,0,76,0,-76
13149,1,1,781,2182,1401
13150,1,0,0,0,0
13151,1,0,75,0,-75
13152,1,0,78,0,-78
13153,1,1,1007,1326,319
13154,1,1,268,1401,1133
13155,1,1,425,4114,3689
13156,0,0,2,0,-2
13157,1,0,74,0,-74
13158,0,0,1,0,-1
13159,0,0,109,0,-109
13160,0,0,15,0,-15
13161,1,1,693,2305,1612
13162,1,0,75,0,-75
13163,1,0,14,0,-14
13164,1,0,3,0,-3
13165,1,1,97,1301,1204
13166,0,0,123,0,-123
13167,0,0,56,0,-56
13168,1,0,8,0,-8
13169,1,1,192,1568,1376
13170,1,1,208,1268,1060
13171,1,0,40,0,-40
13172,1,0,143,0,-143
13173,1,1,153,2199,2046
13174,1,1,21,1303,1282
13175,0,0,25,0,-25
13176,1,0,7,0,-7
13177,0,0,104,0,-104
13178,1,0,3,0,-3
13179,1,1,102,1710,1608
13180,0,0,41,0,-41
13181,0,0,61,0,-61
13182,1,1,31,1460,1429
13183,1,0,29,0,-29
13184,0,0,27,0,-27
13185,1,0,0,0,0
13186,0,0,26,0,-26
13187,1,1,423,1280,857
13188,0,0,16,0,-16
13189,1,1,1654,1595,-59
13190,1,0,306,0,-306
13191,0,0,52,0,-52
13192,1,0,22,0,-22
13193,1,1,669,2093,1424
13194,1,0,85,0,-85
13195,1,1,845,1909,1064
13196,1,0,76,0,-76
13197,0,0,0,0,0
13198,1,0,12,0,-12
13199,0,0,121,0,-121
13200,0,0,53,0,-53
13201,0,0,34,0,-34
13202,1,0,47,0,-47
13203,0,0,224,0,-224
13204,1,0,15,0,-15
13205,1,1,427,3370,2943
13206,1,0,24,0,-24
13207,0,0,93,0,-93
13208,1,0,43,0,-43
13209,0,0,38,0,-38
13210,1,1,1662,1981,319
13211,0,0,18,0,-18
13212,0,0,67,0,-67
13213,1,1,163,1255,1092
13214,1,1,827,1455,628
13215,1,1,682,1668,986
13216,1,0,25,0,-25
13217,0,0,67,0,-67
13218,0,0,196,0,-196
13219,0,0,3,0,-3
13220,0,0,66,0,-66
13221,0,0,10,0,-10
13222,1,1,137,1613,1476
13223,1,0,142,0,-142
13224,0,0,52,0,-52
13225,1,0,4,0,-4
13226,1,1,564,1442,878
13227,1,0,1,0,-1
13228,1,0,73,0,-73
13229,1,1,611,1602,991
13230,0,0,1,0,-1
13231,0,0,7,0,-7
13232,1,0,0,0,0
13233,1,1,835,1486,651
13234,0,0,71,0,-71
13235,1,0,20,0,-20
13236,0,0,12,0,-12
13237,1,1,129,1548,1419
13238,1,0,51,0,-51
13239,0,0,117,0,-117
13240,0,0,2,0,-2
13241,1,1,1087,1295,208
13242,0,0,105,0,-105
13243,1,0,33,0,-33
13244,0,0,20,0,-20
13245,0,0,38,0,-38
13246,0,0,9,0,-9
13247,1,0,1,0,-1
13248,0,0,121,0,-121
13249,1,0,76,0,-76
13250,1,1,1417,1706,289
13251,0,0,25,0,-25
13252,0,0,21,0,-21
13253,1,0,243,0,-243
13254,0,0,1,0,-1
13255,1,0,53,0,-53
13256,1,1,156,2849,2693
13257,0,0,19,0,-19
13258,1,0,26,0,-26
13259,1,1,866,1357,491
13260,0,0,60,0,-60
13261,1,0,4,0,-4
13262,0,0,32,0,-32
13263,1,1,302,1430,1128
13264,0,0,10,0,-10
13265,1,1,362,1720,1358
13266,1,0,100,0,-100
13267,1,1,213,1389,1176
13268,1,0,8,0,-8
13269,1,0,35,0,-35
13270,1,0,70,0,-70
13271,1,0,89,0,-89
13272,1,1,532,1485,953
13273,1,1,422,1288,866
13274,1,0,76,0,-76
13275,0,0,20,0,-20
13276,1,0,136,0,-136
13277,1,0,1,0,-1
13278,1,1,384,1460,1076
13279,0,0,5,0,-5
13280,1,0,108,0,-108
13281,1,1,1102,1287,185
13282,0,0,38,0,-38
13283,0,0,62,0,-62
13284,1,0,88,0,-88
13285,1,0,58,0,-58
13286,1,1,234,1322,1088
13287,0,0,35,0,-35
13288,0,0,6,0,-6
13289,0,0,12,0,-12
13290,0,0,54,0,-54
13291,1,0,47,0,-47
13292,1,1,439,1558,1119
13293,1,0,60,0,-60
13294,0,0,170,0,-170
13295,1,0,26,0,-26
13296,0,0,69,0,-69
13297,1,0,16,0,-16
13298,1,1,695,1757,1062
13299,1,1,637,1706,1069
13300,1,1,659,1250,591
13301,0,0,21,0,-21
13302,1,0,50,0,-50
13303,1,0,5,0,-5
13304,1,0,93,0,-93
13305,1,1,711,2250,1539
13306,0,0,386,0,-386
13307,0,0,4,0,-4
13308,1,1,1892,1327,-565
13309,1,1,69,1399,1330
13310,1,1,1959,2038,79
13311,1,0,6,0,-6
13312,1,0,123,0,-123
13313,1,1,411,1271,860
13314,0,0,210,0,-210
13315,1,0,60,0,-60
13316,1,0,8,0,-8
13317,1,1,332,1752,1420
13318,1,0,3,0,-3
13319,1,1,159,1796,1637
13320,1,0,10,0,-10
13321,1,0,61,0,-61
13322,1,0,3,0,-3
13323,0,0,55,0,-55
13324,1,1,383,1378,995
13325,1,1,240,2544,2304
13326,1,0,32,0,-32
13327,0,0,99,0,-99
13328,0,0,8,0,-8
13329,1,0,37,0,-37
13330,1,0,25,0,-25
13331,1,0,92,0,-92
13332,0,0,65,0,-65
13333,0,0,98,0,-98
13334,1,0,127,0,-127
13335,1,0,6,0,-6
13336,1,1,1233,1331,98
13337,1,0,1,0,-1
13338,1,0,46,0,-46
13339,0,0,13,0,-13
13340,0,0,18,0,-18
13341,0,0,116,0,-116
13342,1,1,1428,1427,-1
13343,1,0,71,0,-71
13344,1,1,498,2230,1732
13345,1,1,446,1289,843
13346,1,1,851,1430,579
13347,0,0,8,0,-8
13348,0,0,29,0,-29
13349,1,0,13,0,-13
13350,1,0,80,0,-80
13351,1,0,21,0,-21
13352,0,0,93,0,-93
13353,1,0,7,0,-7
13354,0,0,85,0,-85
13355,0,0,16,0,-16
13356,1,1,389,1267,878
13357,1,0,90,0,-90
13358,0,0,21,0,-21
13359,1,1,536,2768,2232
13360,1,1,681,1358,677
13361,0,0,65,0,-65
13362,0,0,7,0,-7
13363,0,0,54,0,-54
13364,1,1,214,2134,1920
13365,1,0,34,0,-34
13366,1,0,30,0,-30
13367,1,1,522,1993,1471
13368,0,0,114,0,-114
13369,1,1,473,1324,851
13370,0,0,19,0,-19
13371,0,0,80,0,-80
13372,1,1,1569,1559,-10
13373,1,0,14,0,-14
13374,1,0,33,0,-33
13375,1,1,810,1818,1008
13376,1,1,526,1410,884
13377,1,1,573,1274,701
13378,0,0,85,0,-85
13379,0,0,3,0,-3
13380,0,0,33,0,-33
13381,1,1,225,1282,1057
13382,1,0,164,0,-164
13383,1,0,0,0,0
13384,0,0,26,0,-26
13385,1,1,271,1266,995
13386,0,0,60,0,-60
13387,1,0,44,0,-44
13388,0,0,9,0,-9
13389,1,0,15,0,-15
13390,1,0,33,0,-33
13391,1,0,112,0,-112
13392,0,0,18,0,-18
13393,0,0,115,0,-115
13394,1,0,50,0,-50
13395,1,0,7,0,-7
13396,1,1,204,1359,1155
13397,0,0,179,0,-179
13398,0,0,68,0,-68
13399,1,1,316,2905,2589
13400,1,0,3,0,-3
13401,1,1,222,2325,2103
13402,0,0,32,0,-32
13403,1,0,20,0,-20
13404,1,0,8,0,-8
13405,1,1,207,1281,1074
13406,1,1,955,1360,405
13407,1,1,111,1467,1356
13408,0,0,13,0,-13
13409,1,0,84,0,-84
13410,1,0,62,0,-62
13411,0,0,6,0,-6
13412,1,1,1705,1497,-208
13413,1,1,861,2233,1372
13414,0,0,27,0,-27
13415,0,0,41,0,-41
13416,0,0,59,0,-59
13417,0,0,74,0,-74
13418,1,1,118,1371,1253
13419,1,1,100,1950,1850
13420,0,0,150,0,-150
13421,1,1,203,1278,1075
13422,0,0,2,0,-2
13423,1,0,15,0,-15
13424,0,0,102,0,-102
13425,1,1,629,1672,1043
13426,0,0,145,0,-145
13427,0,0,56,0,-56
13428,0,0,104,0,-104
13429,0,0,45,0,-45
13430,0,0,65,0,-65
13431,0,0,96,0,-96
13432,1,0,40,0,-40
13433,0,0,12,0,-12
13434,1,1,702,1463,761
13435,0,0,48,0,-48
13436,0,0,51,0,-51
13437,1,0,10,0,-10
13438,1,1,47,2628,2581
13439,1,1,489,2923,2434
13440,1,1,666,1298,632
13441,1,0,166,0,-166
13442,1,1,399,2270,1871
13443,0,0,75,0,-75
13444,1,1,603,1824,1221
13445,0,0,41,0,-41
13446,1,1,227,2169,1942
13447,1,0,22,0,-22
13448,1,0,28,0,-28
13449,1,0,3,0,-3
13450,0,0,27,0,-27
13451,0,0,2,0,-2
13452,1,0,36,0,-36
13453,0,0,238,0,-238
13454,1,1,1042,1271,229
13455,0,0,6,0,-6
13456,0,0,49,0,-49
13457,1,0,18,0,-18
13458,0,0,65,0,-65
13459,1,0,62,0,-62
13460,1,1,918,1836,918
13461,0,0,12,0,-12
13462,0,0,13,0,-13
13463,0,0,22,0,-22
13464,1,1,364,1284,920
13465,1,0,24,0,-24
13466,1,1,1349,1863,514
13467,1,1,1657,1244,-413
13468,0,0,16,0,-16
13469,1,1,346,1292,946
13470,1,0,210,0,-210
13471,1,0,30,0,-30
13472,0,0,23,0,-23
13473,1,1,426,2956,2530
13474,0,0,77,0,-77
13475,1,0,9,0,-9
13476,1,1,1255,1338,83
13477,0,0,14,0,-14
13478,1,0,64,0,-64
13479,1,1,397,1984,1587
13480,0,0,82,0,-82
13481,1,0,1,0,-1
13482,1,0,58,0,-58
13483,0,0,93,0,-93
13484,1,0,55,0,-55
13485,1,1,516,1511,995
13486,0,0,543,0,-543
13487,0,0,66,0,-66
13488,1,0,36,0,-36
13489,1,0,22,0,-22
13490,0,0,5,0,-5
13491,1,0,74,0,-74
13492,0,0,5,0,-5
13493,0,0,59,0,-59
13494,1,0,44,0,-44
13495,1,0,9,0,-9
13496,0,0,18,0,-18
13497,0,0,2,0,-2
13498,1,0,70,0,-70
13499,1,1,1668,1494,-174
13500,0,0,85,0,-85
13501,0,0,55,0,-55
13502,0,0,15,0,-15
13503,0,0,36,0,-36
13504,0,0,20,0,-20
13505,1,1,233,1285,1052
13506,0,0,18,0,-18
13507,1,1,1529,1520,-9
13508,0,0,29,0,-29
13509,1,0,54,0,-54
13510,1,0,181,0,-181
13511,1,0,208,0,-208
13512,1,0,6,0,-6
13513,1,1,106,1575,1469
13514,0,0,54,0,-54
13515,0,0,33,0,-33
13516,1,0,59,0,-59
13517,0,0,52,0,-52
13518,1,0,34,0,-34
13519,1,1,488,1346,858
13520,1,1,48,1973,1925
13521,0,0,19,0,-19
13522,0,0,7,0,-7
13523,0,0,15,0,-15
13524,0,0,80,0,-80
13525,1,1,1175,1545,370
13526,0,0,18,0,-18
13527,0,0,57,0,-57
13528,1,0,68,0,-68
13529,0,0,171,0,-171
13530,1,0,227,0,-227
13531,1,1,282,3840,3558
13532,0,0,56,0,-56
13533,1,1,2349,1506,-843
13534,1,1,458,1506,1048
13535,0,0,1,0,-1
13536,1,0,92,0,-92
13537,1,0,30,0,-30
13538,1,1,120,1800,1680
13539,1,1,488,1339,851
13540,0,0,78,0,-78
13541,0,0,6,0,-6
13542,0,0,13,0,-13
13543,1,1,238,1287,1049
13544,0,0,32,0,-32
13545,1,1,602,1778,1176
13546,1,1,128,1545,1417
13547,0,0,119,0,-119
13548,1,1,395,1255,860
13549,0,0,121,0,-121
13550,1,1,2638,1774,-864
13551,1,1,581,1378,797
13552,1,1,265,1305,1040
13553,0,0,42,0,-42
13554,0,0,95,0,-95
13555,1,1,453,1509,1056
13556,1,0,3,0,-3
13557,1,0,6,0,-6
13558,0,0,28,0,-28
13559,0,0,10,0,-10
13560,1,1,1081,1682,601
13561,0,0,0,0,0
13562,1,0,17,0,-17
13563,1,1,215,2148,1933
13564,1,1,1106,1496,390
13565,1,1,324,1638,1314
13566,0,0,18,0,-18
13567,1,1,173,1498,1325
13568,1,1,235,1400,1165
13569,1,0,120,0,-120
13570,1,0,10,0,-10
13571,1,0,103,0,-103
13572,0,0,28,0,-28
13573,1,0,13,0,-13
13574,0,0,104,0,-104
13575,1,0,16,0,-16
13576,0,0,40,0,-40
13577,1,1,146,2009,1863
13578,1,0,12,0,-12
13579,0,0,9,0,-9
13580,1,1,439,1306,867
13581,1,0,3,0,-3
13582,0,0,58,0,-58
13583,0,0,109,0,-109
13584,1,1,436,1403,967
13585,0,0,116,0,-116
13586,0,0,77,0,-77
13587,0,0,158,0,-158
13588,1,0,81,0,-81
13589,0,0,29,0,-29
13590,0,0,8,0,-8
13591,0,0,31,0,-31
13592,1,0,51,0,-51
13593,0,0,34,0,-34
13594,1,1,611,1703,1092
13595,0,0,111,0,-111
13596,1,0,23,0,-23
13597,0,0,91,0,-91
13598,1,1,236,1347,1111
13599,0,0,92,0,-92
13600,1,0,33,0,-33
13601,0,0,35,0,-35
13602,1,1,649,1502,853
13603,0,0,17,0,-17
13604,0,0,42,0,-42
13605,1,1,343,1341,998
13606,1,0,2,0,-2
13607,1,0,57,0,-57
13608,1,0,18,0,-18
13609,0,0,60,0,-60
13610,0,0,43,0,-43
13611,1,0,5,0,-5
13612,0,0,17,0,-17
13613,1,1,618,2029,1411
13614,0,0,19,0,-19
13615,0,0,57,0,-57
13616,1,1,509,1368,859
13617,0,0,17,0,-17
13618,1,0,57,0,-57
13619,1,1,421,1764,1343
13620,1,1,1917,1809,-108
13621,0,0,32,0,-32
13622,0,0,0,0,0
13623,1,0,29,0,-29
13624,0,0,40,0,-40
13625,0,0,72,0,-72
13626,0,0,3,0,-3
13627,0,0,74,0,-74
13628,1,0,55,0,-55
13629,0,0,19,0,-19
13630,0,0,37,0,-37
13631,1,0,49,0,-49
13632,1,0,72,0,-72
13633,1,0,34,0,-34
13634,0,0,54,0,-54
13635,1,1,281,1380,1099
13636,0,0,36,0,-36
13637,1,1,724,2057,1333
13638,1,1,659,1458,799
13639,1,0,37,0,-37
13640,1,0,15,0,-15
13641,0,0,106,0,-106
13642,1,1,303,1564,1261
13643,0,0,161,0,-161
13644,0,0,1,0,-1
13645,0,0,4,0,-4
13646,1,0,5,0,-5
13647,0,0,17,0,-17
13648,0,0,138,0,-138
13649,1,1,658,1354,696
13650,0,0,37,0,-37
13651,1,1,695,1320,625
13652,1,1,177,1347,1170
13653,0,0,13,0,-13
13654,0,0,91,0,-91
13655,1,1,593,1380,787
13656,1,1,524,1273,749
13657,1,1,237,1471,1234
13658,1,1,413,1498,1085
13659,1,0,29,0,-29
13660,0,0,68,0,-68
13661,0,0,90,0,-90
13662,0,0,37,0,-37
13663,1,0,87,0,-87
13664,0,0,3,0,-3
13665,1,1,736,1774,1038
13666,1,0,49,0,-49
13667,1,0,53,0,-53
13668,0,0,45,0,-45
13669,0,0,26,0,-26
13670,1,1,237,1349,1112
13671,0,0,41,0,-41
13672,1,0,12,0,-12
13673,0,0,16,0,-16
13674,1,1,692,1292,600
13675,0,0,83,0,-83
13676,1,1,839,1297,458
13677,0,0,59,0,-59
13678,1,1,840,1306,466
13679,0,0,47,0,-47
13680,0,0,47,0,-47
13681,1,1,996,1351,355
13682,0,0,101,0,-101
13683,1,0,35,0,-35
13684,1,1,215,1623,1408
13685,0,0,43,0,-43
13686,1,0,63,0,-63
13687,0,0,14,0,-14
13688,0,0,3,0,-3
13689,0,0,84,0,-84
13690,1,1,824,1430,606
13691,0,0,100,0,-100
13692,1,0,21,0,-21
13693,1,0,3,0,-3
13694,0,0,36,0,-36
13695,1,0,24,0,-24
13696,0,0,71,0,-71
13697,1,1,565,1254,689
13698,0,0,12,0,-12
13699,0,0,78,0,-78
13700,1,1,1146,1481,335
13701,1,0,73,0,-73
13702,1,0,35,0,-35
13703,1,1,330,2106,1776
13704,0,0,21,0,-21
13705,1,1,325,2276,1951
13706,0,0,22,0,-22
13707,1,0,120,0,-120
13708,1,1,396,2152,1756
13709,0,0,37,0,-37
13710,0,0,17,0,-17
13711,1,1,1317,1363,46
13712,1,1,638,1495,857
13713,0,0,119,0,-119
13714,1,1,108,1614,1506
13715,0,0,159,0,-159
13716,0,0,18,0,-18
13717,0,0,45,0,-45
13718,1,0,140,0,-140
13719,0,0,56,0,-56
13720,0,0,7,0,-7
13721,0,0,48,0,-48
13722,1,0,47,0,-47
13723,0,0,18,0,-18
13724,1,0,12,0,-12
13725,0,0,100,0,-100
13726,1,1,458,1705,1247
13727,1,0,56,0,-56
13728,1,1,254,2016,1762
13729,1,0,7,0,-7
13730,1,1,362,1287,925
13731,1,0,12,0,-12
13732,1,1,619,1262,643
13733,1,1,405,1572,1167
13734,0,0,61,0,-61
13735,1,0,52,0,-52
13736,1,0,220,0,-220
13737,1,1,214,1328,1114
13738,1,1,54,1523,1469
13739,1,0,0,0,0
13740,0,0,32,0,-32
13741,1,1,151,1369,1218
13742,1,0,45,0,-45
13743,1,0,5,0,-5
13744,1,1,957,1519,562
13745,0,0,62,0,-62
13746,0,0,14,0,-14
13747,1,0,26,0,-26
13748,0,0,39,0,-39
13749,0,0,46,0,-46
13750,0,0,32,0,-32
13751,0,0,71,0,-71
13752,1,1,984,1337,353
13753,0,0,33,0,-33
13754,1,0,30,0,-30
13755,1,1,81,1423,1342
13756,1,1,1232,2125,893
13757,1,1,117,2074,1957
13758,0,0,5,0,-5
13759,0,0,90,0,-90
13760,0,0,87,0,-87
13761,1,1,218,1311,1093
13762,1,1,55,1593,1538
13763,1,1,41,1347,1306
13764,1,1,894,1333,439
13765,1,0,17,0,-17
13766,0,0,1,0,-1
13767,1,0,74,0,-74
13768,0,0,305,0,-305
13769,1,0,10,0,-10
13770,1,0,114,0,-114
13771,0,0,17,0,-17
13772,1,0,31,0,-31
13773,1,1,1798,1896,98
13774,0,0,14,0,-14
13775,0,0,38,0,-38
13776,0,0,0,0,0
13777,1,0,68,0,-68
13778,1,0,45,0,-45
13779,0,0,96,0,-96
13780,1,1,154,2112,1958
13781,1,0,53,0,-53
13782,0,0,61,0,-61
13783,1,1,316,1486,1170
13784,1,0,42,0,-42
13785,0,0,6,0,-6
13786,1,0,13,0,-13
13787,0,0,59,0,-59
13788,1,0,35,0,-35
13789,0,0,5,0,-5
13790,1,0,3,0,-3
13791,1,0,116,0,-116
13792,1,0,17,0,-17
13793,1,1,394,3088,2694
13794,0,0,32,0,-32
13795,0,0,115,0,-115
13796,1,0,66,0,-66
13797,0,0,30,0,-30
13798,1,0,82,0,-82
13799,1,1,585,1659,1074
13800,1,0,34,0,-34
13801,1,1,995,1874,879
13802,1,1,135,1485,1350
13803,1,0,23,0,-23
13804,1,1,813,1972,1159
13805,0,0,88,0,-88
13806,1,0,11,0,-11
13807,1,0,106,0,-106
13808,1,0,23,0,-23
13809,0,0,42,0,-42
13810,1,1,152,1304,1152
13811,0,0,155,0,-155
13812,1,0,7,0,-7
13813,0,0,14,0,-14
13814,1,0,34,0,-34
13815,0,0,31,0,-31
13816,1,0,144,0,-144
13817,0,0,36,0,-36
13818,0,0,12,0,-12
13819,1,1,202,2862,2660
13820,1,0,29,0,-29
13821,0,0,0,0,0
13822,0,0,133,0,-133
13823,1,1,1083,1380,297
13824,0,0,9,0,-9
13825,1,1,1522,1791,269
13826,0,0,24,0,-24
13827,0,0,66,0,-66
13828,1,0,50,0,-50
13829,0,0,2,0,-2
13830,0,0,131,0,-131
13831,1,1,158,1370,1212
13832,1,1,265,1247,982
13833,0,0,53,0,-53
13834,1,1,1194,1455,261
13835,0,0,82,0,-82
13836,0,0,177,0,-177
13837,1,1,855,1379,524
13838,1,1,865,1818,953
13839,0,0,39,0,-39
13840,0,0,31,0,-31
13841,1,1,472,1955,1483
13842,1,1,484,2320,1836
13843,0,0,45,0,-45
13844,0,0,91,0,-91
13845,0,0,20,0,-20
13846,0,0,14,0,-14
13847,1,0,24,0,-24
13848,0,0,24,0,-24
13849,1,0,76,0,-76
13850,1,1,458,1743,1285
13851,1,1,963,1649,686
13852,0,0,1,0,-1
13853,0,0,29,0,-29
13854,1,1,322,1412,1090
13855,0,0,58,0,-58
13856,1,0,14,0,-14
13857,1,1,299,1525,1226
13858,1,0,90,0,-90
13859,1,0,45,0,-45
13860,0,0,127,0,-127
13861,1,0,114,0,-114
13862,0,0,17,0,-17
13863,1,1,259,1315,1056
13864,0,0,15,0,-15
13865,1,0,66,0,-66
13866,0,0,98,0,-98
13867,0,0,15,0,-15
13868,1,0,30,0,-30
13869,1,1,608,1636,1028
13870,1,1,636,1237,601
13871,0,0,35,0,-35
13872,1,1,3253,1296,-1957
13873,1,0,89,0,-89
13874,0,0,67,0,-67
13875,0,0,51,0,-51
13876,1,0,94,0,-94
13877,0,0,55,0,-55
13878,1,0,62,0,-62
13879,0,0,22,0,-22
13880,1,0,122,0,-122
13881,0,0,9,0,-9
13882,1,1,272,1248,976
13883,0,0,71,0,-71
13884,1,0,11,0,-11
13885,1,0,49,0,-49
13886,1,0,3,0,-3
13887,1,0,52,0,-52
13888,0,0,5,0,-5
13889,0,0,6,0,-6
13890,0,0,115,0,-115
13891,1,1,951,1394,443
13892,0,0,55,0,-55
13893,0,0,116,0,-116
13894,1,1,103,1239,1136
13895,0,0,37,0,-37
13896,0,0,46,0,-46
13897,1,0,22,0,-22
13898,1,0,76,0,-76
13899,1,0,103,0,-103
13900,0,0,64,0,-64
13901,0,0,92,0,-92
13902,0,0,55,0,-55
13903,0,0,38,0,-38
13904,1,1,182,1516,1334
13905,1,0,10,0,-10
13906,1,1,564,1251,687
13907,0,0,244,0,-244
13908,1,1,213,2478,2265
13909,1,0,0,0,0
13910,0,0,58,0,-58
13911,1,0,145,0,-145
13912,1,1,153,1446,1293
13913,1,0,46,0,-46
13914,0,0,36,0,-36
13915,1,0,14,0,-14
13916,0,0,241,0,-241
13917,1,1,519,1477,958
13918,1,0,30,0,-30
13919,1,0,112,0,-112
13920,1,0,28,0,-28
13921,1,0,113,0,-113
13922,0,0,26,0,-26
13923,0,0,28,0,-28
13924,1,0,5,0,-5
13925,1,0,82,0,-82
13926,0,0,11,0,-11
13927,1,0,10,0,-10
13928,1,0,11,0,-11
13929,0,0,26,0,-26
13930,1,1,814,1347,533
13931,0,0,35,0,-35
13932,0,0,39,0,-39
13933,1,1,30,1242,1212
13934,1,1,136,1431,1295
13935,1,0,116,0,-116
13936,1,0,56,0,-56
13937,0,0,11,0,-11
13938,1,1,528,1410,882
13939,0,0,44,0,-44
13940,0,0,2,0,-2
13941,0,0,44,0,-44
13942,1,0,81,0,-81
13943,1,0,249,0,-249
13944,0,0,56,0,-56
13945,0,0,145,0,-145
13946,0,0,39,0,-39
13947,0,0,141,0,-141
13948,1,1,74,1347,1273
13949,0,0,173,0,-173
13950,1,1,188,1294,1106
13951,0,0,53,0,-53
13952,0,0,115,0,-115
13953,1,0,39,0,-39
13954,1,1,1503,1281,-222
13955,1,1,137,1239,1102
13956,1,0,77,0,-77
13957,1,1,453,1580,1127
13958,1,1,720,1365,645
13959,0,0,77,0,-77
13960,1,0,40,0,-40
13961,1,0,107,0,-107
13962,1,1,455,2395,1940
13963,0,0,1,0,-1
13964,0,0,72,0,-72
13965,1,1,695,1549,854
13966,1,0,60,0,-60
13967,1,1,1120,1354,234
13968,1,1,299,1435,1136
13969,1,1,766,2048,1282
13970,0,0,44,0,-44
13971,1,0,8,0,-8
13972,1,1,9,1416,1407
13973,0,0,26,0,-26
13974,1,0,71,0,-71
13975,0,0,71,0,-71
13976,1,0,20,0,-20
13977,0,0,60,0,-60
13978,1,0,75,0,-75
13979,1,0,118,0,-118
13980,0,0,24,0,-24
13981,0,0,0,0,0
13982,0,0,33,0,-33
13983,1,0,3,0,-3
13984,1,1,161,1644,1483
13985,0,0,87,0,-87
13986,1,0,8,0,-8
13987,0,0,11,0,-11
13988,0,0,1,0,-1
13989,1,0,302,0,-302
13990,0,0,35,0,-35
13991,1,1,352,1635,1283
13992,1,1,145,1381,1236
13993,0,0,31,0,-31
13994,0,0,12,0,-12
13995,1,1,558,1338,780
13996,1,1,256,1495,1239
13997,1,0,0,0,0
13998,1,0,4,0,-4
13999,1,1,477,1369,892
14000,1,0,32,0,-32
14001,1,1,281,1879,1598
14002,1,0,6,0,-6
14003,1,0,2,0,-2
14004,1,0,8,0,-8
14005,1,0,42,0,-42
14006,1,1,1579,1627,48
14007,0,0,8,0,-8
14008,1,1,106,1235,1129
14009,0,0,147,0,-147
14010,1,0,53,0,-53
14011,1,1,156,2245,2089
14012,0,0,14,0,-14
14013,1,0,72,0,-72
14014,1,0,109,0,-109
14015,0,0,26,0,-26
14016,0,0,26,0,-26
14017,1,0,71,0,-71
14018,0,0,211,0,-211
14019,1,0,44,0,-44
14020,1,1,1387,1713,326
14021,1,0,7,0,-7
14022,0,0,49,0,-49
14023,0,0,56,0,-56
14024,1,1,161,1330,1169
14025,0,0,100,0,-100
14026,1,1,507,1338,831
14027,0,0,154,0,-154
14028,1,0,16,0,-16
14029,1,0,34,0,-34
14030,1,1,708,2705,1997
14031,0,0,28,0,-28
14032,1,0,11,0,-11
14033,1,0,16,0,-16
14034,1,1,233,1833,1600
14035,1,1,177,1913,1736
14036,0,0,0,0,0
14037,1,0,16,0,-16
14038,1,0,8,0,-8
14039,0,0,22,0,-22
14040,1,0,50,0,-50
14041,1,1,321,1236,915
14042,1,1,703,1327,624
14043,0,0,41,0,-41
14044,1,0,65,0,-65
14045,1,1,361,1422,1061
14046,1,0,117,0,-117
14047,1,1,768,1663,895
14048,1,1,218,1403,1185
14049,0,0,41,0,-41
14050,1,1,649,1845,1196
14051,1,0,137,0,-137
14052,1,1,102,1270,1168
14053,0,0,2,0,-2
14054,0,0,102,0,-102
14055,1,1,223,1326,1103
14056,0,0,25,0,-25
14057,1,1,611,1414,803
14058,1,0,152,0,-152
14059,0,0,96,0,-96
14060,1,1,152,1492,1340
14061,0,0,9,0,-9
14062,1,1,1137,1408,271
14063,1,1,937,1715,778
14064,1,1,64,1317,1253
14065,0,0,39,0,-39
14066,0,0,15,0,-15
14067,0,0,24,0,-24
14068,0,0,21,0,-21
14069,0,0,0,0,0
14070,1,0,19,0,-19
14071,1,1,113,1284,1171
14072,0,0,28,0,-28
14073,0,0,15,0,-15
14074,0,0,49,0,-49
14075,1,1,1040,1598,558
14076,1,0,8,0,-8
14077,1,0,51,0,-51
14078,0,0,34,0,-34
14079,1,1,1169,1525,356
14080,1,1,532,4435,3903
14081,1,0,2,0,-2
14082,0,0,21,0,-21
14083,1,1,109,2058,1949
14084,1,0,45,0,-45
14085,1,1,409,1297,888
14086,1,1,767,1403,636
14087,1,0,20,0,-20
14088,1,0,7,0,-7
14089,1,1,768,2603,1835
14090,0,0,248,0,-248
14091,1,1,236,2066,1830
14092,1,0,54,0,-54
14093,1,0,19,0,-19
14094,1,0,67,0,-67
14095,1,0,14,0,-14
14096,1,1,703,1846,1143
14097,0,0,44,0,-44
14098,0,0,105,0,-105
14099,1,1,831,1699,868
14100,0,0,18,0,-18
14101,1,1,691,2621,1930
14102,1,1,396,1418,1022
14103,0,0,71,0,-71
14104,0,0,35,0,-35
14105,1,0,13,0,-13
14106,0,0,62,0,-62
14107,0,0,124,0,-124
14108,1,1,281,1734,1453
14109,0,0,28,0,-28
14110,1,0,95,0,-95
14111,1,1,552,1863,1311
14112,0,0,131,0,-131
14113,0,0,17,0,-17
14114,0,0,51,0,-51
14115,0,0,73,0,-73
14116,0,0,12,0,-12
14117,1,1,487,1711,1224
14118,1,0,22,0,-22
14119,1,1,313,1514,1201
14120,0,0,47,0,-47
14121,0,0,52,0,-52
14122,1,0,7,0,-7
14123,1,0,46,0,-46
14124,0,0,24,0,-24
14125,1,0,42,0,-42
14126,1,1,119,1237,1118
14127,0,0,1,0,-1
14128,1,1,418,1552,1134
14129,0,0,56,0,-56
14130,0,0,257,0,-257
14131,1,0,90,0,-90
14132,0,0,23,0,-23
14133,0,0,26,0,-26
14134,1,1,181,1516,1335
14135,0,0,7,0,-7
14136,1,0,77,0,-77
14137,0,0,4,0,-4
14138,1,0,3,0,-3
14139,1,0,94,0,-94
14140,1,0,30,0,-30
14141,1,0,53,0,-53
14142,1,1,183,1353,1170
14143,0,0,4,0,-4
14144,0,0,24,0,-24
14145,1,0,88,0,-88
14146,1,0,13,0,-13
14147,1,1,2591,1548,-1043
14148,1,1,616,1850,1234
14149,0,0,3,0,-3
14150,0,0,25,0,-25
14151,1,0,95,0,-95
14152,1,0,96,0,-96
14153,1,1,2279,1350,-929
14154,1,1,54,1447,1393
14155,1,0,166,0,-166
14156,0,0,12,0,-12
14157,1,1,288,1405,1117
14158,1,0,2,0,-2
14159,1,0,10,0,-10
14160,1,1,355,2473,2118
14161,0,0,51,0,-51
14162,1,0,18,0,-18
14163,1,0,2,0,-2
14164,1,1,226,1381,1155
14165,0,0,13,0,-13
14166,0,0,7,0,-7
14167,0,0,20,0,-20
14168,0,0,47,0,-47
14169,1,0,92,0,-92
14170,1,1,622,1381,759
14171,1,1,603,1272,669
14172,1,0,20,0,-20
14173,1,1,747,1333,586
14174,1,1,1670,1511,-159
14175,0,0,247,0,-247
14176,1,0,106,0,-106
14177,0,0,208,0,-208
14178,1,1,149,1326,1177
14179,1,1,109,1365,1256
14180,1,0,60,0,-60
14181,1,1,160,1797,1637
14182,1,0,7,0,-7
14183,0,0,32,0,-32
14184,1,1,476,1295,819
14185,0,0,31,0,-31
14186,0,0,59,0,-59
14187,1,1,166,1720,1554
14188,0,0,11,0,-11
14189,0,0,3,0,-3
14190,1,0,156,0,-156
14191,0,0,3,0,-3
14192,0,0,13,0,-13
14193,0,0,61,0,-61
14194,0,0,20,0,-20
14195,1,0,13,0,-13
14196,0,0,74,0,-74
14197,1,1,368,2285,1917
14198,0,0,27,0,-27
14199,1,1,227,3210,2983
14200,1,0,4,0,-4
14201,1,0,36,0,-36
14202,1,0,119,0,-119
14203,0,0,77,0,-77
14204,1,0,49,0,-49
14205,0,0,36,0,-36
14206,0,0,17,0,-17
14207,1,0,16,0,-16
14208,1,1,212,3092,2880
14209,1,0,55,0,-55
14210,0,0,23,0,-23
14211,0,0,1,0,-1
14212,1,0,63,0,-63
14213,0,0,80,0,-80
14214,1,1,363,1378,1015
14215,1,0,3,0,-3
14216,0,0,65,0,-65
14217,1,1,144,1503,1359
14218,1,0,67,0,-67
14219,1,0,20,0,-20
14220,0,0,44,0,-44
14221,1,1,1042,1349,307
14222,1,1,340,1374,1034
14223,1,0,34,0,-34
14224,1,0,20,0,-20
14225,1,0,67,0,-67
14226,1,1,355,1245,890
14227,0,0,39,0,-39
14228,0,0,38,0,-38
14229,0,0,25,0,-25
14230,0,0,67,0,-67
14231,1,1,682,1410,728
14232,1,0,174,0,-174
14233,1,1,452,1854,1402
14234,1,1,98,1364,1266
14235,0,0,120,0,-120
14236,0,0,53,0,-53
14237,1,0,30,0,-30
14238,0,0,187,0,-187
14239,1,0,114,0,-114
14240,0,0,38,0,-38
14241,1,1,265,4029,3764
14242,0,0,1,0,-1
14243,1,1,215,1983,1768
14244,0,0,18,0,-18
14245,1,1,228,2422,2194
14246,0,0,27,0,-27
14247,1,0,277,0,-277
14248,1,1,168,1544,1376
14249,0,0,87,0,-87
14250,1,1,1846,1373,-473
14251,0,0,7,0,-7
14252,1,0,16,0,-16
14253,1,0,1,0,-1
14254,1,0,20,0,-20
14255,1,1,587,1653,1066
14256,0,0,50,0,-50
14257,1,0,140,0,-140
14258,1,1,161,3641,3480
14259,1,1,426,1305,879
14260,0,0,86,0,-86
14261,0,0,53,0,-53
14262,1,1,447,2434,1987
14263,0,0,30,0,-30
14264,1,1,240,1490,1250
14265,0,0,26,0,-26
14266,0,0,1,0,-1
14267,0,0,51,0,-51
14268,1,1,372,1704,1332
14269,0,0,61,0,-61
14270,0,0,6,0,-6
14271,0,0,17,0,-17
14272,0,0,43,0,-43
14273,0,0,143,0,-143
14274,1,0,11,0,-11
14275,0,0,20,0,-20
14276,1,0,219,0,-219
14277,1,0,2,0,-2
14278,1,0,59,0,-59
14279,1,0,55,0,-55
14280,1,1,102,1485,1383
14281,0,0,126,0,-126
14282,0,0,25,0,-25
14283,1,1,125,1263,1138
14284,1,0,38,0,-38
14285,1,1,99,1398,1299
14286,1,0,26,0,-26
14287,0,0,4,0,-4
14288,1,0,40,0,-40
14289,1,1,158,1364,1206
14290,1,0,30,0,-30
14291,0,0,54,0,-54
14292,0,0,40,0,-40
14293,0,0,10,0,-10
14294,0,0,15,0,-15
14295,0,0,36,0,-36
14296,0,0,14,0,-14
14297,1,0,16,0,-16
14298,1,1,1201,2478,1277
14299,1,0,4,0,-4
14300,1,1,825,1360,535
14301,1,1,223,2704,2481
14302,1,1,69,1638,1569
14303,1,1,771,1508,737
14304,1,1,47,1405,1358
14305,0,0,44,0,-44
14306,0,0,11,0,-11
14307,0,0,39,0,-39
14308,1,1,3002,1417,-1585
14309,1,0,82,0,-82
14310,1,0,14,0,-14
14311,0,0,49,0,-49
14312,1,1,177,1325,1148
14313,1,1,300,2422,2122
14314,0,0,57,0,-57
14315,1,1,479,1508,1029
14316,1,1,985,1830,845
14317,1,0,27,0,-27
14318,1,0,41,0,-41
14319,1,1,23,1633,1610
14320,1,1,1970,1555,-415
14321,0,0,17,0,-17
14322,1,0,59,0,-59
14323,1,1,532,1287,755
14324,1,1,1817,2253,436
14325,0,0,168,0,-168
14326,1,0,131,0,-131
14327,1,0,49,0,-49
14328,0,0,60,0,-60
14329,1,0,70,0,-70
14330,1,1,499,2053,1554
14331,1,0,30,0,-30
14332,0,0,29,0,-29
14333,1,0,32,0,-32
14334,1,0,147,0,-147
14335,1,0,126,0,-126
14336,1,1,263,1547,1284
14337,1,0,1,0,-1
14338,0,0,28,0,-28
14339,1,0,1,0,-1
14340,0,0,29,0,-29
14341,1,0,36,0,-36
14342,1,1,398,1310,912
14343,0,0,3,0,-3
14344,1,1,248,1496,1248
14345,1,0,14,0,-14
14346,1,1,268,1335,1067
14347,1,0,7,0,-7
14348,0,0,34,0,-34
14349,1,0,56,0,-56
14350,0,0,87,0,-87
14351,1,0,77,0,-77
14352,0,0,135,0,-135
14353,1,0,2,0,-2
14354,1,1,2415,1630,-785
14355,1,1,323,1258,935
14356,1,0,3,0,-3
14357,0,0,1,0,-1
14358,0,0,13,0,-13
14359,1,0,35,0,-35
14360,1,0,66,0,-66
14361,1,0,14,0,-14
14362,0,0,43,0,-43
14363,0,0,27,0,-27
14364,1,0,101,0,-101
14365,0,0,48,0,-48
14366,1,1,536,3440,2904
14367,1,0,215,0,-215
14368,1,0,57,0,-57
14369,1,1,1084,2985,1901
14370,1,1,299,1398,1099
14371,0,0,22,0,-22
14372,1,1,693,1261,568
14373,1,0,50,0,-50
14374,0,0,27,0,-27
14375,1,1,43,1352,1309
14376,0,0,28,0,-28
14377,1,0,4,0,-4
14378,1,1,1103,1349,246
14379,1,1,752,1347,595
14380,0,0,3,0,-3
14381,1,0,88,0,-88
14382,1,0,12,0,-12
14383,0,0,74,0,-74
14384,1,0,106,0,-106
14385,1,1,540,4175,3635
14386,0,0,42,0,-42
14387,1,0,25,0,-25
14388,1,0,0,0,0
14389,0,0,24,0,-24
14390,1,1,242,3366,3124
14391,1,0,11,0,-11
14392,1,0,49,0,-49
14393,0,0,12,0,-12
14394,1,0,176,0,-176
14395,1,1,518,1335,817
14396,1,0,57,0,-57
14397,1,1,131,2220,2089
14398,1,0,0,0,0
14399,0,0,25,0,-25
14400,1,1,47,1590,1543
14401,0,0,12,0,-12
14402,1,0,106,0,-106
14403,0,0,8,0,-8
14404,1,1,612,1567,955
14405,0,0,33,0,-33
14406,1,1,162,1861,1699
14407,0,0,99,0,-99
14408,1,0,39,0,-39
14409,0,0,72,0,-72
14410,1,1,132,1332,1200
14411,0,0,76,0,-76
14412,1,0,105,0,-105
14413,1,0,13,0,-13
14414,1,1,520,1994,1474
14415,1,0,152,0,-152
14416,1,1,71,1413,1342
14417,0,0,89,0,-89
14418,1,1,430,1938,1508
14419,1,0,78,0,-78
14420,0,0,34,0,-34
14421,1,1,364,1251,887
14422,1,1,248,1524,1276
14423,1,1,323,1360,1037
14424,1,0,61,0,-61
14425,1,1,858,1928,1070
14426,1,1,580,1576,996
14427,0,0,15,0,-15
14428,0,0,58,0,-58
14429,0,0,16,0,-16
14430,0,0,21,0,-21
14431,1,1,343,1684,1341
14432,0,0,31,0,-31
14433,1,0,79,0,-79
14434,1,0,38,0,-38
14435,0,0,183,0,-183
14436,1,0,98,0,-98
14437,1,1,235,1748,1513
14438,1,0,42,0,-42
14439,1,0,2,0,-2
14440,0,0,14,0,-14
14441,0,0,9,0,-9
14442,0,0,36,0,-36
14443,0,0,6,0,-6
14444,0,0,71,0,-71
14445,1,0,98,0,-98
14446,1,0,25,0,-25
14447,0,0,104,0,-104
14448,1,0,102,0,-102
14449,1,0,10,0,-10
14450,0,0,110,0,-110
14451,0,0,13,0,-13
14452,1,0,26,0,-26
14453,1,0,10,0,-10
14454,1,1,464,1598,1134
14455,1,0,17,0,-17
14456,1,0,21,0,-21
14457,1,0,154,0,-154
14458,1,1,1540,1417,-123
14459,1,1,345,1573,1228
14460,1,1,306,2853,2547
14461,0,0,0,0,0
14462,1,1,768,1290,522
14463,1,1,135,2336,2201
14464,1,1,370,1287,917
14465,0,0,3,0,-3
14466,1,0,5,0,-5
14467,1,0,40,0,-40
14468,1,0,72,0,-72
14469,1,0,9,0,-9
14470,1,0,17,0,-17
14471,1,0,60,0,-60
14472,0,0,92,0,-92
14473,1,1,392,1313,921
14474,1,1,572,1269,697
14475,0,0,33,0,-33
14476,1,0,13,0,-13
14477,0,0,17,0,-17
14478,1,0,40,0,-40
14479,1,1,141,1359,1218
14480,1,0,67,0,-67
14481,0,0,34,0,-34
14482,1,0,36,0,-36
14483,0,0,7,0,-7
14484,0,0,0,0,0
14485,1,0,4,0,-4
14486,1,1,2830,1375,-1455
14487,1,0,14,0,-14
14488,1,0,77,0,-77
14489,0,0,93,0,-93
14490,0,0,11,0,-11
14491,1,1,1207,1270,63
14492,1,1,458,1387,929
14493,0,0,28,0,-28
14494,1,1,427,1252,825
14495,0,0,132,0,-132
14496,1,0,27,0,-27
14497,0,0,9,0,-9
14498,0,0,42,0,-42
14499,1,1,1413,1467,54
14500,1,0,16,0,-16
14501,1,1,285,1362,1077
14502,1,1,27,1424,1397
14503,1,1,127,2647,2520
14504,1,0,27,0,-27
14505,1,1,636,1729,1093
14506,0,0,92,0,-92
14507,1,0,264,0,-264
14508,0,0,20,0,-20
14509,1,0,171,0,-171
14510,1,0,83,0,-83
14511,0,0,6,0,-6
14512,1,1,416,1430,1014
14513,0,0,98,0,-98
14514,1,0,133,0,-133
14515,1,0,66,0,-66
14516,0,0,34,0,-34
14517,1,0,2,0,-2
14518,1,1,94,3687,3593
14519,1,1,592,1530,938
14520,0,0,120,0,-120
14521,0,0,22,0,-22
14522,0,0,13,0,-13
14523,0,0,3,0,-3
14524,1,1,952,1389,437
14525,1,0,50,0,-50
14526,1,0,8,0,-8
14527,1,0,16,0,-16
14528,1,0,113,0,-113
14529,0,0,0,0,0
14530,1,1,320,1639,1319
14531,1,0,13,0,-13
14532,1,1,421,1300,879
14533,0,0,59,0,-59
14534,1,1,1022,1736,714
14535,1,0,75,0,-75
14536,1,1,451,1756,1305
14537,0,0,200,0,-200
14538,0,0,48,0,-48
14539,1,0,12,0,-12
14540,0,0,12,0,-12
14541,1,1,464,1444,980
14542,1,0,57,0,-57
14543,1,1,445,1319,874
14544,1,1,208,1289,1081
14545,1,0,14,0,-14
14546,1,0,7,0,-7
14547,1,1,838,1492,654
14548,0,0,26,0,-26
14549,1,1,457,1604,1147
14550,1,0,6,0,-6
14551,0,0,25,0,-25
14552,1,1,708,1582,874
14553,1,0,104,0,-104
14554,0,0,1,0,-1
14555,0,0,10,0,-10
14556,0,0,17,0,-17
14557,1,0,0,0,0
14558,0,0,46,0,-46
14559,0,0,80,0,-80
14560,1,0,10,0,-10
14561,1,0,4,0,-4
14562,1,0,95,0,-95
14563,0,0,51,0,-51
14564,1,1,280,1375,1095
14565,1,1,1115,1599,484
14566,1,1,460,1967,1507
14567,1,1,96,1275,1179
14568,0,0,41,0,-41
14569,1,0,4,0,-4
14570,0,0,58,0,-58
14571,1,1,699,1243,544
14572,1,0,70,0,-70
14573,0,0,95,0,-95
14574,1,1,442,1360,918
14575,1,0,12,0,-12
14576,0,0,207,0,-207
14577,1,1,67,1489,1422
14578,1,1,149,14551,14402
14579,1,1,98,1867,1769
14580,1,1,639,1267,628
14581,0,0,183,0,-183
14582,1,1,641,1367,726
14583,1,1,620,1257,637
14584,1,1,393,1238,845
14585,1,0,39,0,-39
14586,0,0,95,0,-95
14587,1,1,816,2277,1461
14588,1,1,108,1412,1304
14589,1,1,1136,1392,256
14590,1,1,62,1283,1221
14591,1,0,22,0,-22
14592,1,1,2477,1280,-1197
14593,1,0,31,0,-31
14594,0,0,38,0,-38
14595,1,1,263,1317,1054
14596,1,1,155,1371,1216
14597,1,0,32,0,-32
14598,1,1,1223,1558,335
14599,1,0,29,0,-29
14600,1,1,90,1313,1223
14601,1,0,284,0,-284
14602,0,0,11,0,-11
14603,0,0,33,0,-33
14604,1,0,95,0,-95
14605,1,1,43,1259,1216
14606,1,0,55,0,-55
14607,1,1,331,1283,952
14608,1,1,314,1365,1051
14609,0,0,14,0,-14
14610,1,1,496,1385,889
14611,1,0,52,0,-52
14612,1,1,806,1342,536
14613,0,0,16,0,-16
14614,1,0,20,0,-20
14615,1,1,1365,1525,160
14616,1,0,239,0,-239
14617,0,0,9,0,-9
14618,0,0,62,0,-62
14619,0,0,6,0,-6
14620,1,1,226,2212,1986
14621,1,1,1235,1374,139
14622,1,1,697,2428,1731
14623,1,1,311,1733,1422
14624,0,0,11,0,-11
14625,1,1,817,1423,606
14626,1,0,92,0,-92
14627,1,1,543,1724,1181
14628,1,1,650,1399,749
14629,1,0,36,0,-36
14630,0,0,4,0,-4
14631,0,0,169,0,-169
14632,1,0,51,0,-51
14633,1,1,1929,1259,-670
14634,1,0,97,0,-97
14635,0,0,134,0,-134
14636,0,0,72,0,-72
14637,0,0,55,0,-55
14638,0,0,9,0,-9
14639,1,1,250,1435,1185
14640,1,1,452,1831,1379
14641,0,0,160,0,-160
14642,0,0,183,0,-183
14643,1,0,18,0,-18
14644,1,0,21,0,-21
14645,0,0,13,0,-13
14646,0,0,51,0,-51
14647,1,1,272,2875,2603
14648,1,0,17,0,-17
14649,1,1,314,1300,986
14650,0,0,92,0,-92
14651,1,1,215,1308,1093
14652,1,1,1630,1393,-237
14653,0,0,0,0,0
14654,0,0,42,0,-42
14655,1,1,885,1604,719
14656,1,0,5,0,-5
14657,1,0,35,0,-35
14658,0,0,34,0,-34
14659,1,0,26,0,-26
14660,1,1,196,1439,1243
14661,0,0,55,0,-55
14662,1,1,752,2123,1371
14663,0,0,14,0,-14
14664,0,0,48,0,-48
14665,0,0,19,0,-19
14666,0,0,113,0,-113
14667,1,0,223,0,-223
14668,0,0,67,0,-67
14669,1,1,232,2694,2462
14670,1,1,220,1324,1104
14671,1,1,342,1620,1278
14672,1,0,87,0,-87
14673,0,0,113,0,-113
14674,1,0,61,0,-61
14675,1,0,66,0,-66
14676,1,1,1377,1354,-23
14677,0,0,10,0,-10
14678,1,0,51,0,-51
14679,1,0,38,0,-38
14680,0,0,43,0,-43
14681,1,0,17,0,-17
14682,1,0,53,0,-53
14683,0,0,99,0,-99
14684,0,0,68,0,-68
14685,1,1,122,1258,1136
14686,0,0,3,0,-3
14687,0,0,32,0,-32
14688,0,0,28,0,-28
14689,1,0,25,0,-25
14690,1,0,6,0,-6
14691,0,0,61,0,-61
14692,0,0,43,0,-43
14693,1,1,340,1804,1464
14694,1,0,30,0,-30
14695,1,0,43,0,-43
14696,0,0,30,0,-30
14697,1,1,98,1368,1270
14698,1,0,116,0,-116
14699,0,0,24,0,-24
14700,1,0,25,0,-25
14701,0,0,13,0,-13
14702,0,0,58,0,-58
14703,1,1,135,2472,2337
14704,0,0,79,0,-79
14705,0,0,3,0,-3
14706,1,0,55,0,-55
14707,1,0,38,0,-38
14708,0,0,58,0,-58
14709,1,1,755,1366,611
14710,1,0,84,0,-84
14711,1,0,87,0,-87
14712,1,1,794,1326,532
14713,0,0,46,0,-46
14714,1,1,407,1344,937
14715,1,1,2044,1529,-515
14716,0,0,18,0,-18
14717,1,0,10,0,-10
14718,1,0,19,0,-19
14719,1,0,53,0,-53
14720,0,0,61,0,-61
14721,1,1,2198,1344,-854
14722,1,0,33,0,-33
14723,0,0,103,0,-103
14724,0,0,2,0,-2
14725,0,0,10,0,-10
14726,0,0,97,0,-97
14727,1,1,738,1358,620
14728,1,0,13,0,-13
14729,1,0,31,0,-31
14730,0,0,16,0,-16
14731,1,1,231,2310,2079
14732,1,1,1296,1289,-7
14733,1,0,188,0,-188
14734,0,0,59,0,-59
14735,0,0,45,0,-45
14736,1,0,2,0,-2
14737,0,0,155,0,-155
14738,1,1,107,1260,1153
14739,0,0,0,0,0
14740,0,0,15,0,-15
14741,1,0,12,0,-12
14742,1,0,40,0,-40
14743,1,1,415,1325,910
14744,1,0,79,0,-79
14745,1,0,17,0,-17
14746,0,0,51,0,-51
14747,0,0,135,0,-135
14748,0,0,1,0,-1
14749,1,1,241,1431,1190
14750,1,0,2,0,-2
14751,0,0,64,0,-64
14752,1,0,53,0,-53
14753,0,0,36,0,-36
14754,1,1,285,1244,959
14755,0,0,7,0,-7
14756,1,1,1242,1322,80
14757,1,1,326,1570,1244
14758,0,0,26,0,-26
14759,1,1,989,1709,720
14760,1,0,17,0,-17
14761,0,0,99,0,-99
14762,0,0,73,0,-73
14763,1,1,140,1448,1308
14764,0,0,47,0,-47
14765,0,0,1,0,-1
14766,1,0,23,0,-23
14767,1,0,19,0,-19
14768,1,0,12,0,-12
14769,1,1,798,1332,534
14770,1,0,69,0,-69
14771,0,0,15,0,-15
14772,1,0,85,0,-85
14773,1,0,1,0,-1
14774,1,1,157,1360,1203
14775,0,0,5,0,-5
14776,1,1,1254,1654,400
14777,1,0,23,0,-23
14778,0,0,105,0,-105
14779,0,0,2,0,-2
14780,1,0,155,0,-155
14781,1,0,11,0,-11
14782,1,1,245,1252,1007
14783,0,0,45,0,-45
14784,0,0,95,0,-95
14785,0,0,11,0,-11
14786,0,0,9,0,-9
14787,1,1,1202,2790,1588
14788,0,0,0,0,0
14789,0,0,2,0,-2
14790,0,0,17,0,-17
14791,1,0,41,0,-41
14792,1,1,82,1242,1160
14793,1,0,1,0,-1
14794,1,0,63,0,-63
14795,0,0,16,0,-16
14796,1,1,517,1366,849
14797,0,0,156,0,-156
14798,1,1,51,1536,1485
14799,0,0,21,0,-21
14800,1,1,183,1454,1271
14801,0,0,21,0,-21
14802,1,0,46,0,-46
14803,0,0,10,0,-10
14804,0,0,62,0,-62
14805,1,0,43,0,-43
14806,1,0,21,0,-21
14807,0,0,45,0,-45
14808,0,0,46,0,-46
14809,1,1,303,1668,1365
14810,0,0,12,0,-12
14811,1,0,3,0,-3
14812,0,0,12,0,-12
14813,0,0,11,0,-11
14814,1,0,15,0,-15
14815,0,0,2,0,-2
14816,0,0,27,0,-27
14817,0,0,34,0,-34
14818,1,1,796,1235,439
14819,0,0,11,0,-11
14820,1,0,53,0,-53
14821,0,0,83,0,-83
14822,1,0,98,0,-98
14823,1,0,3,0,-3
14824,0,0,29,0,-29
14825,0,0,8,0,-8
14826,1,0,20,0,-20
14827,0,0,64,0,-64
14828,0,0,43,0,-43
14829,1,0,14,0,-14
14830,1,0,28,0,-28
14831,1,1,878,1285,407
14832,1,0,36,0,-36
14833,1,1,594,1968,1374
14834,1,1,209,1652,1443
14835,1,1,527,1595,1068
14836,0,0,5,0,-5
14837,0,0,104,0,-104
14838,0,0,85,0,-85
14839,1,1,1837,1790,-47
14840,0,0,2,0,-2
14841,1,1,381,1837,1456
14842,0,0,11,0,-11
14843,0,0,42,0,-42
14844,0,0,2,0,-2
14845,0,0,38,0,-38
14846,0,0,136,0,-136
14847,1,0,74,0,-74
14848,1,1,1199,1907,708
14849,1,0,32,0,-32
14850,1,0,55,0,-55
14851,1,0,63,0,-63
14852,1,1,194,2286,2092
14853,1,0,34,0,-34
14854,0,0,1,0,-1
14855,0,0,102,0,-102
14856,0,0,48,0,-48
14857,1,1,28,2067,2039
14858,1,1,262,1954,1692
14859,0,0,64,0,-64
14860,1,0,47,0,-47
14861,1,0,48,0,-48
14862,0,0,126,0,-126
14863,1,0,16,0,-16
14864,1,0,47,0,-47
14865,1,0,20,0,-20
14866,1,0,57,0,-57
14867,1,1,614,1328,714
14868,1,0,191,0,-191
14869,0,0,22,0,-22
14870,1,1,83,1424,1341
14871,1,0,134,0,-134
14872,0,0,110,0,-110
14873,1,0,42,0,-42
14874,1,1,658,1365,707
14875,1,0,51,0,-51
14876,1,0,19,0,-19
14877,1,0,81,0,-81
14878,0,0,25,0,-25
14879,1,1,549,1420,871
14880,1,0,10,0,-10
14881,1,0,119,0,-119
14882,1,1,507,1238,731
14883,1,1,103,1258,1155
14884,0,0,138,0,-138
14885,0,0,13,0,-13
14886,0,0,5,0,-5
14887,1,0,3,0,-3
14888,1,0,12,0,-12
14889,0,0,35,0,-35
14890,1,1,196,1308,1112
14891,1,1,224,2178,1954
14892,1,1,111,1245,1134
14893,0,0,63,0,-63
14894,1,0,16,0,-16
14895,1,1,1150,1352,202
14896,0,0,142,0,-142
14897,1,0,6,0,-6
14898,1,0,54,0,-54
14899,0,0,2,0,-2
14900,0,0,75,0,-75
14901,0,0,22,0,-22
14902,1,1,262,1643,1381
14903,1,0,8,0,-8
14904,0,0,47,0,-47
14905,0,0,77,0,-77
14906,1,0,9,0,-9
14907,1,1,624,1531,907
14908,1,0,22,0,-22
14909,1,0,61,0,-61
14910,0,0,3,0,-3
14911,0,0,61,0,-61
14912,0,0,2,0,-2
14913,0,0,21,0,-21
14914,1,1,120,1236,1116
14915,1,1,320,1609,1289
14916,1,1,231,2374,2143
14917,1,0,5,0,-5
14918,1,1,521,1254,733
14919,0,0,7,0,-7
14920,1,0,19,0,-19
14921,1,1,311,1421,1110
14922,1,0,52,0,-52
14923,1,0,49,0,-49
14924,0,0,30,0,-30
14925,1,0,116,0,-116
14926,0,0,107,0,-107
14927,0,0,30,0,-30
14928,1,0,1,0,-1
14929,1,0,34,0,-34
14930,0,0,80,0,-80
14931,1,1,176,1432,1256
14932,0,0,65,0,-65
14933,1,1,553,1246,693
14934,0,0,5,0,-5
14935,1,0,78,0,-78
14936,0,0,1,0,-1
14937,1,1,742,1671,929
14938,1,1,708,1357,649
14939,0,0,183,0,-183
14940,0,0,11,0,-11
14941,1,1,184,2294,2110
14942,1,0,2,0,-2
14943,0,0,5,0,-5
14944,1,0,63,0,-63
14945,1,1,624,1591,967
14946,1,1,353,1424,1071
14947,1,1,267,2006,1739
14948,1,1,758,1463,705
14949,1,1,1108,1418,310
14950,1,0,30,0,-30
14951,1,1,743,1458,715
14952,0,0,31,0,-31
14953,1,1,474,1898,1424
14954,1,1,885,1422,537
14955,1,1,184,1821,1637
14956,0,0,74,0,-74
14957,0,0,85,0,-85
14958,1,0,26,0,-26
14959,1,1,139,1298,1159
14960,0,0,39,0,-39
14961,1,0,91,0,-91
14962,1,1,119,1680,1561
14963,1,0,109,0,-109
14964,1,1,138,1287,1149
14965,1,0,9,0,-9
14966,1,0,38,0,-38
14967,1,1,1340,1848,508
14968,1,1,1050,1432,382
14969,1,0,35,0,-35
14970,1,0,4,0,-4
14971,0,0,14,0,-14
14972,1,1,1273,1355,82
14973,1,0,30,0,-30
14974,0,0,14,0,-14
14975,0,0,24,0,-24
14976,1,1,682,1394,712
14977,0,0,26,0,-26
14978,0,0,70,0,-70
14979,1,0,102,0,-102
14980,1,0,92,0,-92
14981,0,0,30,0,-30
14982,0,0,101,0,-101
14983,1,0,37,0,-37
14984,0,0,17,0,-17
14985,0,0,21,0,-21
14986,0,0,69,0,-69
14987,1,1,1144,1825,681
14988,1,1,486,1262,776
14989,1,1,464,1459,995
14990,1,0,28,0,-28
14991,0,0,9,0,-9
14992,1,0,112,0,-112
14993,0,0,1,0,-1
14994,1,0,41,0,-41
14995,1,0,7,0,-7
14996,1,0,2,0,-2
14997,1,1,1096,1818,722
14998,0,0,67,0,-67
14999,1,1,87,2391,2304
15000,0,0,5,0,-5
15001,1,1,175,1506,1331
15002,1,1,96,1454,1358
15003,1,1,1645,1393,-252
15004,1,1,158,1839,1681
15005,0,0,85,0,-85
15006,1,0,40,0,-40
15007,0,0,97,0,-97
15008,0,0,81,0,-81
15009,1,1,246,1362,1116
15010,1,0,27,0,-27
15011,1,0,1,0,-1
15012,0,0,25,0,-25
15013,0,0,58,0,-58
15014,0,0,24,0,-24
15015,0,0,0,0,0
15016,0,0,24,0,-24
15017,1,0,41,0,-41
15018,1,0,0,0,0
15019,1,0,75,0,-75
15020,1,0,42,0,-42
15021,1,1,166,2159,1993
15022,0,0,71,0,-71
15023,0,0,85,0,-85
15024,1,0,10,0,-10
15025,0,0,12,0,-12
15026,1,1,1098,1343,245
15027,0,0,72,0,-72
15028,0,0,72,0,-72
15029,1,0,6,0,-6
15030,0,0,9,0,-9
15031,1,0,23,0,-23
15032,1,1,118,3019,2901
15033,1,0,2,0,-2
15034,1,0,0,0,0
15035,0,0,0,0,0
15036,0,0,55,0,-55
15037,1,0,27,0,-27
15038,1,0,31,0,-31
15039,0,0,24,0,-24
15040,1,1,678,1815,1137
15041,1,0,9,0,-9
15042,1,1,369,1639,1270
15043,1,1,312,1525,1213
15044,0,0,2,0,-2
15045,0,0,116,0,-116
15046,0,0,13,0,-13
15047,0,0,243,0,-243
15048,0,0,48,0,-48
15049,1,0,63,0,-63
15050,0,0,12,0,-12
15051,1,0,37,0,-37
15052,0,0,38,0,-38
15053,0,0,1,0,-1
15054,0,0,4,0,-4
15055,1,0,54,0,-54
15056,0,0,4,0,-4
15057,1,1,191,1249,1058
15058,0,0,23,0,-23
15059,1,1,440,1383,943
15060,1,0,105,0,-105
15061,1,1,1110,2612,1502
15062,0,0,40,0,-40
15063,0,0,4,0,-4
15064,1,1,296,2523,2227
15065,0,0,38,0,-38
15066,1,0,9,0,-9
15067,0,0,20,0,-20
15068,1,1,1239,1383,144
15069,1,0,1,0,-1
15070,1,0,6,0,-6
15071,1,0,165,0,-165
15072,0,0,79,0,-79
15073,0,0,89,0,-89
15074,1,0,29,0,-29
15075,1,1,293,1244,951
15076,0,0,37,0,-37
15077,1,1,1637,1348,-289
15078,0,0,108,0,-108
15079,1,1,515,1794,1279
15080,1,0,117,0,-117
15081,1,1,486,1397,911
15082,1,1,278,1528,1250
15083,0,0,0,0,0
15084,1,1,50,1268,1218
15085,0,0,25,0,-25
15086,0,0,5,0,-5
15087,1,0,125,0,-125
15088,1,0,58,0,-58
15089,1,0,6,0,-6
15090,1,0,12,0,-12
15091,1,1,261,1320,1059
15092,1,0,50,0,-50
15093,1,1,706,1264,558
15094,1,0,126,0,-126
15095,1,1,44,1418,1374
15096,1,0,20,0,-20
15097,0,0,28,0,-28
15098,1,1,905,1365,460
15099,0,0,12,0,-12
15100,0,0,71,0,-71
15101,1,0,370,0,-370
15102,1,1,1213,1661,448
15103,1,1,618,1274,656
15104,0,0,39,0,-39
15105,0,0,4,0,-4
15106,0,0,4,0,-4
15107,0,0,53,0,-53
15108,1,1,153,2590,2437
15109,1,0,80,0,-80
15110,1,0,157,0,-157
15111,1,1,1019,1750,731
15112,0,0,120,0,-120
15113,1,1,214,2721,2507
15114,0,0,0,0,0
15115,0,0,56,0,-56
15116,0,0,151,0,-151
15117,0,0,148,0,-148
15118,1,1,1371,1465,94
15119,1,1,477,1833,1356
15120,1,0,3,0,-3
15121,1,0,2,0,-2
15122,1,0,39,0,-39
15123,1,1,732,2620,1888
15124,1,0,62,0,-62
15125,0,0,28,0,-28
15126,0,0,23,0,-23
15127,0,0,33,0,-33
15128,1,0,75,0,-75
15129,0,0,92,0,-92
15130,0,0,191,0,-191
15131,1,1,406,1737,1331
15132,1,1,119,1271,1152
15133,0,0,24,0,-24
15134,1,1,822,1270,448
15135,1,0,75,0,-75
15136,1,0,65,0,-65
15137,0,0,121,0,-121
15138,0,0,98,0,-98
15139,1,0,10,0,-10
15140,0,0,0,0,0
15141,0,0,23,0,-23
15142,1,0,0,0,0
15143,0,0,54,0,-54
15144,0,0,99,0,-99
15145,0,0,25,0,-25
15146,0,0,52,0,-52
15147,1,1,309,1347,1038
15148,1,1,214,1989,1775
15149,1,1,80,1630,1550
15150,1,1,503,1337,834
15151,0,0,14,0,-14
15152,0,0,275,0,-275
15153,0,0,61,0,-61
15154,1,0,14,0,-14
15155,1,0,36,0,-36
15156,1,1,63,1632,1569
15157,0,0,25,0,-25
15158,1,0,24,0,-24
15159,1,0,22,0,-22
15160,0,0,44,0,-44
15161,0,0,96,0,-96
15162,1,0,53,0,-53
15163,1,1,959,1474,515
15164,1,0,1,0,-1
15165,0,0,45,0,-45
15166,0,0,20,0,-20
15167,1,0,51,0,-51
15168,1,1,175,1471,1296
15169,1,1,134,1435,1301
15170,0,0,1,0,-1
15171,0,0,147,0,-147
15172,0,0,49,0,-49
15173,1,1,381,1423,1042
15174,1,0,42,0,-42
15175,1,0,32,0,-32
15176,1,1,297,1483,1186
15177,0,0,15,0,-15
15178,1,1,676,1920,1244
15179,1,1,117,1324,1207
15180,1,1,461,1307,846
15181,0,0,61,0,-61
15182,1,1,386,1275,889
15183,1,0,41,0,-41
15184,1,0,10,0,-10
15185,0,0,20,0,-20
15186,0,0,6,0,-6
15187,0,0,34,0,-34
15188,0,0,10,0,-10
15189,1,0,106,0,-106
15190,1,1,1507,1289,-218
15191,0,0,115,0,-115
15192,0,0,26,0,-26
15193,0,0,81,0,-81
15194,1,1,42,1325,1283
15195,1,1,267,1277,1010
15196,0,0,49,0,-49
15197,1,0,20,0,-20
15198,1,1,159,1532,1373
15199,1,1,907,1864,957
15200,1,0,17,0,-17
15201,0,0,10,0,-10
15202,1,0,27,0,-27
15203,0,0,32,0,-32
15204,0,0,22,0,-22
15205,1,0,102,0,-102
15206,1,0,85,0,-85
15207,1,1,311,2015,1704
15208,1,1,293,1355,1062
15209,0,0,124,0,-124
15210,1,1,1965,1314,-651
15211,1,1,117,3257,3140
15212,0,0,54,0,-54
15213,0,0,10,0,-10
15214,0,0,14,0,-14
15215,1,1,130,1463,1333
15216,0,0,70,0,-70
15217,0,0,57,0,-57
15218,0,0,154,0,-154
15219,1,0,54,0,-54
15220,0,0,85,0,-85
15221,1,0,6,0,-6
15222,1,1,114,1647,1533
15223,1,1,180,1864,1684
15224,1,0,24,0,-24
15225,1,0,108,0,-108
15226,1,0,61,0,-61
15227,1,1,180,2138,1958
15228,0,0,77,0,-77
15229,0,0,146,0,-146
15230,0,0,19,0,-19
15231,1,1,342,1418,1076
15232,1,1,214,1410,1196
15233,1,1,119,1236,1117
15234,0,0,41,0,-41
15235,0,0,14,0,-14
15236,0,0,31,0,-31
15237,1,0,103,0,-103
15238,0,0,59,0,-59
15239,1,1,122,2005,1883
15240,1,1,593,1250,657
15241,1,0,13,0,-13
15242,0,0,75,0,-75
15243,1,1,435,2016,1581
15244,1,1,955,1772,817
15245,1,0,41,0,-41
15246,1,0,15,0,-15
15247,0,0,327,0,-327
15248,1,0,14,0,-14
15249,1,1,211,1529,1318
15250,1,1,112,1624,1512
15251,1,0,6,0,-6
15252,0,0,44,0,-44
15253,1,0,51,0,-51
15254,0,0,53,0,-53
15255,0,0,86,0,-86
15256,1,1,111,1637,1526
15257,1,0,52,0,-52
15258,0,0,33,0,-33
15259,0,0,37,0,-37
15260,0,0,59,0,-59
15261,1,1,141,1415,1274
15262,0,0,6,0,-6
15263,1,0,92,0,-92
15264,1,0,54,0,-54
15265,0,0,36,0,-36
15266,1,1,19,3291,3272
15267,1,0,45,0,-45
15268,1,0,9,0,-9
15269,0,0,1,0,-1
15270,1,0,23,0,-23
15271,0,0,29,0,-29
15272,0,0,5,0,-5
15273,1,0,17,0,-17
15274,1,1,2005,1843,-162
15275,1,1,719,1292,573
15276,1,0,78,0,-78
15277,0,0,157,0,-157
15278,0,0,6,0,-6
15279,1,1,590,1854,1264
15280,1,0,54,0,-54
15281,1,1,1524,1920,396
15282,1,0,18,0,-18
15283,1,0,20,0,-20
15284,1,1,305,1354,1049
15285,1,0,44,0,-44
15286,1,0,54,0,-54
15287,1,0,33,0,-33
15288,0,0,12,0,-12
15289,1,0,185,0,-185
15290,1,0,184,0,-184
15291,0,0,93,0,-93
15292,1,1,1258,1903,645
15293,1,0,34,0,-34
15294,1,1,1053,1364,311
15295,0,0,9,0,-9
15296,1,1,364,1367,1003
15297,0,0,56,0,-56
15298,1,1,169,1273,1104
15299,0,0,52,0,-52
15300,0,0,8,0,-8
15301,1,0,15,0,-15
15302,1,1,1271,1329,58
15303,1,1,438,1280,842
15304,1,0,20,0,-20
15305,0,0,162,0,-162
15306,1,0,89,0,-89
15307,0,0,39,0,-39
15308,0,0,18,0,-18
15309,1,1,279,1750,1471
15310,1,1,137,1847,1710
15311,1,0,6,0,-6
15312,1,0,9,0,-9
15313,1,0,99,0,-99
15314,0,0,50,0,-50
15315,1,1,1216,1678,462
15316,0,0,44,0,-44
15317,0,0,29,0,-29
15318,0,0,0,0,0
15319,1,1,53,1675,1622
15320,0,0,40,0,-40
15321,0,0,19,0,-19
15322,0,0,60,0,-60
15323,0,0,22,0,-22
15324,0,0,20,0,-20
15325,0,0,16,0,-16
15326,1,0,2,0,-2
15327,1,1,296,1578,1282
15328,1,1,209,2446,2237
15329,1,0,4,0,-4
15330,1,0,17,0,-17
15331,0,0,13,0,-13
15332,1,0,13,0,-13
15333,1,0,59,0,-59
15334,1,1,117,1391,1274
15335,1,1,1932,1902,-30
15336,1,1,1987,1296,-691
15337,1,1,1249,1485,236
15338,1,0,78,0,-78
15339,0,0,83,0,-83
15340,1,0,107,0,-107
15341,0,0,83,0,-83
15342,1,0,72,0,-72
15343,0,0,181,0,-181
15344,1,1,68,1287,1219
15345,1,1,323,1374,1051
15346,1,0,100,0,-100
15347,0,0,39,0,-39
15348,0,0,17,0,-17
15349,1,0,2,0,-2
15350,0,0,65,0,-65
15351,0,0,31,0,-31
15352,1,1,1241,1366,125
15353,1,1,102,1359,1257
15354,1,0,8,0,-8
15355,0,0,66,0,-66
15356,1,0,0,0,0
15357,0,0,36,0,-36
15358,1,1,277,3447,3170
15359,0,0,32,0,-32
15360,1,0,45,0,-45
15361,0,0,13,0,-13
15362,1,0,101,0,-101
15363,1,1,19,2096,2077
15364,0,0,7,0,-7
15365,1,0,11,0,-11
15366,1,0,1,0,-1
15367,1,1,571,1509,938
15368,1,0,62,0,-62
15369,1,0,4,0,-4
15370,0,0,37,0,-37
15371,1,0,2,0,-2
15372,1,1,591,1311,720
15373,1,1,660,1538,878
15374,0,0,27,0,-27
15375,0,0,213,0,-213
15376,1,1,709,1466,757
15377,1,0,31,0,-31
15378,1,0,0,0,0
15379,1,1,203,4137,3934
15380,1,0,1,0,-1
15381,0,0,3,0,-3
15382,1,0,63,0,-63
15383,0,0,74,0,-74
15384,1,1,1699,1818,119
15385,0,0,83,0,-83
15386,0,0,161,0,-161
15387,0,0,102,0,-102
15388,1,1,29,1423,1394
15389,0,0,24,0,-24
15390,0,0,59,0,-59
15391,1,0,51,0,-51
15392,1,1,731,1302,571
15393,1,1,661,1235,574
15394,0,0,3,0,-3
15395,1,0,80,0,-80
15396,0,0,142,0,-142
15397,1,1,38,1254,1216
15398,0,0,157,0,-157
15399,1,0,16,0,-16
15400,0,0,27,0,-27
15401,0,0,9,0,-9
15402,1,1,516,1443,927
15403,0,0,32,0,-32
15404,0,0,34,0,-34
15405,0,0,32,0,-32
15406,1,0,72,0,-72
15407,1,0,26,0,-26
15408,0,0,6,0,-6
15409,0,0,15,0,-15
15410,1,0,96,0,-96
15411,0,0,59,0,-59
15412,1,1,153,1494,1341
15413,0,0,0,0,0
15414,0,0,32,0,-32
15415,0,0,93,0,-93
15416,0,0,94,0,-94
15417,1,0,96,0,-96
15418,1,0,17,0,-17
15419,1,0,11,0,-11
15420,1,1,529,1285,756
15421,1,0,41,0,-41
15422,1,1,444,1566,1122
15423,0,0,26,0,-26
15424,1,1,505,1937,1432
15425,0,0,13,0,-13
15426,0,0,69,0,-69
15427,1,1,436,1527,1091
15428,1,1,163,1711,1548
15429,0,0,6,0,-6
15430,0,0,82,0,-82
15431,0,0,23,0,-23
15432,1,1,587,1419,832
15433,1,1,335,1379,1044
15434,1,1,70,1649,1579
15435,1,0,50,0,-50
15436,0,0,10,0,-10
15437,0,0,10,0,-10
15438,0,0,26,0,-26
15439,1,0,19,0,-19
15440,1,0,35,0,-35
15441,1,0,25,0,-25
15442,1,0,55,0,-55
15443,0,0,45,0,-45
15444,1,1,487,1357,870
15445,1,1,350,1663,1313
15446,0,0,69,0,-69
15447,1,1,429,1836,1407
15448,1,1,791,2071,1280
15449,1,0,15,0,-15
15450,0,0,9,0,-9
15451,1,0,88,0,-88
15452,1,1,342,1547,1205
15453,0,0,2,0,-2
15454,1,0,17,0,-17
15455,0,0,37,0,-37
15456,1,0,12,0,-12
15457,1,1,1487,1339,-148
15458,0,0,22,0,-22
15459,1,0,3,0,-3
15460,1,0,50,0,-50
15461,1,1,779,1413,634
15462,0,0,79,0,-79
15463,1,0,8,0,-8
15464,1,1,161,1272,1111
15465,1,1,843,1298,455
15466,0,0,35,0,-35
15467,1,0,7,0,-7
15468,0,0,7,0,-7
15469,0,0,54,0,-54
15470,1,0,2,0,-2
15471,0,0,90,0,-90
15472,1,0,22,0,-22
15473,1,0,24,0,-24
15474,1,1,67,1759,1692
15475,0,0,165,0,-165
15476,0,0,41,0,-41
15477,1,0,75,0,-75
15478,0,0,30,0,-30
15479,1,0,6,0,-6
15480,1,0,45,0,-45
15481,0,0,28,0,-28
15482,1,1,386,1590,1204
15483,1,1,86,1468,1382
15484,0,0,21,0,-21
15485,0,0,82,0,-82
15486,0,0,76,0,-76
15487,0,0,28,0,-28
15488,1,1,841,1808,967
15489,0,0,26,0,-26
15490,1,1,223,2218,1995
15491,1,0,200,0,-200
15492,1,0,22,0,-22
15493,1,0,5,0,-5
15494,1,1,1056,1654,598
15495,0,0,51,0,-51
15496,1,0,33,0,-33
15497,1,1,173,1241,1068
15498,1,0,28,0,-28
15499,0,0,72,0,-72
15500,0,0,0,0,0
15501,0,0,1,0,-1
15502,0,0,30,0,-30
15503,1,0,33,0,-33
15504,0,0,3,0,-3
15505,0,0,54,0,-54
15506,1,1,14,1660,1646
15507,0,0,44,0,-44
15508,1,0,19,0,-19
15509,1,1,477,1342,865
15510,0,0,94,0,-94
15511,1,1,614,1858,1244
15512,0,0,113,0,-113
15513,0,0,71,0,-71
15514,1,0,17,0,-17
15515,1,1,421,1362,941
15516,1,1,676,1290,614
15517,1,1,64,1745,1681
15518,1,0,8,0,-8
15519,0,0,36,0,-36
15520,1,0,62,0,-62
15521,0,0,64,0,-64
15522,0,0,212,0,-212
15523,0,0,41,0,-41
15524,1,0,3,0,-3
15525,1,1,369,1386,1017
15526,0,0,0,0,0
15527,0,0,28,0,-28
15528,1,1,67,1305,1238
15529,1,1,155,1937,1782
15530,1,1,138,1413,1275
15531,1,1,146,1503,1357
15532,1,0,14,0,-14
15533,1,0,65,0,-65
15534,1,0,1,0,-1
15535,0,0,66,0,-66
15536,1,0,7,0,-7
15537,0,0,37,0,-37
15538,0,0,112,0,-112
15539,0,0,113,0,-113
15540,0,0,26,0,-26
15541,0,0,52,0,-52
15542,1,1,316,1535,1219
15543,1,1,636,1242,606
15544,1,1,126,1342,1216
15545,0,0,7,0,-7
15546,1,0,124,0,-124
15547,1,0,35,0,-35
15548,1,0,39,0,-39
15549,1,0,57,0,-57
15550,1,0,40,0,-40
15551,1,1,558,1296,738
15552,1,0,48,0,-48
15553,1,0,58,0,-58
15554,1,0,121,0,-121
15555,1,1,246,1310,1064
15556,1,0,11,0,-11
15557,0,0,41,0,-41
15558,1,1,218,1729,1511
15559,1,1,1506,1409,-97
15560,1,0,50,0,-50
15561,1,0,22,0,-22
15562,0,0,19,0,-19
15563,1,0,15,0,-15
15564,1,1,122,1339,1217
15565,1,0,89,0,-89
15566,1,0,0,0,0
15567,0,0,120,0,-120
15568,1,0,10,0,-10
15569,1,0,4,0,-4
15570,0,0,5,0,-5
15571,0,0,21,0,-21
15572,1,1,200,1958,1758
15573,0,0,36,0,-36
15574,0,0,209,0,-209
15575,1,0,6,0,-6
15576,1,0,308,0,-308
15577,1,1,72,1288,1216
15578,0,0,41,0,-41
15579,1,1,1734,1245,-489
15580,1,0,38,0,-38
15581,1,1,777,1577,800
15582,1,0,2,0,-2
15583,1,0,8,0,-8
15584,0,0,11,0,-11
15585,0,0,57,0,-57
15586,1,1,66,1456,1390
15587,1,1,1020,1426,406
15588,0,0,15,0,-15
15589,1,0,113,0,-113
15590,0,0,90,0,-90
15591,0,0,48,0,-48
15592,1,0,46,0,-46
15593,0,0,78,0,-78
15594,1,1,1258,1341,83
15595,0,0,60,0,-60
15596,0,0,9,0,-9
15597,1,1,499,1322,823
15598,1,1,77,1454,1377
15599,1,1,182,1508,1326
15600,1,0,97,0,-97
15601,1,1,1313,1688,375
15602,1,1,219,1550,1331
15603,1,1,3246,1631,-1615
15604,0,0,88,0,-88
15605,1,0,21,0,-21
15606,1,1,517,1364,847
15607,0,0,15,0,-15
15608,1,0,38,0,-38
15609,0,0,27,0,-27
15610,1,0,68,0,-68
15611,1,0,139,0,-139
15612,1,0,152,0,-152
15613,1,1,323,1329,1006
15614,1,1,1301,1367,66
15615,1,0,4,0,-4
15616,1,1,538,2012,1474
15617,1,1,369,1287,918
15618,1,0,36,0,-36
15619,1,0,9,0,-9
15620,0,0,24,0,-24
15621,1,1,201,1375,1174
15622,0,0,9,0,-9
15623,0,0,48,0,-48
15624,1,1,38,1310,1272
15625,1,1,509,1245,736
15626,1,1,1212,1651,439
15627,1,1,49,1247,1198
15628,1,0,89,0,-89
15629,0,0,8,0,-8
15630,1,0,36,0,-36
15631,1,1,273,1273,1000
15632,1,0,106,0,-106
15633,1,1,222,1235,1013
15634,1,1,1371,1691,320
15635,0,0,64,0,-64
15636,0,0,30,0,-30
15637,1,0,81,0,-81
15638,1,1,628,1377,749
15639,0,0,13,0,-13
15640,1,0,54,0,-54
15641,0,0,6,0,-6
15642,1,1,593,1585,992
15643,0,0,40,0,-40
15644,1,1,158,1478,1320
15645,0,0,37,0,-37
15646,1,1,177,1498,1321
15647,1,0,141,0,-141
15648,1,0,31,0,-31
15649,0,0,20,0,-20
15650,1,1,774,2102,1328
15651,0,0,52,0,-52
15652,1,0,98,0,-98
15653,1,1,1206,1988,782
15654,1,1,482,1269,787
15655,1,1,166,1328,1162
15656,0,0,64,0,-64
15657,1,0,9,0,-9
15658,1,0,15,0,-15
15659,1,1,511,1292,781
15660,1,0,2,0,-2
15661,0,0,1,0,-1
15662,0,0,94,0,-94
15663,1,1,258,1273,1015
15664,1,1,934,1241,307
15665,1,1,94,1573,1479
15666,0,0,2,0,-2
15667,1,0,0,0,0
15668,0,0,19,0,-19
15669,1,1,611,2924,2313
15670,0,0,17,0,-17
15671,1,0,0,0,0
15672,1,0,59,0,-59
15673,1,0,7,0,-7
15674,0,0,5,0,-5
15675,0,0,53,0,-53
15676,0,0,155,0,-155
15677,1,0,53,0,-53
15678,1,0,180,0,-180
15679,0,0,1,0,-1
15680,0,0,1,0,-1
15681,1,0,23,0,-23
15682,1,0,12,0,-12
15683,1,0,94,0,-94
15684,1,1,699,1377,678
15685,1,0,113,0,-113
15686,1,1,1027,1717,690
15687,1,1,67,1468,1401
15688,0,0,70,0,-70
15689,0,0,128,0,-128
15690,0,0,35,0,-35
15691,1,0,3,0,-3
15692,0,0,2,0,-2
15693,0,0,8,0,-8
15694,0,0,33,0,-33
15695,1,0,113,0,-113
15696,1,0,32,0,-32
15697,0,0,9,0,-9
15698,0,0,16,0,-16
15699,1,0,83,0,-83
15700,1,0,29,0,-29
15701,1,1,279,2424,2145
15702,1,1,632,1629,997
15703,0,0,97,0,-97
15704,1,1,645,1330,685
15705,0,0,5,0,-5
15706,0,0,89,0,-89
15707,0,0,179,0,-179
15708,0,0,75,0,-75
15709,0,0,56,0,-56
15710,0,0,57,0,-57
15711,1,1,198,1246,1048
15712,1,1,2116,1678,-438
15713,0,0,44,0,-44
15714,1,0,69,0,-69
15715,0,0,2,0,-2
15716,0,0,68,0,-68
15717,1,0,1,0,-1
15718,0,0,61,0,-61
15719,1,0,136,0,-136
15720,0,0,10,0,-10
15721,1,0,127,0,-127
15722,1,1,1582,1600,18
15723,1,0,6,0,-6
15724,0,0,70,0,-70
15725,1,0,21,0,-21
15726,0,0,8,0,-8
15727,0,0,6,0,-6
15728,1,1,1619,1377,-242
15729,1,0,33,0,-33
15730,1,1,730,2044,1314
15731,0,0,47,0,-47
15732,0,0,23,0,-23
15733,0,0,26,0,-26
15734,0,0,3,0,-3
15735,0,0,40,0,-40
15736,0,0,5,0,-5
15737,1,0,40,0,-40
15738,0,0,53,0,-53
15739,1,1,658,2307,1649
15740,1,1,1019,1245,226
15741,0,0,10,0,-10
15742,0,0,7,0,-7
15743,0,0,20,0,-20
15744,0,0,9,0,-9
15745,0,0,3,0,-3
15746,0,0,36,0,-36
15747,1,1,3491,3631,140
15748,0,0,39,0,-39
15749,1,1,434,1605,1171
15750,0,0,12,0,-12
15751,1,1,479,1454,975
15752,0,0,38,0,-38
15753,1,0,38,0,-38
15754,1,0,18,0,-18
15755,1,1,361,1247,886
15756,0,0,20,0,-20
15757,1,0,1,0,-1
15758,0,0,60,0,-60
15759,0,0,106,0,-106
15760,0,0,55,0,-55
15761,0,0,7,0,-7
15762,1,0,27,0,-27
15763,0,0,35,0,-35
15764,1,1,358,1723,1365
15765,1,1,214,1275,1061
15766,0,0,0,0,0
15767,1,0,15,0,-15
15768,1,0,4,0,-4
15769,1,1,89,1347,1258
15770,1,0,39,0,-39
15771,1,0,41,0,-41
15772,1,1,793,1440,647
15773,1,1,722,1257,535
15774,1,0,33,0,-33
15775,1,1,539,1783,1244
15776,1,1,114,1427,1313
15777,0,0,1,0,-1
15778,0,0,90,0,-90
15779,1,1,109,1594,1485
15780,1,1,40,1272,1232
15781,0,0,19,0,-19
15782,1,1,578,1336,758
15783,1,0,9,0,-9
15784,0,0,8,0,-8
15785,1,1,219,1239,1020
15786,0,0,59,0,-59
15787,1,1,141,1546,1405
15788,1,1,377,1257,880
15789,1,0,0,0,0
15790,1,0,32,0,-32
15791,0,0,2,0,-2
15792,0,0,50,0,-50
15793,1,0,19,0,-19
15794,1,0,59,0,-59
15795,0,0,8,0,-8
15796,0,0,42,0,-42
15797,1,0,10,0,-10
15798,1,1,1513,1591,78
15799,1,1,3642,1613,-2029
15800,1,1,1071,1498,427
15801,1,1,45,1571,1526
15802,0,0,2,0,-2
15803,1,0,2,0,-2
15804,0,0,7,0,-7
15805,0,0,32,0,-32
15806,1,0,64,0,-64
15807,0,0,219,0,-219
15808,0,0,64,0,-64
15809,0,0,3,0,-3
15810,0,0,17,0,-17
15811,0,0,17,0,-17
15812,0,0,23,0,-23
15813,1,1,480,1590,1110
15814,1,1,157,1270,1113
15815,0,0,19,0,-19
15816,1,0,110,0,-110
15817,1,0,39,0,-39
15818,1,1,630,1296,666
15819,1,1,449,2622,2173
15820,0,0,23,0,-23
15821,0,0,102,0,-102
15822,0,0,11,0,-11
15823,1,1,179,2657,2478
15824,1,0,2,0,-2
15825,1,1,421,1509,1088
15826,0,0,47,0,-47
15827,1,1,583,1544,961
15828,0,0,13,0,-13
15829,1,1,619,1268,649
15830,1,1,1381,1240,-141
15831,0,0,14,0,-14
15832,0,0,6,0,-6
15833,0,0,41,0,-41
15834,0,0,67,0,-67
15835,1,0,10,0,-10
15836,0,0,35,0,-35
15837,1,1,400,1774,1374
15838,1,0,15,0,-15
15839,1,1,661,1732,1071
15840,1,0,8,0,-8
15841,1,1,680,1714,1034
15842,1,1,534,1731,1197
15843,0,0,20,0,-20
15844,1,0,8,0,-8
15845,0,0,56,0,-56
15846,1,1,415,1862,1447
15847,1,0,108,0,-108
15848,1,1,367,1270,903
15849,1,0,3,0,-3
15850,0,0,8,0,-8
15851,0,0,251,0,-251
15852,1,0,10,0,-10
15853,1,0,83,0,-83
15854,1,0,13,0,-13
15855,0,0,123,0,-123
15856,1,1,404,1312,908
15857,1,1,138,1297,1159
15858,1,0,4,0,-4
15859,1,1,128,1245,1117
15860,0,0,28,0,-28
15861,1,0,4,0,-4
15862,1,1,405,1523,1118
15863,0,0,43,0,-43
15864,1,0,0,0,0
15865,0,0,11,0,-11
15866,0,0,63,0,-63
15867,0,0,16,0,-16
15868,0,0,17,0,-17
15869,1,1,108,1391,1283
15870,1,0,26,0,-26
15871,0,0,156,0,-156
15872,1,0,244,0,-244
15873,1,1,428,2080,1652
15874,0,0,107,0,-107
15875,1,0,69,0,-69
15876,1,1,208,1356,1148
15877,0,0,29,0,-29
15878,0,0,28,0,-28
15879,0,0,5,0,-5
15880,0,0,64,0,-64
15881,0,0,19,0,-19
15882,1,1,299,2407,2108
15883,1,1,152,1855,1703
15884,0,0,91,0,-91
15885,1,0,0,0,0
15886,0,0,3,0,-3
15887,1,0,52,0,-52
15888,0,0,63,0,-63
15889,1,1,257,1303,1046
15890,0,0,89,0,-89
15891,0,0,57,0,-57
15892,1,1,493,2501,2008
15893,1,0,8,0,-8
15894,1,1,339,1259,920
15895,1,1,286,1263,977
15896,1,1,577,1353,776
15897,1,1,103,1830,1727
15898,1,1,978,1297,319
15899,0,0,49,0,-49
15900,0,0,115,0,-115
15901,1,1,242,1265,1023
15902,0,0,48,0,-48
15903,0,0,34,0,-34
15904,1,0,76,0,-76
15905,1,0,24,0,-24
15906,0,0,33,0,-33
15907,1,0,83,0,-83
15908,0,0,44,0,-44
15909,0,0,4,0,-4
15910,1,1,75,1423,1348
15911,1,1,139,1494,1355
15912,1,0,9,0,-9
15913,0,0,85,0,-85
15914,0,0,16,0,-16
15915,0,0,31,0,-31
15916,0,0,46,0,-46
15917,0,0,33,0,-33
15918,1,1,1100,4698,3598
15919,1,1,235,1293,1058
15920,1,0,57,0,-57
15921,0,0,8,0,-8
15922,0,0,7,0,-7
15923,1,0,41,0,-41
15924,0,0,6,0,-6
15925,1,1,375,1364,989
15926,0,0,19,0,-19
15927,0,0,4,0,-4
15928,0,0,68,0,-68
15929,0,0,67,0,-67
15930,0,0,2,0,-2
15931,1,0,74,0,-74
15932,1,0,69,0,-69
15933,0,0,162,0,-162
15934,1,1,2360,1274,-1086
15935,1,0,138,0,-138
15936,1,0,29,0,-29
15937,0,0,108,0,-108
15938,1,0,125,0,-125
15939,0,0,113,0,-113
15940,1,0,19,0,-19
15941,0,0,28,0,-28
15942,1,1,86,1299,1213
15943,0,0,77,0,-77
15944,0,0,7,0,-7
15945,1,1,419,1474,1055
15946,1,1,72,2044,1972
15947,1,0,7,0,-7
15948,1,0,17,0,-17
15949,0,0,25,0,-25
15950,1,0,89,0,-89
15951,1,1,750,1374,624
15952,1,1,2735,2087,-648
15953,0,0,23,0,-23
15954,1,0,63,0,-63
15955,1,0,40,0,-40
15956,0,0,122,0,-122
15957,1,1,237,1286,1049
15958,0,0,169,0,-169
15959,1,1,317,2239,1922
15960,1,0,5,0,-5
15961,1,0,161,0,-161
15962,1,1,560,1450,890
15963,1,1,765,1485,720
15964,1,0,39,0,-39
15965,1,0,3,0,-3
15966,1,1,1331,2659,1328
15967,1,1,596,4181,3585
15968,1,0,5,0,-5
15969,1,0,107,0,-107
15970,0,0,13,0,-13
15971,0,0,8,0,-8
15972,0,0,27,0,-27
15973,1,0,2,0,-2
15974,1,0,316,0,-316
15975,0,0,194,0,-194
15976,0,0,29,0,-29
15977,1,1,851,1263,412
15978,1,0,103,0,-103
15979,0,0,5,0,-5
15980,1,0,122,0,-122
15981,0,0,16,0,-16
15982,0,0,122,0,-122
15983,1,0,13,0,-13
15984,0,0,32,0,-32
15985,0,0,16,0,-16
15986,1,0,56,0,-56
15987,1,0,18,0,-18
15988,0,0,5,0,-5
15989,1,0,30,0,-30
15990,0,0,165,0,-165
15991,1,1,44,1283,1239
15992,1,1,516,2548,2032
15993,1,0,10,0,-10
15994,0,0,56,0,-56
15995,1,1,295,1845,1550
15996,1,0,20,0,-20
15997,1,0,41,0,-41
15998,0,0,159,0,-159
15999,0,0,47,0,-47
16000,0,0,2,0,-2
16001,0,0,32,0,-32
16002,1,0,187,0,-187
16003,1,0,1,0,-1
16004,1,1,1353,1646,293
16005,0,0,1,0,-1
16006,1,0,14,0,-14
16007,0,0,6,0,-6
16008,1,0,353,0,-353
16009,0,0,15,0,-15
16010,0,0,2,0,-2
16011,0,0,91,0,-91
16012,1,0,69,0,-69
16013,0,0,9,0,-9
16014,1,1,211,1369,1158
16015,0,0,1,0,-1
16016,0,0,15,0,-15
16017,1,1,582,1444,862
16018,0,0,22,0,-22
16019,1,1,102,1292,1190
16020,1,0,64,0,-64
16021,1,1,575,2517,1942
16022,0,0,49,0,-49
16023,1,0,90,0,-90
16024,0,0,73,0,-73
16025,1,1,57,3610,3553
16026,1,0,39,0,-39
16027,0,0,0,0,0
16028,0,0,54,0,-54
16029,1,0,38,0,-38
16030,0,0,15,0,-15
16031,0,0,251,0,-251
16032,0,0,295,0,-295
16033,1,1,649,1863,1214
16034,0,0,3,0,-3
16035,0,0,88,0,-88
16036,1,1,1688,1709,21
16037,1,0,22,0,-22
16038,1,1,226,1507,1281
16039,1,0,34,0,-34
16040,0,0,107,0,-107
16041,0,0,47,0,-47
16042,0,0,77,0,-77
16043,0,0,54,0,-54
16044,1,1,421,3344,2923
16045,0,0,43,0,-43
16046,1,1,735,1438,703
16047,1,0,35,0,-35
16048,0,0,23,0,-23
16049,1,1,246,3937,3691
16050,0,0,4,0,-4
16051,1,1,212,1347,1135
16052,1,1,236,1441,1205
16053,1,1,344,1247,903
16054,1,0,44,0,-44
16055,1,1,105,1331,1226
16056,0,0,74,0,-74
16057,0,0,20,0,-20
16058,0,0,17,0,-17
16059,0,0,67,0,-67
16060,0,0,19,0,-19
16061,1,1,231,1253,1022
16062,1,0,5,0,-5
16063,1,1,162,1345,1183
16064,1,1,334,1243,909
16065,1,0,62,0,-62
16066,0,0,22,0,-22
16067,0,0,76,0,-76
16068,1,1,106,1408,1302
16069,0,0,21,0,-21
16070,1,0,2,0,-2
16071,1,0,27,0,-27
16072,0,0,32,0,-32
16073,0,0,29,0,-29
16074,1,0,79,0,-79
16075,1,1,339,2064,1725
16076,1,1,124,1285,1161
16077,1,1,907,1649,742
16078,1,0,45,0,-45
16079,1,0,8,0,-8
16080,1,0,62,0,-62
16081,1,1,497,1542,1045
16082,0,0,36,0,-36
16083,1,0,114,0,-114
16084,1,0,76,0,-76
16085,1,0,57,0,-57
16086,0,0,260,0,-260
16087,1,1,768,1265,497
16088,0,0,12,0,-12
16089,0,0,3,0,-3
16090,0,0,61,0,-61
16091,0,0,11,0,-11
16092,0,0,58,0,-58
16093,1,0,1,0,-1
16094,1,0,12,0,-12
16095,0,0,16,0,-16
16096,1,1,840,1462,622
16097,1,1,334,1743,1409
16098,0,0,105,0,-105
16099,0,0,9,0,-9
16100,1,0,30,0,-30
16101,1,0,0,0,0
16102,0,0,93,0,-93
16103,0,0,87,0,-87
16104,1,1,169,3438,3269
16105,0,0,14,0,-14
16106,1,1,143,1415,1272
16107,0,0,18,0,-18
16108,1,1,390,1384,994
16109,0,0,37,0,-37
16110,1,0,95,0,-95
16111,1,1,244,1266,1022
16112,1,1,929,1394,465
16113,0,0,137,0,-137
16114,1,1,391,1789,1398
16115,1,1,209,1544,1335
16116,1,0,1,0,-1
16117,0,0,38,0,-38
16118,1,1,374,1439,1065
16119,1,1,85,1238,1153
16120,1,1,744,3341,2597
16121,0,0,44,0,-44
16122,1,1,436,1712,1276
16123,1,0,71,0,-71
16124,1,1,317,1529,1212
16125,1,1,303,1294,991
16126,1,1,1818,2008,190
16127,1,1,219,1455,1236
16128,0,0,66,0,-66
16129,0,0,2,0,-2
16130,0,0,13,0,-13
16131,1,0,57,0,-57
16132,1,1,982,1324,342
16133,1,1,56,1281,1225
16134,1,0,100,0,-100
16135,1,0,28,0,-28
16136,0,0,52,0,-52
16137,1,0,76,0,-76
16138,1,1,282,1751,1469
16139,1,1,520,2166,1646
16140,1,0,134,0,-134
16141,1,0,19,0,-19
16142,0,0,9,0,-9
16143,1,0,3,0,-3
16144,1,0,8,0,-8
16145,1,0,0,0,0
16146,1,0,106,0,-106
16147,1,1,488,1599,1111
16148,0,0,8,0,-8
16149,1,1,544,3489,2945
16150,1,1,139,1720,1581
16151,1,0,53,0,-53
16152,0,0,26,0,-26
16153,1,0,61,0,-61
16154,1,0,43,0,-43
16155,0,0,60,0,-60
16156,1,0,38,0,-38
16157,0,0,179,0,-179
16158,1,1,272,1600,1328
16159,1,1,426,1372,946
16160,1,1,493,1597,1104
16161,1,0,25,0,-25
16162,1,0,36,0,-36
16163,0,0,176,0,-176
16164,0,0,112,0,-112
16165,0,0,11,0,-11
16166,0,0,35,0,-35
16167,0,0,18,0,-18
16168,1,1,281,1300,1019
16169,0,0,167,0,-167
16170,1,0,35,0,-35
16171,0,0,32,0,-32
16172,1,0,119,0,-119
16173,1,0,9,0,-9
16174,0,0,1,0,-1
16175,0,0,104,0,-104
16176,1,1,45,2040,1995
16177,0,0,26,0,-26
16178,1,0,57,0,-57
16179,1,0,143,0,-143
16180,1,0,75,0,-75
16181,0,0,26,0,-26
16182,1,1,56,2007,1951
16183,0,0,8,0,-8
16184,0,0,12,0,-12
16185,1,0,70,0,-70
16186,0,0,28,0,-28
16187,0,0,12,0,-12
16188,1,1,207,1455,1248
16189,0,0,137,0,-137
16190,1,1,343,1360,1017
16191,1,0,103,0,-103
16192,1,1,744,1304,560
16193,0,0,37,0,-37
16194,1,0,153,0,-153
16195,1,1,696,1675,979
16196,1,0,7,0,-7
16197,1,0,111,0,-111
16198,1,0,42,0,-42
16199,0,0,81,0,-81
16200,1,1,314,1427,1113
16201,1,0,30,0,-30
16202,1,1,211,1793,1582
16203,1,0,93,0,-93
16204,1,0,27,0,-27
16205,1,1,390,1457,1067
16206,1,0,11,0,-11
16207,0,0,71,0,-71
16208,1,0,3,0,-3
16209,1,1,437,1661,1224
16210,1,0,22,0,-22
16211,0,0,8,0,-8
16212,0,0,145,0,-145
16213,0,0,47,0,-47
16214,0,0,2,0,-2
16215,0,0,83,0,-83
16216,1,1,693,1552,859
16217,1,1,830,2983,2153
16218,0,0,76,0,-76
16219,1,0,111,0,-111
16220,0,0,4,0,-4
16221,0,0,50,0,-50
16222,1,1,189,1494,1305
16223,0,0,116,0,-116
16224,1,1,249,1251,1002
16225,1,1,208,1441,1233
16226,0,0,77,0,-77
16227,1,0,16,0,-16
16228,0,0,25,0,-25
16229,0,0,13,0,-13
16230,0,0,25,0,-25
16231,0,0,55,0,-55
16232,0,0,39,0,-39
16233,1,0,77,0,-77
16234,0,0,1,0,-1
16235,0,0,53,0,-53
16236,1,1,428,1243,815
16237,1,0,36,0,-36
16238,1,0,81,0,-81
16239,1,1,352,1409,1057
16240,0,0,9,0,-9
16241,1,1,1413,1357,-56
16242,0,0,2,0,-2
16243,1,1,256,1245,989
16244,1,1,563,1301,738
16245,1,0,59,0,-59
16246,0,0,3,0,-3
16247,0,0,58,0,-58
16248,1,1,102,1279,1177
16249,1,1,116,1235,1119
16250,1,1,674,1727,1053
16251,1,1,91,2651,2560
16252,1,0,113,0,-113
16253,0,0,4,0,-4
16254,1,0,33,0,-33
16255,1,1,1225,1583,358
16256,1,0,86,0,-86
16257,1,1,196,1427,1231
16258,0,0,4,0,-4
16259,1,0,14,0,-14
16260,0,0,41,0,-41
16261,1,0,30,0,-30
16262,1,1,426,1467,1041
16263,1,1,1956,1933,-23
16264,0,0,119,0,-119
16265,1,1,943,1292,349
16266,1,0,96,0,-96
16267,1,1,852,1319,467
16268,1,0,131,0,-131
16269,1,1,116,1274,1158
16270,1,1,1211,1516,305
16271,0,0,20,0,-20
16272,0,0,42,0,-42
16273,1,0,107,0,-107
16274,1,1,138,1457,1319
16275,0,0,70,0,-70
16276,1,1,640,1252,612
16277,1,1,296,1305,1009
16278,0,0,2,0,-2
16279,1,0,5,0,-5
16280,0,0,2,0,-2
16281,0,0,135,0,-135
16282,1,1,436,1514,1078
16283,1,0,27,0,-27
16284,1,0,9,0,-9
16285,0,0,7,0,-7
16286,0,0,6,0,-6
16287,1,0,109,0,-109
16288,1,1,107,1424,1317
16289,0,0,38,0,-38
16290,1,0,15,0,-15
16291,1,1,93,1255,1162
16292,0,0,100,0,-100
16293,1,0,7,0,-7
16294,1,1,257,1248,991
16295,0,0,18,0,-18
16296,1,0,128,0,-128
16297,0,0,111,0,-111
16298,0,0,29,0,-29
16299,0,0,4,0,-4
16300,1,1,501,1270,769
16301,0,0,35,0,-35
16302,1,0,9,0,-9
16303,0,0,29,0,-29
16304,0,0,57,0,-57
16305,1,1,122,1570,1448
16306,0,0,69,0,-69
16307,0,0,69,0,-69
16308,1,0,41,0,-41
16309,1,0,114,0,-114
16310,1,1,832,1274,442
16311,0,0,20,0,-20
16312,1,0,3,0,-3
16313,1,0,94,0,-94
16314,1,0,9,0,-9
16315,1,0,232,0,-232
16316,1,1,244,1475,1231
16317,1,0,70,0,-70
16318,0,0,34,0,-34
16319,1,0,77,0,-77
16320,0,0,4,0,-4
16321,0,0,71,0,-71
16322,1,0,2,0,-2
16323,0,0,80,0,-80
16324,1,0,22,0,-22
16325,1,0,22,0,-22
16326,0,0,291,0,-291
16327,0,0,9,0,-9
16328,1,0,19,0,-19
16329,1,0,96,0,-96
16330,0,0,6,0,-6
16331,1,1,161,1755,1594
16332,0,0,29,0,-29
16333,0,0,30,0,-30
16334,1,0,263,0,-263
16335,1,0,2,0,-2
16336,1,0,6,0,-6
16337,0,0,66,0,-66
16338,1,0,52,0,-52
16339,1,1,2671,1362,-1309
16340,1,0,3,0,-3
16341,0,0,0,0,0
16342,0,0,10,0,-10
16343,1,0,97,0,-97
16344,0,0,20,0,-20
16345,0,0,5,0,-5
16346,0,0,11,0,-11
16347,1,1,822,1540,718
16348,1,1,246,1263,1017
16349,1,1,508,1390,882
16350,0,0,0,0,0
16351,1,0,287,0,-287
16352,1,0,80,0,-80
16353,1,1,1159,2346,1187
16354,1,1,957,1438,481
16355,0,0,20,0,-20
16356,1,1,572,1396,824
16357,0,0,43,0,-43
16358,1,0,26,0,-26
16359,1,0,0,0,0
16360,0,0,19,0,-19
16361,0,0,100,0,-100
16362,1,1,1412,1361,-51
16363,1,1,1042,1487,445
16364,1,1,653,2443,1790
16365,0,0,77,0,-77
16366,0,0,38,0,-38
16367,1,0,121,0,-121
16368,0,0,103,0,-103
16369,1,0,0,0,0
16370,1,1,480,1409,929
16371,0,0,12,0,-12
16372,1,1,672,1738,1066
16373,0,0,7,0,-7
16374,1,1,1148,1252,104
16375,0,0,108,0,-108
16376,0,0,117,0,-117
16377,0,0,6,0,-6
16378,0,0,147,0,-147
16379,0,0,18,0,-18
16380,1,0,87,0,-87
16381,0,0,2,0,-2
16382,0,0,14,0,-14
16383,1,1,329,1410,1081
16384,0,0,72,0,-72
16385,1,1,231,1256,1025
16386,1,1,1777,2335,558
16387,0,0,49,0,-49
16388,1,1,850,1521,671
16389,0,0,25,0,-25
16390,1,1,1194,1372,178
16391,0,0,36,0,-36
16392,1,0,10,0,-10
16393,0,0,67,0,-67
16394,1,0,43,0,-43
16395,1,0,266,0,-266
16396,1,1,567,1480,913
16397,1,0,63,0,-63
16398,1,1,39,1248,1209
16399,0,0,44,0,-44
16400,1,0,82,0,-82
16401,0,0,77,0,-77
16402,0,0,14,0,-14
16403,1,0,37,0,-37
16404,1,0,88,0,-88
16405,1,0,48,0,-48
16406,1,1,115,1852,1737
16407,1,0,2,0,-2
16408,0,0,37,0,-37
16409,0,0,0,0,0
16410,1,0,71,0,-71
16411,0,0,47,0,-47
16412,1,0,17,0,-17
16413,0,0,43,0,-43
16414,0,0,58,0,-58
16415,0,0,20,0,-20
16416,0,0,77,0,-77
16417,1,0,34,0,-34
16418,0,0,46,0,-46
16419,1,1,665,1992,1327
16420,0,0,151,0,-151
16421,1,0,157,0,-157
16422,1,0,6,0,-6
16423,0,0,25,0,-25
16424,0,0,56,0,-56
16425,0,0,77,0,-77
16426,1,1,179,1486,1307
16427,0,0,8,0,-8
16428,0,0,60,0,-60
16429,1,0,17,0,-17
16430,1,1,826,2471,1645
16431,1,1,691,1368,677
16432,1,1,116,1261,1145
16433,1,1,98,1246,1148
16434,0,0,17,0,-17
16435,0,0,50,0,-50
16436,1,1,845,2403,1558
16437,0,0,31,0,-31
16438,1,1,1533,2152,619
16439,1,1,97,2231,2134
16440,0,0,64,0,-64
16441,1,1,46,1305,1259
16442,0,0,81,0,-81
16443,1,1,123,1538,1415
16444,1,0,30,0,-30
16445,1,1,578,1437,859
16446,0,0,60,0,-60
16447,0,0,41,0,-41
16448,0,0,26,0,-26
16449,1,1,323,1241,918
16450,1,0,18,0,-18
16451,0,0,81,0,-81
16452,1,0,6,0,-6
16453,1,0,18,0,-18
16454,1,0,6,0,-6
16455,0,0,21,0,-21
16456,0,0,14,0,-14
16457,0,0,78,0,-78
16458,1,1,515,1683,1168
16459,1,0,76,0,-76
16460,0,0,90,0,-90
16461,0,0,36,0,-36
16462,1,1,84,1270,1186
16463,1,0,1,0,-1
16464,1,0,35,0,-35
16465,1,0,25,0,-25
16466,1,1,67,1502,1435
16467,1,1,277,1540,1263
16468,1,0,29,0,-29
16469,1,0,24,0,-24
16470,1,0,13,0,-13
16471,1,0,31,0,-31
16472,1,1,1531,1425,-106
16473,0,0,74,0,-74
16474,1,1,335,1439,1104
16475,0,0,1,0,-1
16476,1,0,63,0,-63
16477,1,1,1129,1296,167
16478,0,0,97,0,-97
16479,0,0,28,0,-28
16480,1,0,63,0,-63
16481,0,0,42,0,-42
16482,1,1,51,1724,1673
16483,1,0,66,0,-66
16484,0,0,231,0,-231
16485,0,0,20,0,-20
16486,1,0,33,0,-33
16487,1,0,142,0,-142
16488,0,0,29,0,-29
16489,1,0,3,0,-3
16490,0,0,100,0,-100
16491,1,1,442,1340,898
16492,1,0,10,0,-10
16493,1,1,164,1685,1521
16494,1,1,1466,1326,-140
16495,0,0,76,0,-76
16496,1,0,2,0,-2
16497,1,1,922,1819,897
16498,1,1,542,1342,800
16499,1,1,1101,1700,599
16500,0,0,70,0,-70
16501,1,0,85,0,-85
16502,1,0,46,0,-46
16503,1,0,117,0,-117
16504,0,0,53,0,-53
16505,1,1,343,1466,1123
16506,0,0,45,0,-45
16507,1,0,76,0,-76
16508,1,0,55,0,-55
16509,1,1,419,1510,1091
16510,0,0,12,0,-12
16511,0,0,34,0,-34
16512,1,1,164,1452,1288
16513,0,0,210,0,-210
16514,0,0,0,0,0
16515,0,0,27,0,-27
16516,0,0,33,0,-33
16517,0,0,9,0,-9
16518,1,0,50,0,-50
16519,1,0,12,0,-12
16520,0,0,113,0,-113
16521,1,1,254,1428,1174
16522,0,0,36,0,-36
16523,1,1,732,1403,671
16524,1,1,785,1714,929
16525,1,1,96,1303,1207
16526,1,0,23,0,-23
16527,1,1,393,1343,950
16528,0,0,26,0,-26
16529,1,1,662,1262,600
16530,1,0,18,0,-18
16531,0,0,262,0,-262
16532,0,0,6,0,-6
16533,1,0,13,0,-13
16534,0,0,16,0,-16
16535,1,0,76,0,-76
16536,1,0,51,0,-51
16537,1,1,295,1237,942
16538,1,1,922,1339,417
16539,0,0,94,0,-94
16540,1,0,30,0,-30
16541,1,0,46,0,-46
16542,0,0,74,0,-74
16543,1,1,413,1266,853
16544,0,0,149,0,-149
16545,1,0,54,0,-54
16546,1,0,8,0,-8
16547,0,0,82,0,-82
16548,1,0,0,0,0
16549,0,0,72,0,-72
16550,1,1,353,1584,1231
16551,1,0,108,0,-108
16552,1,1,727,1596,869
16553,1,0,85,0,-85
16554,0,0,137,0,-137
16555,1,0,70,0,-70
16556,1,0,141,0,-141
16557,0,0,194,0,-194
16558,0,0,17,0,-17
16559,1,0,27,0,-27
16560,0,0,28,0,-28
16561,1,0,36,0,-36
16562,0,0,19,0,-19
16563,1,1,465,1260,795
16564,0,0,20,0,-20
16565,1,0,64,0,-64
16566,0,0,2,0,-2
16567,1,1,431,1300,869
16568,1,0,30,0,-30
16569,0,0,61,0,-61
16570,0,0,8,0,-8
16571,1,1,119,1299,1180
16572,0,0,56,0,-56
16573,1,0,11,0,-11
16574,0,0,68,0,-68
16575,1,1,572,1601,1029
16576,0,0,124,0,-124
16577,1,1,1262,1333,71
16578,1,0,10,0,-10
16579,1,0,26,0,-26
16580,1,0,66,0,-66
16581,0,0,125,0,-125
16582,1,1,586,1525,939
16583,0,0,20,0,-20
16584,1,0,22,0,-22
16585,0,0,5,0,-5
16586,0,0,14,0,-14
16587,0,0,11,0,-11
16588,1,1,28,1490,1462
16589,1,1,379,1633,1254
16590,1,1,398,1339,941
16591,0,0,213,0,-213
16592,1,0,10,0,-10
16593,1,1,144,1284,1140
16594,0,0,3,0,-3
16595,0,0,29,0,-29
16596,0,0,31,0,-31
16597,1,0,86,0,-86
16598,1,0,17,0,-17
16599,0,0,4,0,-4
16600,0,0,4,0,-4
16601,0,0,70,0,-70
16602,0,0,114,0,-114
16603,1,0,24,0,-24
16604,1,0,94,0,-94
16605,0,0,84,0,-84
16606,1,1,62,1274,1212
16607,1,0,50,0,-50
16608,1,0,5,0,-5
16609,1,1,248,1439,1191
16610,1,1,184,1319,1135
16611,1,1,530,1468,938
16612,0,0,48,0,-48
16613,0,0,73,0,-73
16614,0,0,132,0,-132
16615,0,0,33,0,-33
16616,0,0,68,0,-68
16617,1,1,317,3057,2740
16618,1,1,655,2462,1807
16619,0,0,2,0,-2
16620,1,0,27,0,-27
16621,0,0,13,0,-13
16622,0,0,84,0,-84
16623,1,1,292,1412,1120
16624,1,0,25,0,-25
16625,0,0,76,0,-76
16626,1,1,1177,1415,238
16627,1,0,11,0,-11
16628,1,0,95,0,-95
16629,1,0,26,0,-26
16630,0,0,9,0,-9
16631,0,0,18,0,-18
16632,1,1,474,1622,1148
16633,0,0,12,0,-12
16634,1,0,21,0,-21
16635,0,0,55,0,-55
16636,1,0,31,0,-31
16637,1,0,66,0,-66
16638,1,0,45,0,-45
16639,0,0,13,0,-13
16640,0,0,204,0,-204
16641,0,0,8,0,-8
16642,0,0,36,0,-36
16643,0,0,7,0,-7
16644,1,1,66,2261,2195
16645,1,1,670,1319,649
16646,0,0,29,0,-29
16647,1,0,42,0,-42
16648,0,0,0,0,0
16649,0,0,24,0,-24
16650,1,1,253,1559,1306
16651,0,0,150,0,-150
16652,1,1,668,1467,799
16653,0,0,70,0,-70
16654,1,1,736,1677,941
16655,1,0,24,0,-24
16656,0,0,76,0,-76
16657,1,0,8,0,-8
16658,0,0,31,0,-31
16659,1,1,1075,1910,835
16660,0,0,18,0,-18
16661,1,1,1000,1567,567
16662,1,0,30,0,-30
16663,0,0,35,0,-35
16664,1,0,0,0,0
16665,0,0,0,0,0
16666,1,1,133,1430,1297
16667,1,0,3,0,-3
16668,1,1,257,1284,1027
16669,1,0,46,0,-46
16670,1,0,107,0,-107
16671,1,1,318,2296,1978
16672,1,1,108,1733,1625
16673,1,0,40,0,-40
16674,1,0,161,0,-161
16675,1,0,0,0,0
16676,1,0,35,0,-35
16677,0,0,72,0,-72
16678,1,0,111,0,-111
16679,1,0,42,0,-42
16680,0,0,15,0,-15
16681,1,0,0,0,0
16682,1,0,16,0,-16
16683,0,0,25,0,-25
16684,1,1,377,1303,926
16685,1,0,101,0,-101
16686,1,1,826,1299,473
16687,1,1,194,1807,1613
16688,1,1,133,1269,1136
16689,0,0,65,0,-65
16690,1,0,184,0,-184
16691,0,0,351,0,-351
16692,1,0,21,0,-21
16693,1,0,241,0,-241
16694,1,0,71,0,-71
16695,0,0,3,0,-3
16696,1,0,91,0,-91
16697,0,0,3,0,-3
16698,1,1,339,1260,921
16699,1,0,65,0,-65
16700,0,0,38,0,-38
16701,1,1,816,1682,866
16702,0,0,55,0,-55
16703,0,0,63,0,-63
16704,0,0,31,0,-31
16705,1,0,4,0,-4
16706,1,0,94,0,-94
16707,1,0,50,0,-50
16708,1,0,28,0,-28
16709,1,0,66,0,-66
16710,0,0,19,0,-19
16711,1,1,498,1592,1094
16712,1,1,57,1568,1511
16713,0,0,39,0,-39
16714,1,1,103,1767,1664
16715,1,0,2,0,-2
16716,0,0,27,0,-27
16717,1,1,547,1663,1116
16718,1,1,286,1401,1115
16719,1,1,431,1367,936
16720,1,0,2,0,-2
16721,0,0,37,0,-37
16722,0,0,59,0,-59
16723,1,1,756,1495,739
16724,1,0,95,0,-95
16725,1,0,28,0,-28
16726,1,1,225,1994,1769
16727,0,0,52,0,-52
16728,0,0,54,0,-54
16729,0,0,51,0,-51
16730,1,0,109,0,-109
16731,1,1,664,1946,1282
16732,0,0,203,0,-203
16733,0,0,61,0,-61
16734,1,0,67,0,-67
16735,1,0,114,0,-114
16736,1,0,103,0,-103
16737,1,0,113,0,-113
16738,0,0,132,0,-132
16739,0,0,230,0,-230
16740,1,0,77,0,-77
16741,1,0,8,0,-8
16742,0,0,6,0,-6
16743,0,0,5,0,-5
16744,1,0,31,0,-31
16745,1,0,60,0,-60
16746,1,0,186,0,-186
16747,1,0,35,0,-35
16748,0,0,6,0,-6
16749,1,1,50,1633,1583
16750,0,0,143,0,-143
16751,1,0,63,0,-63
16752,1,0,154,0,-154
16753,0,0,117,0,-117
16754,0,0,29,0,-29
16755,0,0,32,0,-32
16756,1,0,17,0,-17
16757,0,0,2,0,-2
16758,1,1,79,1288,1209
16759,0,0,14,0,-14
16760,0,0,36,0,-36
16761,1,0,15,0,-15
16762,1,0,34,0,-34
16763,1,0,112,0,-112
16764,0,0,10,0,-10
16765,1,1,33,1406,1373
16766,1,0,16,0,-16
16767,0,0,36,0,-36
16768,1,1,247,1293,1046
16769,1,1,1204,1323,119
16770,1,1,555,2346,1791
16771,1,1,588,1280,692
16772,1,1,15,1719,1704
16773,1,0,241,0,-241
16774,1,1,408,1253,845
16775,0,0,1,0,-1
16776,1,0,23,0,-23
16777,1,1,583,1267,684
16778,1,0,17,0,-17
16779,1,0,53,0,-53
16780,0,0,122,0,-122
16781,0,0,1,0,-1
16782,1,1,314,1303,989
16783,0,0,76,0,-76
16784,1,1,327,1275,948
16785,1,1,275,1642,1367
16786,1,0,3,0,-3
16787,1,0,33,0,-33
16788,1,0,63,0,-63
16789,0,0,28,0,-28
16790,1,0,23,0,-23
16791,1,1,192,2020,1828
16792,1,0,8,0,-8
16793,0,0,38,0,-38
16794,0,0,142,0,-142
16795,0,0,5,0,-5
16796,1,1,17,1697,1680
16797,1,1,501,1345,844
16798,1,0,4,0,-4
16799,1,0,34,0,-34
16800,1,0,84,0,-84
16801,0,0,99,0,-99
16802,1,1,817,1327,510
16803,0,0,20,0,-20
16804,0,0,70,0,-70
16805,0,0,8,0,-8
16806,0,0,77,0,-77
16807,1,1,100,1316,1216
16808,0,0,42,0,-42
16809,0,0,9,0,-9
16810,1,1,214,2083,1869
16811,0,0,1,0,-1
16812,1,0,22,0,-22
16813,1,0,50,0,-50
16814,1,1,631,1355,724
16815,0,0,46,0,-46
16816,1,0,10,0,-10
16817,1,1,163,1619,1456
16818,1,0,10,0,-10
16819,1,0,109,0,-109
16820,0,0,45,0,-45
16821,1,0,24,0,-24
16822,0,0,59,0,-59
16823,1,0,43,0,-43
16824,1,1,1041,2006,965
16825,1,0,34,0,-34
16826,1,0,151,0,-151
16827,0,0,4,0,-4
16828,0,0,126,0,-126
16829,0,0,8,0,-8
16830,1,1,31,1907,1876
16831,1,1,806,1428,622
16832,1,1,177,1502,1325
16833,0,0,36,0,-36
16834,0,0,93,0,-93
16835,0,0,64,0,-64
16836,0,0,70,0,-70
16837,1,1,121,1939,1818
16838,1,1,761,1467,706
16839,1,1,344,1738,1394
16840,0,0,71,0,-71
16841,1,1,113,1462,1349
16842,0,0,8,0,-8
16843,1,1,901,2028,1127
16844,1,0,70,0,-70
16845,1,0,111,0,-111
16846,0,0,7,0,-7
16847,1,0,9,0,-9
16848,0,0,126,0,-126
16849,1,0,73,0,-73
16850,0,0,18,0,-18
16851,0,0,52,0,-52
16852,0,0,119,0,-119
16853,0,0,151,0,-151
16854,1,1,242,2020,1778
16855,1,0,2,0,-2
16856,1,1,930,2779,1849
16857,1,1,154,1364,1210
16858,1,0,8,0,-8
16859,1,1,247,1482,1235
16860,1,1,1663,1522,-141
16861,0,0,38,0,-38
16862,0,0,12,0,-12
16863,0,0,18,0,-18
16864,1,1,165,1455,1290
16865,1,1,367,1619,1252
16866,1,1,369,1763,1394
16867,1,0,53,0,-53
16868,0,0,3,0,-3
16869,1,0,202,0,-202
16870,1,1,584,2908,2324
16871,1,1,579,1336,757
16872,0,0,133,0,-133
16873,1,1,727,1335,608
16874,0,0,66,0,-66
16875,0,0,23,0,-23
16876,0,0,59,0,-59
16877,0,0,145,0,-145
16878,1,1,73,1534,1461
16879,1,0,68,0,-68
16880,1,1,256,2009,1753
16881,1,0,48,0,-48
16882,1,1,475,1520,1045
16883,1,0,47,0,-47
16884,1,0,63,0,-63
16885,0,0,140,0,-140
16886,1,0,0,0,0
16887,0,0,8,0,-8
16888,1,0,45,0,-45
16889,0,0,57,0,-57
16890,0,0,4,0,-4
16891,1,0,73,0,-73
16892,1,0,137,0,-137
16893,0,0,85,0,-85
16894,0,0,101,0,-101
16895,0,0,61,0,-61
16896,1,0,41,0,-41
16897,1,0,22,0,-22
16898,0,0,16,0,-16
16899,1,0,5,0,-5
16900,1,0,24,0,-24
16901,0,0,14,0,-14
16902,0,0,58,0,-58
16903,0,0,3,0,-3
16904,0,0,24,0,-24
16905,1,0,35,0,-35
16906,0,0,99,0,-99
16907,1,0,45,0,-45
16908,1,0,19,0,-19
16909,1,0,2,0,-2
16910,0,0,69,0,-69
16911,1,0,8,0,-8
16912,0,0,19,0,-19
16913,1,1,265,1826,1561
16914,1,0,66,0,-66
16915,1,0,305,0,-305
16916,0,0,78,0,-78
16917,1,0,37,0,-37
16918,1,1,236,1337,1101
16919,0,0,66,0,-66
16920,0,0,31,0,-31
16921,1,1,2276,1404,-872
16922,1,1,328,1388,1060
16923,1,0,8,0,-8
16924,0,0,18,0,-18
16925,1,0,38,0,-38
16926,1,1,187,1437,1250
16927,0,0,10,0,-10
16928,0,0,1,0,-1
16929,1,0,84,0,-84
16930,0,0,11,0,-11
16931,0,0,71,0,-71
16932,1,1,1344,1395,51
16933,0,0,73,0,-73
16934,1,0,14,0,-14
16935,1,1,143,1617,1474
16936,0,0,82,0,-82
16937,0,0,41,0,-41
16938,0,0,105,0,-105
16939,1,1,176,1376,1200
16940,0,0,18,0,-18
16941,1,1,172,1236,1064
16942,1,1,573,1384,811
16943,1,0,20,0,-20
16944,1,0,5,0,-5
16945,0,0,161,0,-161
16946,1,1,690,2738,2048
16947,1,1,282,1331,1049
16948,0,0,66,0,-66
16949,0,0,10,0,-10
16950,0,0,70,0,-70
16951,1,0,182,0,-182
16952,1,1,1398,1274,-124
16953,1,1,179,1829,1650
16954,0,0,53,0,-53
16955,0,0,45,0,-45
16956,1,1,431,1391,960
16957,1,1,613,1388,775
16958,1,0,49,0,-49
16959,1,0,79,0,-79
16960,1,1,255,2974,2719
16961,1,1,963,1543,580
16962,1,0,57,0,-57
16963,1,0,95,0,-95
16964,1,1,848,1917,1069
16965,0,0,28,0,-28
16966,0,0,4,0,-4
16967,1,1,39,1654,1615
16968,1,0,74,0,-74
16969,0,0,16,0,-16
16970,1,0,66,0,-66
16971,1,0,12,0,-12
16972,0,0,94,0,-94
16973,1,0,35,0,-35
16974,1,0,41,0,-41
16975,1,0,7,0,-7
16976,0,0,24,0,-24
16977,1,1,201,2383,2182
16978,1,0,1,0,-1
16979,0,0,11,0,-11
16980,1,1,25,1331,1306
16981,1,1,110,1683,1573
16982,1,0,80,0,-80
16983,1,0,95,0,-95
16984,1,0,16,0,-16
16985,1,0,46,0,-46
16986,1,0,23,0,-23
16987,0,0,5,0,-5
16988,1,1,470,1424,954
16989,1,1,297,1331,1034
16990,0,0,19,0,-19
16991,1,1,401,1358,957
16992,0,0,38,0,-38
16993,0,0,45,0,-45
16994,1,1,487,1280,793
16995,1,0,33,0,-33
16996,1,0,10,0,-10
16997,1,1,212,3091,2879
16998,0,0,41,0,-41
16999,1,1,1221,1290,69
17000,1,1,270,1262,992
17001,1,0,2,0,-2
17002,0,0,31,0,-31
17003,0,0,57,0,-57
17004,0,0,27,0,-27
17005,1,1,295,1350,1055
17006,1,0,95,0,-95
17007,1,0,28,0,-28
17008,0,0,27,0,-27
17009,1,1,562,1862,1300
17010,1,0,65,0,-65
17011,1,1,1362,1391,29
17012,1,0,16,0,-16
17013,0,0,4,0,-4
17014,1,0,28,0,-28
17015,0,0,33,0,-33
17016,1,1,67,1243,1176
17017,1,1,2041,1947,-94
17018,0,0,19,0,-19
17019,1,0,8,0,-8
17020,0,0,10,0,-10
17021,1,0,20,0,-20
17022,1,1,190,1713,1523
17023,1,0,8,0,-8
17024,0,0,75,0,-75
17025,0,0,98,0,-98
17026,0,0,57,0,-57
17027,1,1,451,1872,1421
17028,1,1,43,1959,1916
17029,1,1,1851,1486,-365
17030,0,0,81,0,-81
17031,1,1,735,1310,575
17032,0,0,17,0,-17
17033,1,1,460,1346,886
17034,0,0,23,0,-23
17035,0,0,30,0,-30
17036,0,0,7,0,-7
17037,1,1,46,1240,1194
17038,0,0,16,0,-16
17039,0,0,51,0,-51
17040,1,1,947,3846,2899
17041,1,0,22,0,-22
17042,1,0,95,0,-95
17043,1,1,149,1452,1303
17044,0,0,1,0,-1
17045,0,0,24,0,-24
17046,0,0,14,0,-14
17047,0,0,180,0,-180
17048,1,0,15,0,-15
17049,0,0,4,0,-4
17050,0,0,77,0,-77
17051,1,1,291,1354,1063
17052,0,0,34,0,-34
17053,0,0,4,0,-4
17054,0,0,24,0,-24
17055,1,1,689,1326,637
17056,1,0,20,0,-20
17057,1,1,43,1377,1334
17058,0,0,100,0,-100
17059,0,0,46,0,-46
17060,1,0,54,0,-54
17061,0,0,15,0,-15
17062,1,1,398,1426,1028
17063,0,0,28,0,-28
17064,1,0,78,0,-78
17065,1,0,79,0,-79
17066,1,0,24,0,-24
17067,1,0,54,0,-54
17068,0,0,6,0,-6
17069,0,0,49,0,-49
17070,0,0,39,0,-39
17071,0,0,4,0,-4
17072,1,0,38,0,-38
17073,1,0,26,0,-26
17074,1,0,3,0,-3
17075,1,1,834,1663,829
17076,1,1,1175,1514,339
17077,1,0,44,0,-44
17078,1,1,1141,1902,761
17079,1,0,8,0,-8
17080,0,0,0,0,0
17081,1,0,27,0,-27
17082,1,1,211,1814,1603
17083,1,1,176,1369,1193
17084,1,0,109,0,-109
17085,1,0,140,0,-140
17086,1,1,712,1286,574
17087,0,0,50,0,-50
17088,0,0,144,0,-144
17089,0,0,62,0,-62
17090,0,0,8,0,-8
17091,1,1,1840,2000,160
17092,0,0,14,0,-14
17093,1,0,97,0,-97
17094,1,0,28,0,-28
17095,0,0,125,0,-125
17096,0,0,6,0,-6
17097,1,0,44,0,-44
17098,0,0,9,0,-9
17099,1,1,92,1668,1576
17100,1,1,2261,1483,-778
17101,1,0,48,0,-48
17102,1,1,387,1351,964
17103,1,1,190,1308,1118
17104,0,0,124,0,-124
17105,1,0,39,0,-39
17106,0,0,30,0,-30
17107,0,0,12,0,-12
17108,0,0,42,0,-42
17109,1,0,30,0,-30
17110,1,1,1588,2195,607
17111,1,1,491,1319,828
17112,1,0,54,0,-54
17113,1,1,775,1864,1089
17114,1,0,30,0,-30
17115,1,1,230,1396,1166
17116,0,0,71,0,-71
17117,1,0,59,0,-59
17118,1,1,859,2163,1304
17119,0,0,89,0,-89
17120,0,0,3,0,-3
17121,0,0,3,0,-3
17122,1,0,13,0,-13
17123,0,0,23,0,-23
17124,1,1,538,1948,1410
17125,1,1,617,1324,707
17126,1,0,90,0,-90
17127,1,1,331,1268,937
17128,0,0,13,0,-13
17129,1,0,16,0,-16
17130,0,0,28,0,-28
17131,0,0,179,0,-179
17132,1,0,52,0,-52
17133,1,0,30,0,-30
17134,1,1,1393,3234,1841
17135,1,1,1226,1593,367
17136,1,0,86,0,-86
17137,1,1,537,1329,792
17138,0,0,6,0,-6
17139,1,0,125,0,-125
17140,0,0,69,0,-69
17141,0,0,181,0,-181
17142,0,0,144,0,-144
17143,0,0,216,0,-216
17144,1,0,54,0,-54
17145,1,1,1974,1480,-494
17146,1,0,13,0,-13
17147,0,0,17,0,-17
17148,0,0,10,0,-10
17149,0,0,28,0,-28
17150,0,0,93,0,-93
17151,1,1,110,1669,1559
17152,0,0,124,0,-124
17153,0,0,89,0,-89
17154,1,1,182,1313,1131
17155,0,0,2,0,-2
17156,1,1,143,1585,1442
17157,1,0,54,0,-54
17158,0,0,83,0,-83
17159,0,0,32,0,-32
17160,1,0,41,0,-41
17161,0,0,15,0,-15
17162,1,1,618,1468,850
17163,1,0,174,0,-174
17164,0,0,21,0,-21
17165,0,0,6,0,-6
17166,1,0,97,0,-97
17167,1,1,247,1392,1145
17168,0,0,104,0,-104
17169,0,0,73,0,-73
17170,1,1,1496,1249,-247
17171,1,1,834,1446,612
17172,1,0,26,0,-26
17173,1,1,489,1569,1080
17174,1,1,310,1267,957
17175,1,0,26,0,-26
17176,0,0,49,0,-49
17177,1,0,21,0,-21
17178,1,0,7,0,-7
17179,1,0,2,0,-2
17180,0,0,29,0,-29
17181,1,0,10,0,-10
17182,1,0,3,0,-3
17183,1,0,125,0,-125
17184,1,0,28,0,-28
17185,1,0,14,0,-14
17186,0,0,24,0,-24
17187,1,0,99,0,-99
17188,1,1,133,1405,1272
17189,0,0,57,0,-57
17190,0,0,1,0,-1
17191,0,0,81,0,-81
17192,1,0,61,0,-61
17193,1,1,1122,2126,1004
17194,1,1,815,1399,584
17195,1,0,24,0,-24
17196,0,0,121,0,-121
17197,1,0,50,0,-50
17198,0,0,73,0,-73
17199,1,0,16,0,-16
17200,0,0,8,0,-8
17201,0,0,11,0,-11
17202,0,0,80,0,-80
17203,0,0,33,0,-33
17204,0,0,22,0,-22
17205,0,0,10,0,-10
17206,0,0,11,0,-11
17207,1,1,22,1499,1477
17208,1,0,5,0,-5
17209,1,0,39,0,-39
17210,1,0,8,0,-8
17211,1,1,63,1293,1230
17212,1,1,878,1305,427
17213,1,1,410,1395,985
17214,1,1,448,1492,1044
17215,1,1,324,1294,970
17216,1,0,15,0,-15
17217,1,0,18,0,-18
17218,0,0,43,0,-43
17219,0,0,19,0,-19
17220,1,0,8,0,-8
17221,0,0,71,0,-71
17222,1,1,677,2658,1981
17223,1,1,985,1863,878
17224,0,0,11,0,-11
17225,1,0,73,0,-73
17226,0,0,8,0,-8
17227,1,1,2118,1447,-671
17228,0,0,38,0,-38
17229,1,1,1261,1505,244
17230,0,0,28,0,-28
17231,1,0,13,0,-13
17232,1,1,213,1504,1291
17233,1,1,302,1771,1469
17234,0,0,38,0,-38
17235,1,0,37,0,-37
17236,1,1,414,1436,1022
17237,0,0,66,0,-66
17238,1,0,64,0,-64
17239,0,0,4,0,-4
17240,1,0,3,0,-3
17241,0,0,105,0,-105
17242,1,1,463,2171,1708
17243,0,0,3,0,-3
17244,1,1,160,1259,1099
17245,0,0,68,0,-68
17246,1,1,1263,1992,729
17247,1,0,113,0,-113
17248,1,1,490,1664,1174
17249,0,0,106,0,-106
17250,0,0,13,0,-13
17251,1,1,216,3120,2904
17252,1,1,357,1245,888
17253,1,1,1239,1327,88
17254,1,1,579,1384,805
17255,1,0,63,0,-63
17256,0,0,6,0,-6
17257,1,0,68,0,-68
17258,0,0,31,0,-31
17259,1,0,24,0,-24
17260,1,1,384,1610,1226
17261,1,0,79,0,-79
17262,1,1,1128,1528,400
17263,0,0,17,0,-17
17264,1,0,9,0,-9
17265,1,0,9,0,-9
17266,1,0,0,0,0
17267,1,1,871,2170,1299
17268,1,0,126,0,-126
17269,0,0,32,0,-32
17270,0,0,52,0,-52
17271,0,0,17,0,-17
17272,0,0,51,0,-51
17273,0,0,23,0,-23
17274,1,1,67,1464,1397
17275,1,0,20,0,-20
17276,0,0,21,0,-21
17277,1,0,79,0,-79
17278,0,0,42,0,-42
17279,1,1,192,1644,1452
17280,1,1,30,1246,1216
17281,1,0,79,0,-79
17282,1,1,395,1903,1508
17283,0,0,45,0,-45
17284,1,1,462,1594,1132
17285,0,0,29,0,-29
17286,0,0,126,0,-126
17287,1,1,1500,1580,80
17288,1,0,38,0,-38
17289,0,0,16,0,-16
17290,1,1,70,1350,1280
17291,0,0,38,0,-38
17292,1,1,25,1817,1792
17293,1,1,202,1241,1039
17294,1,1,379,2160,1781
17295,1,0,0,0,0
17296,0,0,24,0,-24
17297,0,0,4,0,-4
17298,1,0,68,0,-68
17299,1,1,146,1673,1527
17300,1,1,205,1653,1448
17301,1,0,40,0,-40
17302,1,0,102,0,-102
17303,0,0,162,0,-162
17304,0,0,38,0,-38
17305,1,1,810,1527,717
17306,1,0,25,0,-25
17307,1,0,63,0,-63
17308,0,0,31,0,-31
17309,1,0,4,0,-4
17310,0,0,2,0,-2
17311,0,0,175,0,-175
17312,1,1,83,1254,1171
17313,1,1,888,1335,447
17314,0,0,8,0,-8
17315,1,1,29,1423,1394
17316,1,0,0,0,0
17317,0,0,19,0,-19
17318,1,0,73,0,-73
17319,1,1,1128,1237,109
17320,0,0,23,0,-23
17321,0,0,116,0,-116
17322,1,0,1,0,-1
17323,1,0,96,0,-96
17324,1,0,16,0,-16
17325,0,0,15,0,-15
17326,1,1,1070,1355,285
17327,1,1,129,1398,1269
17328,1,1,53,1327,1274
17329,1,1,1617,1724,107
17330,0,0,57,0,-57
17331,1,0,44,0,-44
17332,1,0,55,0,-55
17333,1,1,263,1510,1247
17334,1,0,70,0,-70
17335,0,0,46,0,-46
17336,0,0,30,0,-30
17337,1,0,83,0,-83
17338,0,0,18,0,-18
17339,0,0,8,0,-8
17340,1,0,57,0,-57
17341,1,1,60,1429,1369
17342,1,1,760,1387,627
17343,0,0,21,0,-21
17344,1,1,184,1325,1141
17345,0,0,19,0,-19
17346,1,1,904,1361,457
17347,0,0,37,0,-37
17348,1,1,306,1685,1379
17349,1,0,5,0,-5
17350,1,0,104,0,-104
17351,0,0,2,0,-2
17352,0,0,2,0,-2
17353,1,0,100,0,-100
17354,1,0,15,0,-15
17355,0,0,11,0,-11
17356,1,1,412,2098,1686
17357,1,1,345,1795,1450
17358,1,0,83,0,-83
17359,1,0,34,0,-34
17360,0,0,123,0,-123
17361,1,0,10,0,-10
17362,1,1,209,1461,1252
17363,0,0,29,0,-29
17364,1,1,462,1915,1453
17365,1,0,162,0,-162
17366,0,0,26,0,-26
17367,1,1,157,1643,1486
17368,0,0,1,0,-1
17369,1,0,52,0,-52
17370,0,0,0,0,0
17371,0,0,195,0,-195
17372,0,0,29,0,-29
17373,1,0,56,0,-56
17374,0,0,118,0,-118
17375,1,0,101,0,-101
17376,1,0,0,0,0
17377,0,0,29,0,-29
17378,0,0,76,0,-76
17379,1,1,570,6516,5946
17380,0,0,20,0,-20
17381,0,0,13,0,-13
17382,1,0,32,0,-32
17383,0,0,47,0,-47
17384,1,0,81,0,-81
17385,1,0,144,0,-144
17386,1,0,47,0,-47
17387,1,0,72,0,-72
17388,1,0,100,0,-100
17389,1,0,128,0,-128
17390,0,0,4,0,-4
17391,0,0,20,0,-20
17392,1,0,31,0,-31
17393,0,0,100,0,-100
17394,0,0,1,0,-1
17395,0,0,31,0,-31
17396,0,0,37,0,-37
17397,1,0,24,0,-24
17398,1,1,173,1273,1100
17399,1,0,42,0,-42
17400,1,1,483,1677,1194
17401,1,1,250,1242,992
17402,1,0,15,0,-15
17403,0,0,63,0,-63
17404,0,0,209,0,-209
17405,1,1,955,1309,354
17406,0,0,80,0,-80
17407,1,0,4,0,-4
17408,1,0,21,0,-21
17409,0,0,77,0,-77
17410,1,1,668,1733,1065
17411,1,0,10,0,-10
17412,1,1,154,1244,1090
17413,1,0,61,0,-61
17414,1,0,219,0,-219
17415,0,0,19,0,-19
17416,0,0,105,0,-105
17417,0,0,20,0,-20
17418,0,0,7,0,-7
17419,1,0,70,0,-70
17420,1,0,63,0,-63
17421,0,0,4,0,-4
17422,1,1,205,1390,1185
17423,0,0,8,0,-8
17424,1,1,526,1416,890
17425,1,1,235,2786,2551
17426,1,1,312,2134,1822
17427,0,0,0,0,0
17428,0,0,5,0,-5
17429,1,0,7,0,-7
17430,1,1,372,1479,1107
17431,1,1,153,1335,1182
17432,1,1,1212,1255,43
17433,1,0,3,0,-3
17434,1,0,2,0,-2
17435,1,1,470,1273,803
17436,0,0,74,0,-74
17437,1,0,16,0,-16
17438,1,1,423,1488,1065
17439,1,0,5,0,-5
17440,1,0,9,0,-9
17441,1,0,1,0,-1
17442,1,1,408,1349,941
17443,1,1,638,1519,881
17444,1,1,2293,1408,-885
17445,0,0,18,0,-18
17446,1,0,26,0,-26
17447,0,0,24,0,-24
17448,0,0,197,0,-197
17449,1,1,1055,1965,910
17450,0,0,55,0,-55
17451,0,0,26,0,-26
17452,0,0,79,0,-79
17453,1,1,212,3240,3028
17454,1,0,53,0,-53
17455,1,0,13,0,-13
17456,1,1,228,2496,2268
17457,1,1,491,1421,930
17458,1,0,117,0,-117
17459,0,0,16,0,-16
17460,1,1,536,1502,966
17461,0,0,66,0,-66
17462,1,0,61,0,-61
17463,1,0,81,0,-81
17464,1,1,175,2029,1854
17465,1,1,1202,1246,44
17466,1,0,37,0,-37
17467,0,0,98,0,-98
17468,1,0,3,0,-3
17469,1,1,2413,1330,-1083
17470,1,0,2,0,-2
17471,0,0,66,0,-66
17472,1,1,1110,2133,1023
17473,1,0,128,0,-128
17474,0,0,106,0,-106
17475,0,0,141,0,-141
17476,0,0,112,0,-112
17477,1,0,96,0,-96
17478,0,0,4,0,-4
17479,1,1,1419,1271,-148
17480,0,0,126,0,-126
17481,0,0,107,0,-107
17482,0,0,100,0,-100
17483,0,0,3,0,-3
17484,1,1,798,1466,668
17485,0,0,5,0,-5
17486,1,0,65,0,-65
17487,1,1,982,1324,342
17488,1,1,468,2311,1843
17489,1,1,1987,3450,1463
17490,0,0,7,0,-7
17491,0,0,197,0,-197
17492,0,0,6,0,-6
17493,1,0,20,0,-20
17494,0,0,62,0,-62
17495,0,0,138,0,-138
17496,1,0,4,0,-4
17497,1,1,554,1474,920
17498,0,0,107,0,-107
17499,0,0,0,0,0
17500,1,1,297,1414,1117
17501,1,0,26,0,-26
17502,0,0,22,0,-22
17503,0,0,44,0,-44
17504,1,1,1392,1817,425
17505,1,1,232,1278,1046
17506,1,0,6,0,-6
17507,1,1,1167,2944,1777
17508,0,0,18,0,-18
17509,0,0,69,0,-69
17510,0,0,86,0,-86
17511,0,0,15,0,-15
17512,1,1,1609,2279,670
17513,0,0,6,0,-6
17514,0,0,51,0,-51
17515,1,0,57,0,-57
17516,1,0,8,0,-8
17517,1,0,1,0,-1
17518,1,0,15,0,-15
17519,0,0,15,0,-15
17520,1,0,44,0,-44
17521,1,1,974,1530,556
17522,0,0,16,0,-16
17523,0,0,90,0,-90
17524,0,0,55,0,-55
17525,1,1,102,1270,1168
17526,0,0,4,0,-4
17527,0,0,51,0,-51
17528,0,0,31,0,-31
17529,1,0,12,0,-12
17530,1,1,240,2792,2552
17531,1,0,48,0,-48
17532,0,0,34,0,-34
17533,1,1,230,1256,1026
17534,0,0,4,0,-4
17535,1,0,19,0,-19
17536,1,1,418,1296,878
17537,0,0,45,0,-45
17538,0,0,87,0,-87
17539,1,1,413,2028,1615
17540,1,0,43,0,-43
17541,0,0,7,0,-7
17542,0,0,24,0,-24
17543,0,0,103,0,-103
17544,1,0,73,0,-73
17545,0,0,5,0,-5
17546,1,1,712,1851,1139
17547,1,1,724,1415,691
17548,0,0,139,0,-139
17549,0,0,75,0,-75
17550,1,1,78,1544,1466
17551,0,0,119,0,-119
17552,1,0,4,0,-4
17553,0,0,9,0,-9
17554,0,0,81,0,-81
17555,1,1,196,1771,1575
17556,0,0,40,0,-40
17557,1,0,12,0,-12
17558,1,1,245,1268,1023
17559,0,0,225,0,-225
17560,1,0,92,0,-92
17561,1,0,8,0,-8
17562,0,0,14,0,-14
17563,0,0,50,0,-50
17564,1,0,40,0,-40
17565,1,1,172,1236,1064
17566,0,0,64,0,-64
17567,1,0,19,0,-19
17568,0,0,15,0,-15
17569,0,0,0,0,0
17570,0,0,6,0,-6
17571,1,1,1386,1687,301
17572,1,0,76,0,-76
17573,1,1,190,1773,1583
17574,1,0,78,0,-78
17575,0,0,133,0,-133
17576,1,1,898,1379,481
17577,1,0,105,0,-105
17578,1,0,35,0,-35
17579,0,0,93,0,-93
17580,0,0,69,0,-69
17581,0,0,0,0,0
17582,0,0,5,0,-5
17583,0,0,13,0,-13
17584,1,0,32,0,-32
17585,0,0,94,0,-94
17586,0,0,65,0,-65
17587,1,0,8,0,-8
17588,1,1,156,3305,3149
17589,0,0,70,0,-70
17590,1,1,124,1936,1812
17591,0,0,184,0,-184
17592,1,0,66,0,-66
17593,1,0,52,0,-52
17594,0,0,3,0,-3
17595,1,1,106,1403,1297
17596,1,1,189,1523,1334
17597,1,1,525,2952,2427
17598,0,0,37,0,-37
17599,0,0,29,0,-29
17600,0,0,37,0,-37
17601,0,0,52,0,-52
17602,1,0,109,0,-109
17603,0,0,21,0,-21
17604,0,0,26,0,-26
17605,1,0,44,0,-44
17606,0,0,113,0,-113
17607,0,0,0,0,0
17608,1,1,606,1429,823
17609,1,1,262,3488,3226
17610,1,1,170,1355,1185
17611,1,1,65,1652,1587
17612,0,0,42,0,-42
17613,0,0,17,0,-17
17614,1,0,12,0,-12
17615,0,0,47,0,-47
17616,1,0,72,0,-72
17617,1,1,435,1429,994
17618,1,0,148,0,-148
17619,1,1,566,1270,704
17620,1,1,858,2109,1251
17621,0,0,4,0,-4
17622,1,1,148,2148,2000
17623,0,0,50,0,-50
17624,1,0,10,0,-10
17625,1,1,262,1488,1226
17626,1,0,81,0,-81
17627,0,0,71,0,-71
17628,1,1,458,1629,1171
17629,1,0,8,0,-8
17630,0,0,124,0,-124
17631,1,1,1040,1448,408
17632,1,1,72,2353,2281
17633,0,0,51,0,-51
17634,1,1,591,4504,3913
17635,1,0,72,0,-72
17636,1,1,417,1690,1273
17637,1,1,745,1247,502
17638,1,0,54,0,-54
17639,0,0,6,0,-6
17640,1,0,30,0,-30
17641,1,1,593,1579,986
17642,1,1,451,1357,906
17643,0,0,65,0,-65
17644,1,0,34,0,-34
17645,0,0,109,0,-109
17646,1,0,65,0,-65
17647,0,0,42,0,-42
17648,0,0,28,0,-28
17649,1,0,14,0,-14
17650,1,0,7,0,-7
17651,0,0,42,0,-42
17652,0,0,31,0,-31
17653,0,0,93,0,-93
17654,1,0,14,0,-14
17655,1,1,968,1340,372
17656,1,1,469,1421,952
17657,1,1,395,1499,1104
17658,1,0,12,0,-12
17659,1,1,733,1393,660
17660,1,1,482,4240,3758
17661,0,0,51,0,-51
17662,1,1,218,1740,1522
17663,1,0,60,0,-60
17664,1,0,40,0,-40
17665,1,1,123,1250,1127
17666,0,0,21,0,-21
17667,1,1,1409,1261,-148
17668,0,0,175,0,-175
17669,0,0,121,0,-121
17670,1,0,31,0,-31
17671,0,0,251,0,-251
17672,1,0,182,0,-182
17673,0,0,24,0,-24
17674,1,0,42,0,-42
17675,1,0,104,0,-104
17676,0,0,46,0,-46
17677,1,1,2074,1258,-816
17678,1,1,416,2147,1731
17679,0,0,76,0,-76
17680,1,1,1425,1243,-182
17681,1,0,99,0,-99
17682,1,1,411,1619,1208
17683,1,0,26,0,-26
17684,1,1,1587,2177,590
17685,1,0,46,0,-46
17686,1,0,83,0,-83
17687,1,0,46,0,-46
17688,1,1,1819,1248,-571
17689,1,1,568,2236,1668
17690,1,0,22,0,-22
17691,0,0,7,0,-7
17692,1,0,130,0,-130
17693,0,0,89,0,-89
17694,1,0,16,0,-16
17695,0,0,65,0,-65
17696,0,0,78,0,-78
17697,0,0,50,0,-50
17698,0,0,13,0,-13
17699,1,1,977,1325,348
17700,0,0,10,0,-10
17701,1,1,33,1838,1805
17702,1,0,69,0,-69
17703,1,1,288,1644,1356
17704,0,0,8,0,-8
17705,1,0,21,0,-21
17706,0,0,8,0,-8
17707,1,0,11,0,-11
17708,1,0,75,0,-75
17709,1,0,56,0,-56
17710,0,0,47,0,-47
17711,1,0,8,0,-8
17712,0,0,10,0,-10
17713,1,0,189,0,-189
17714,0,0,77,0,-77
17715,0,0,1,0,-1
17716,0,0,21,0,-21
17717,0,0,0,0,0
17718,1,1,434,1723,1289
17719,0,0,7,0,-7
17720,0,0,60,0,-60
17721,1,0,10,0,-10
17722,1,1,534,1599,1065
17723,1,1,479,2024,1545
17724,1,0,13,0,-13
17725,0,0,20,0,-20
17726,1,1,1418,1352,-66
17727,0,0,86,0,-86
17728,1,1,258,1854,1596
17729,1,0,86,0,-86
17730,1,0,63,0,-63
17731,1,1,115,1451,1336
17732,1,0,73,0,-73
17733,0,0,53,0,-53
17734,0,0,107,0,-107
17735,1,0,12,0,-12
17736,1,1,110,1246,1136
17737,1,1,403,1726,1323
17738,1,1,306,1974,1668
17739,0,0,67,0,-67
17740,0,0,2,0,-2
17741,1,1,120,1274,1154
17742,1,0,25,0,-25
17743,1,0,59,0,-59
17744,1,0,21,0,-21
17745,0,0,2,0,-2
17746,1,0,31,0,-31
17747,0,0,17,0,-17
17748,0,0,5,0,-5
17749,0,0,120,0,-120
17750,1,0,84,0,-84
17751,1,1,390,1269,879
17752,1,1,831,1334,503
17753,1,1,222,1642,1420
17754,0,0,46,0,-46
17755,1,1,124,1444,1320
17756,0,0,102,0,-102
17757,1,1,261,1411,1150
17758,0,0,101,0,-101
17759,1,0,86,0,-86
17760,0,0,8,0,-8
17761,1,0,5,0,-5
17762,1,1,187,1411,1224
17763,0,0,39,0,-39
17764,1,1,436,1520,1084
17765,1,1,488,1845,1357
17766,0,0,15,0,-15
17767,0,0,75,0,-75
17768,0,0,122,0,-122
17769,1,1,100,1503,1403
17770,0,0,44,0,-44
17771,0,0,39,0,-39
17772,1,1,839,1519,680
17773,1,0,152,0,-152
17774,0,0,82,0,-82
17775,1,0,30,0,-30
17776,1,1,314,1332,1018
17777,0,0,36,0,-36
17778,1,1,187,1358,1171
17779,1,1,1514,2732,1218
17780,1,1,2168,1237,-931
17781,0,0,3,0,-3
17782,0,0,33,0,-33
17783,1,0,44,0,-44
17784,0,0,43,0,-43
17785,1,0,42,0,-42
17786,1,1,190,1235,1045
17787,1,0,6,0,-6
17788,1,0,10,0,-10
17789,0,0,45,0,-45
17790,1,0,17,0,-17
17791,1,0,0,0,0
17792,1,0,56,0,-56
17793,0,0,22,0,-22
17794,1,0,109,0,-109
17795,1,0,65,0,-65
17796,1,0,183,0,-183
17797,0,0,10,0,-10
17798,0,0,30,0,-30
17799,1,0,12,0,-12
17800,0,0,25,0,-25
17801,0,0,0,0,0
17802,0,0,138,0,-138
17803,0,0,34,0,-34
17804,1,0,28,0,-28
17805,0,0,89,0,-89
17806,0,0,11,0,-11
17807,1,0,87,0,-87
17808,1,0,69,0,-69
17809,0,0,31,0,-31
17810,0,0,2,0,-2
17811,1,0,28,0,-28
17812,1,0,23,0,-23
17813,1,0,38,0,-38
17814,1,1,653,2854,2201
17815,1,0,58,0,-58
17816,1,0,4,0,-4
17817,1,0,8,0,-8
17818,1,0,18,0,-18
17819,0,0,38,0,-38
17820,0,0,14,0,-14
17821,1,0,45,0,-45
17822,1,0,24,0,-24
17823,1,1,532,1689,1157
17824,1,0,89,0,-89
17825,0,0,79,0,-79
17826,1,1,86,2064,1978
17827,1,1,517,1605,1088
17828,0,0,12,0,-12
17829,0,0,97,0,-97
17830,1,1,1038,1448,410
17831,0,0,104,0,-104
17832,0,0,27,0,-27
17833,0,0,40,0,-40
17834,1,1,168,1478,1310
17835,0,0,17,0,-17
17836,1,1,800,1385,585
17837,0,0,49,0,-49
17838,1,0,61,0,-61
17839,1,1,48,1585,1537
17840,0,0,41,0,-41
17841,0,0,20,0,-20
17842,1,0,267,0,-267
17843,0,0,67,0,-67
17844,0,0,25,0,-25
17845,0,0,10,0,-10
17846,1,0,97,0,-97
17847,1,1,1199,1270,71
17848,0,0,20,0,-20
17849,0,0,11,0,-11
17850,0,0,33,0,-33
17851,0,0,44,0,-44
17852,0,0,15,0,-15
17853,0,0,21,0,-21
17854,0,0,23,0,-23
17855,1,0,43,0,-43
17856,0,0,21,0,-21
17857,1,1,1048,1564,516
17858,0,0,13,0,-13
17859,1,0,57,0,-57
17860,0,0,48,0,-48
17861,1,0,113,0,-113
17862,0,0,109,0,-109
17863,1,0,81,0,-81
17864,0,0,50,0,-50
17865,0,0,4,0,-4
17866,0,0,8,0,-8
17867,0,0,108,0,-108
17868,0,0,21,0,-21
17869,0,0,165,0,-165
17870,1,1,267,1410,1143
17871,0,0,56,0,-56
17872,1,0,65,0,-65
17873,0,0,70,0,-70
17874,0,0,19,0,-19
17875,1,0,67,0,-67
17876,1,0,133,0,-133
17877,0,0,25,0,-25
17878,1,1,490,1273,783
17879,1,0,25,0,-25
17880,0,0,20,0,-20
17881,1,0,104,0,-104
17882,0,0,246,0,-246
17883,0,0,16,0,-16
17884,1,1,721,1595,874
17885,1,0,34,0,-34
17886,0,0,37,0,-37
17887,1,0,50,0,-50
17888,1,1,625,1297,672
17889,1,1,351,1697,1346
17890,0,0,0,0,0
17891,0,0,113,0,-113
17892,1,1,225,1279,1054
17893,1,0,60,0,-60
17894,0,0,20,0,-20
17895,0,0,27,0,-27
17896,0,0,10,0,-10
17897,0,0,11,0,-11
17898,1,1,662,1373,711
17899,1,1,308,1403,1095
17900,1,1,31,1761,1730
17901,1,0,1,0,-1
17902,1,0,73,0,-73
17903,1,0,13,0,-13
17904,0,0,27,0,-27
17905,1,0,48,0,-48
17906,1,0,3,0,-3
17907,0,0,19,0,-19
17908,1,0,43,0,-43
17909,0,0,58,0,-58
17910,1,1,1362,1482,120
17911,1,0,74,0,-74
17912,0,0,15,0,-15
17913,0,0,31,0,-31
17914,1,0,10,0,-10
17915,1,0,34,0,-34
17916,0,0,35,0,-35
17917,0,0,180,0,-180
17918,1,1,297,1357,1060
17919,0,0,84,0,-84
17920,1,0,97,0,-97
17921,0,0,17,0,-17
17922,1,1,298,2202,1904
17923,1,1,221,1315,1094
17924,1,1,691,1328,637
17925,1,1,517,1627,1110
17926,0,0,58,0,-58
17927,1,1,49,1440,1391
17928,1,0,47,0,-47
17929,1,0,32,0,-32
17930,1,0,2,0,-2
17931,1,0,19,0,-19
17932,1,0,117,0,-117
17933,0,0,10,0,-10
17934,0,0,35,0,-35
17935,1,0,48,0,-48
17936,1,1,100,1247,1147
17937,0,0,64,0,-64
17938,1,1,219,1498,1279
17939,1,1,94,3566,3472
17940,0,0,194,0,-194
17941,1,0,64,0,-64
17942,1,0,11,0,-11
17943,1,1,54,1340,1286
17944,1,1,1375,1475,100
17945,1,0,102,0,-102
17946,0,0,93,0,-93
17947,1,1,380,1258,878
17948,1,0,11,0,-11
17949,0,0,38,0,-38
17950,0,0,65,0,-65
17951,1,0,18,0,-18
17952,0,0,233,0,-233
17953,1,0,33,0,-33
17954,1,1,342,1455,1113
17955,0,0,104,0,-104
17956,0,0,6,0,-6
17957,0,0,48,0,-48
17958,1,1,138,1589,1451
17959,1,1,373,1737,1364
17960,1,0,9,0,-9
17961,1,0,15,0,-15
17962,0,0,6,0,-6
17963,0,0,15,0,-15
17964,1,0,23,0,-23
17965,1,0,35,0,-35
17966,0,0,43,0,-43
17967,0,0,6,0,-6
17968,0,0,28,0,-28
17969,1,0,30,0,-30
17970,0,0,86,0,-86
17971,1,0,4,0,-4
17972,1,1,497,2320,1823
17973,1,1,65,1306,1241
17974,1,0,3,0,-3
17975,0,0,35,0,-35
17976,1,1,879,1295,416
17977,1,0,29,0,-29
17978,1,1,95,1323,1228
17979,0,0,23,0,-23
17980,1,1,346,1483,1137
17981,0,0,14,0,-14
17982,0,0,12,0,-12
17983,1,1,412,1241,829
17984,0,0,142,0,-142
17985,0,0,55,0,-55
17986,1,1,215,1425,1210
17987,1,0,0,0,0
17988,1,0,30,0,-30
17989,1,1,471,3677,3206
17990,1,1,347,1460,1113
17991,1,0,131,0,-131
17992,0,0,18,0,-18
17993,0,0,198,0,-198
17994,0,0,28,0,-28
17995,1,1,382,1243,861
17996,0,0,95,0,-95
17997,1,1,27,3035,3008
17998,1,0,89,0,-89
17999,1,0,6,0,-6
18000,1,1,250,1303,1053
18001,0,0,82,0,-82
18002,0,0,12,0,-12
18003,1,1,36,1553,1517
18004,1,1,424,1770,1346
18005,1,0,115,0,-115
18006,0,0,19,0,-19
18007,1,1,106,1752,1646
18008,1,1,546,1672,1126
18009,1,0,175,0,-175
18010,0,0,36,0,-36
18011,1,1,436,1424,988
18012,1,1,60,1460,1400
18013,0,0,57,0,-57
18014,1,0,76,0,-76
18015,0,0,18,0,-18
18016,1,1,335,1555,1220
18017,0,0,21,0,-21
18018,1,1,383,1460,1077
18019,0,0,0,0,0
18020,1,1,225,1448,1223
18021,0,0,85,0,-85
18022,0,0,6,0,-6
18023,1,0,34,0,-34
18024,1,1,260,1281,1021
18025,1,0,11,0,-11
18026,0,0,65,0,-65
18027,0,0,25,0,-25
18028,0,0,185,0,-185
18029,1,0,34,0,-34
18030,1,1,650,1583,933
18031,1,1,1035,2179,1144
18032,1,0,50,0,-50
18033,1,0,33,0,-33
18034,1,1,65,1916,1851
18035,1,0,100,0,-100
18036,1,0,11,0,-11
18037,0,0,10,0,-10
18038,0,0,113,0,-113
18039,1,1,186,1564,1378
18040,1,0,20,0,-20
18041,1,0,153,0,-153
18042,1,1,312,1484,1172
18043,1,0,27,0,-27
18044,1,1,109,1707,1598
18045,1,1,93,1361,1268
18046,1,0,14,0,-14
18047,1,1,819,1248,429
18048,1,0,15,0,-15
18049,1,0,29,0,-29
18050,1,0,31,0,-31
18051,0,0,38,0,-38
18052,0,0,66,0,-66
18053,1,0,10,0,-10
18054,1,0,11,0,-11
18055,1,1,324,1747,1423
18056,0,0,21,0,-21
18057,1,0,0,0,0
18058,0,0,41,0,-41
18059,1,1,621,1401,780
18060,1,1,340,2072,1732
18061,0,0,124,0,-124
18062,1,1,1069,1258,189
18063,1,0,17,0,-17
18064,1,1,511,1359,848
18065,0,0,65,0,-65
18066,0,0,87,0,-87
18067,1,1,165,1803,1638
18068,1,0,11,0,-11
18069,0,0,6,0,-6
18070,0,0,29,0,-29
18071,0,0,143,0,-143
18072,0,0,50,0,-50
18073,1,0,3,0,-3
18074,0,0,43,0,-43
18075,1,1,82,1276,1194
18076,1,0,12,0,-12
18077,1,0,5,0,-5
18078,0,0,20,0,-20
18079,1,0,23,0,-23
18080,1,0,154,0,-154
18081,0,0,23,0,-23
18082,1,0,171,0,-171
18083,0,0,64,0,-64
18084,1,1,97,1236,1139
18085,1,0,26,0,-26
18086,1,0,74,0,-74
18087,1,0,5,0,-5
18088,0,0,63,0,-63
18089,1,0,131,0,-131
18090,1,1,191,1372,1181
18091,0,0,131,0,-131
18092,0,0,53,0,-53
18093,0,0,69,0,-69
18094,1,1,750,1296,546
18095,0,0,139,0,-139
18096,1,1,304,1555,1251
18097,1,1,899,1270,371
18098,0,0,34,0,-34
18099,1,1,88,1949,1861
18100,1,0,17,0,-17
18101,1,0,46,0,-46
18102,0,0,25,0,-25
18103,0,0,66,0,-66
18104,1,0,2,0,-2
18105,0,0,62,0,-62
18106,0,0,10,0,-10
18107,1,1,144,1345,1201
18108,0,0,16,0,-16
18109,0,0,23,0,-23
18110,0,0,184,0,-184
18111,0,0,1,0,-1
18112,1,0,22,0,-22
18113,0,0,43,0,-43
18114,1,1,1992,1417,-575
18115,1,0,17,0,-17
18116,1,0,94,0,-94
18117,1,0,11,0,-11
18118,1,1,841,1444,603
18119,1,0,19,0,-19
18120,1,1,1506,1294,-212
18121,1,1,1223,1243,20
18122,1,1,212,1498,1286
18123,1,0,32,0,-32
18124,1,1,95,1807,1712
18125,0,0,16,0,-16
18126,1,0,35,0,-35
18127,1,0,92,0,-92
18128,1,1,235,1338,1103
18129,0,0,14,0,-14
18130,1,1,520,1404,884
18131,0,0,55,0,-55
18132,1,1,56,1640,1584
18133,1,0,136,0,-136
18134,1,1,782,2309,1527
18135,1,0,212,0,-212
18136,1,1,449,1388,939
18137,1,0,8,0,-8
18138,1,1,204,2453,2249
18139,1,1,1040,2267,1227
18140,0,0,1,0,-1
18141,0,0,59,0,-59
18142,1,0,97,0,-97
18143,0,0,59,0,-59
18144,0,0,149,0,-149
18145,1,1,48,2130,2082
18146,0,0,82,0,-82
18147,0,0,1,0,-1
18148,0,0,61,0,-61
18149,1,1,66,1336,1270
18150,1,0,76,0,-76
18151,0,0,2,0,-2
18152,0,0,53,0,-53
18153,1,1,566,2023,1457
18154,1,0,29,0,-29
18155,0,0,7,0,-7
18156,1,0,30,0,-30
18157,0,0,110,0,-110
18158,0,0,12,0,-12
18159,0,0,87,0,-87
18160,0,0,24,0,-24
18161,1,1,513,1737,1224
18162,1,1,58,1379,1321
18163,1,1,873,2549,1676
18164,1,1,401,1387,986
18165,0,0,31,0,-31
18166,1,1,1933,3722,1789
18167,0,0,61,0,-61
18168,0,0,253,0,-253
18169,0,0,50,0,-50
18170,0,0,158,0,-158
18171,1,1,961,1930,969
18172,1,0,151,0,-151
18173,1,0,33,0,-33
18174,0,0,26,0,-26
18175,1,0,107,0,-107
18176,0,0,20,0,-20
18177,1,0,2,0,-2
18178,1,1,484,1708,1224
18179,1,0,53,0,-53
18180,0,0,9,0,-9
18181,0,0,17,0,-17
18182,1,0,0,0,0
18183,0,0,14,0,-14
18184,1,1,464,1849,1385
18185,1,0,8,0,-8
18186,1,0,100,0,-100
18187,0,0,11,0,-11
18188,1,0,45,0,-45
18189,1,0,29,0,-29
18190,1,0,50,0,-50
18191,0,0,28,0,-28
18192,1,1,1428,1336,-92
18193,0,0,41,0,-41
18194,0,0,14,0,-14
18195,1,1,105,1300,1195
18196,0,0,47,0,-47
18197,1,0,28,0,-28
18198,0,0,20,0,-20
18199,1,1,117,1279,1162
18200,1,1,268,1557,1289
18201,1,0,26,0,-26
18202,0,0,10,0,-10
18203,1,0,18,0,-18
18204,1,0,21,0,-21
18205,1,0,43,0,-43
18206,1,0,21,0,-21
18207,0,0,48,0,-48
18208,0,0,18,0,-18
18209,0,0,197,0,-197
18210,1,1,937,1399,462
18211,1,0,90,0,-90
18212,0,0,157,0,-157
18213,1,0,27,0,-27
18214,1,1,1818,2032,214
18215,1,0,17,0,-17
18216,1,0,13,0,-13
18217,1,0,11,0,-11
18218,1,0,154,0,-154
18219,0,0,46,0,-46
18220,1,0,7,0,-7
18221,0,0,38,0,-38
18222,1,0,6,0,-6
18223,1,1,735,1803,1068
18224,1,1,210,1271,1061
18225,0,0,99,0,-99
18226,1,1,696,1977,1281
18227,1,0,1,0,-1
18228,1,1,1031,1286,255
18229,1,0,11,0,-11
18230,1,0,178,0,-178
18231,1,0,0,0,0
18232,1,1,424,1518,1094
18233,1,0,97,0,-97
18234,1,0,77,0,-77
18235,1,1,139,2021,1882
18236,1,0,14,0,-14
18237,1,0,47,0,-47
18238,1,0,3,0,-3
18239,1,0,12,0,-12
18240,0,0,82,0,-82
18241,0,0,36,0,-36
18242,0,0,88,0,-88
18243,0,0,57,0,-57
18244,0,0,1,0,-1
18245,0,0,38,0,-38
18246,1,1,851,1636,785
18247,0,0,36,0,-36
18248,0,0,53,0,-53
18249,0,0,29,0,-29
18250,1,1,1094,1609,515
18251,1,0,71,0,-71
18252,0,0,189,0,-189
18253,1,0,34,0,-34
18254,0,0,23,0,-23
18255,1,1,444,1503,1059
18256,0,0,12,0,-12
18257,1,1,194,1450,1256
18258,0,0,60,0,-60
18259,1,1,1137,3664,2527
18260,1,1,561,1265,704
18261,1,1,187,1282,1095
18262,1,1,60,2290,2230
18263,1,0,32,0,-32
18264,1,1,306,3007,2701
18265,1,0,3,0,-3
18266,1,1,219,1382,1163
18267,1,0,0,0,0
18268,1,0,7,0,-7
18269,0,0,113,0,-113
18270,0,0,11,0,-11
18271,1,0,1,0,-1
18272,1,0,8,0,-8
18273,1,0,1,0,-1
18274,1,1,199,3160,2961
18275,1,0,79,0,-79
18276,1,0,69,0,-69
18277,1,1,72,1260,1188
18278,0,0,94,0,-94
18279,0,0,23,0,-23
18280,0,0,76,0,-76
18281,0,0,28,0,-28
18282,0,0,90,0,-90
18283,0,0,0,0,0
18284,1,1,1839,1398,-441
18285,0,0,33,0,-33
18286,1,0,62,0,-62
18287,1,1,749,1542,793
18288,1,1,1189,1277,88
18289,1,0,51,0,-51
18290,0,0,3,0,-3
18291,1,1,225,1268,1043
18292,1,0,2,0,-2
18293,1,0,2,0,-2
18294,0,0,46,0,-46
18295,0,0,110,0,-110
18296,1,0,19,0,-19
18297,0,0,14,0,-14
18298,0,0,169,0,-169
18299,1,0,31,0,-31
18300,1,0,0,0,0
18301,1,0,14,0,-14
18302,1,1,756,1912,1156
18303,0,0,43,0,-43
18304,1,1,225,1319,1094
18305,0,0,39,0,-39
18306,1,0,6,0,-6
18307,1,1,370,3456,3086
18308,1,0,5,0,-5
18309,0,0,62,0,-62
18310,1,1,475,1866,1391
18311,0,0,62,0,-62
18312,1,0,15,0,-15
18313,1,1,1260,1437,177
18314,1,1,820,2051,1231
18315,1,0,30,0,-30
18316,1,0,24,0,-24
18317,1,1,1296,2054,758
18318,1,0,12,0,-12
18319,0,0,96,0,-96
18320,1,0,27,0,-27
18321,1,1,545,1886,1341
18322,1,1,577,1333,756
18323,1,0,74,0,-74
18324,1,0,8,0,-8
18325,1,0,47,0,-47
18326,1,1,1644,1313,-331
18327,1,0,88,0,-88
18328,0,0,21,0,-21
18329,0,0,13,0,-13
18330,1,0,67,0,-67
18331,0,0,128,0,-128
18332,0,0,9,0,-9
18333,0,0,7,0,-7
18334,0,0,153,0,-153
18335,1,0,23,0,-23
18336,1,1,1741,1362,-379
18337,0,0,43,0,-43
18338,1,0,29,0,-29
18339,1,0,56,0,-56
18340,1,1,395,1302,907
18341,1,0,72,0,-72
18342,0,0,21,0,-21
18343,1,1,186,2146,1960
18344,0,0,6,0,-6
18345,1,1,370,1286,916
18346,1,1,511,1373,862
18347,1,1,1430,1561,131
18348,1,0,64,0,-64
18349,1,1,838,1300,462
18350,0,0,106,0,-106
18351,1,1,352,1297,945
18352,1,0,18,0,-18
18353,1,0,123,0,-123
18354,1,0,6,0,-6
18355,0,0,1,0,-1
18356,1,1,27,1502,1475
18357,1,0,56,0,-56
18358,1,1,270,1444,1174
18359,0,0,29,0,-29
18360,1,1,93,1580,1487
18361,1,0,93,0,-93
18362,1,1,687,1313,626
18363,1,0,29,0,-29
18364,1,1,179,1335,1156
18365,0,0,20,0,-20
18366,1,1,701,1415,714
18367,0,0,59,0,-59
18368,0,0,28,0,-28
18369,1,0,85,0,-85
18370,0,0,5,0,-5
18371,0,0,29,0,-29
18372,1,1,1003,1330,327
18373,0,0,11,0,-11
18374,1,1,71,1300,1229
18375,1,1,400,1318,918
18376,1,1,501,2139,1638
18377,1,1,563,1236,673
18378,0,0,109,0,-109
18379,0,0,70,0,-70
18380,0,0,15,0,-15
18381,1,1,70,1260,1190
18382,0,0,62,0,-62
18383,0,0,71,0,-71
18384,1,1,381,1357,976
18385,1,0,268,0,-268
18386,0,0,15,0,-15
18387,1,0,16,0,-16
18388,0,0,38,0,-38
18389,1,0,20,0,-20
18390,0,0,69,0,-69
18391,0,0,2,0,-2
18392,1,0,148,0,-148
18393,1,0,38,0,-38
18394,1,0,60,0,-60
18395,1,1,1152,2200,1048
18396,1,1,1213,1313,100
18397,0,0,31,0,-31
18398,1,1,1078,2461,1383
18399,1,0,10,0,-10
18400,1,1,260,1726,1466
18401,1,1,409,1245,836
18402,0,0,120,0,-120
18403,0,0,0,0,0
18404,1,1,217,1772,1555
18405,1,1,384,1374,990
18406,1,0,58,0,-58
18407,0,0,217,0,-217
18408,1,1,1087,1268,181
18409,1,0,0,0,0
18410,1,0,5,0,-5
18411,0,0,63,0,-63
18412,1,1,391,1691,1300
18413,1,1,975,1312,337
18414,0,0,97,0,-97
18415,1,1,585,1534,949
18416,0,0,13,0,-13
18417,1,0,5,0,-5
18418,1,1,600,1584,984
18419,0,0,126,0,-126
18420,1,1,157,1386,1229
18421,1,0,11,0,-11
18422,0,0,90,0,-90
18423,1,1,165,1323,1158
18424,1,0,77,0,-77
18425,1,0,59,0,-59
18426,0,0,22,0,-22
18427,0,0,34,0,-34
18428,0,0,1,0,-1
18429,0,0,251,0,-251
18430,1,0,33,0,-33
18431,1,0,103,0,-103
18432,1,1,565,1336,771
18433,1,1,561,1265,704
18434,1,1,809,1289,480
18435,0,0,59,0,-59
18436,1,0,18,0,-18
18437,1,0,87,0,-87
18438,1,0,12,0,-12
18439,1,0,50,0,-50
18440,1,1,831,1663,832
18441,0,0,10,0,-10
18442,0,0,2,0,-2
18443,0,0,28,0,-28
18444,1,1,389,2329,1940
18445,0,0,9,0,-9
18446,1,0,27,0,-27
18447,1,1,186,1278,1092
18448,0,0,27,0,-27
18449,1,0,63,0,-63
18450,1,0,35,0,-35
18451,1,0,62,0,-62
18452,1,0,17,0,-17
18453,1,0,235,0,-235
18454,1,1,1042,1548,506
18455,1,1,344,1878,1534
18456,0,0,89,0,-89
18457,1,0,9,0,-9
18458,1,0,62,0,-62
18459,0,0,14,0,-14
18460,1,1,225,1407,1182
18461,1,0,21,0,-21
18462,1,0,139,0,-139
18463,0,0,52,0,-52
18464,1,0,70,0,-70
18465,1,0,37,0,-37
18466,0,0,59,0,-59
18467,1,1,410,1274,864
18468,1,1,294,1249,955
18469,1,0,50,0,-50
18470,1,0,25,0,-25
18471,0,0,40,0,-40
18472,0,0,21,0,-21
18473,1,1,122,1577,1455
18474,1,0,12,0,-12
18475,1,0,22,0,-22
18476,1,1,950,1262,312
18477,1,0,15,0,-15
18478,1,1,53,2047,1994
18479,0,0,50,0,-50
18480,0,0,40,0,-40
18481,0,0,34,0,-34
18482,1,1,1128,1337,209
18483,1,1,2312,1639,-673
18484,1,0,14,0,-14
18485,1,1,319,2165,1846
18486,0,0,20,0,-20
18487,0,0,44,0,-44
18488,0,0,23,0,-23
18489,1,1,70,1496,1426
18490,1,1,396,1311,915
18491,1,1,230,1768,1538
18492,1,1,176,1434,1258
18493,1,1,1882,1332,-550
18494,1,1,262,1321,1059
18495,1,0,281,0,-281
18496,1,0,10,0,-10
18497,1,1,60,1333,1273
18498,1,1,981,1267,286
18499,0,0,5,0,-5
18500,1,1,796,1247,451
18501,1,1,413,1882,1469
18502,0,0,73,0,-73
18503,1,1,778,2044,1266
18504,1,1,45,1612,1567
18505,1,0,14,0,-14
18506,1,1,910,1453,543
18507,0,0,16,0,-16
18508,0,0,10,0,-10
18509,1,0,37,0,-37
18510,0,0,55,0,-55
18511,1,0,57,0,-57
18512,1,1,750,1765,1015
18513,1,1,1358,1290,-68
18514,0,0,25,0,-25
18515,0,0,83,0,-83
18516,1,1,272,1287,1015
18517,1,1,174,1328,1154
18518,1,1,303,1299,996
18519,1,1,531,1519,988
18520,0,0,179,0,-179
18521,1,1,343,1687,1344
18522,1,0,138,0,-138
18523,1,1,388,1737,1349
18524,1,1,111,1291,1180
18525,0,0,14,0,-14
18526,1,0,10,0,-10
18527,0,0,35,0,-35
18528,1,0,94,0,-94
18529,0,0,177,0,-177
18530,0,0,58,0,-58
18531,1,0,34,0,-34
18532,1,0,33,0,-33
18533,1,1,206,1337,1131
18534,1,0,166,0,-166
18535,0,0,68,0,-68
18536,1,1,275,2230,1955
18537,1,1,28,1315,1287
18538,0,0,42,0,-42
18539,1,1,179,1686,1507
18540,0,0,42,0,-42
18541,1,1,476,1534,1058
18542,0,0,82,0,-82
18543,1,0,30,0,-30
18544,0,0,96,0,-96
18545,0,0,25,0,-25
18546,1,0,122,0,-122
18547,0,0,76,0,-76
18548,0,0,55,0,-55
18549,1,1,577,1392,815
18550,1,0,29,0,-29
18551,1,0,10,0,-10
18552,1,0,38,0,-38
18553,0,0,62,0,-62
18554,1,0,51,0,-51
18555,1,0,104,0,-104
18556,0,0,2,0,-2
18557,1,0,33,0,-33
18558,0,0,126,0,-126
18559,1,1,640,1550,910
18560,0,0,22,0,-22
18561,0,0,2,0,-2
18562,1,1,497,1256,759
18563,0,0,17,0,-17
18564,0,0,138,0,-138
18565,0,0,130,0,-130
18566,1,1,356,1429,1073
18567,0,0,78,0,-78
18568,0,0,15,0,-15
18569,0,0,7,0,-7
18570,0,0,85,0,-85
18571,1,0,34,0,-34
18572,1,0,11,0,-11
18573,0,0,85,0,-85
18574,1,1,116,1255,1139
18575,0,0,36,0,-36
18576,0,0,62,0,-62
18577,0,0,94,0,-94
18578,1,1,908,1687,779
18579,1,0,5,0,-5
18580,1,1,307,1481,1174
18581,1,1,901,1830,929
18582,1,1,46,2079,2033
18583,1,0,86,0,-86
18584,0,0,31,0,-31
18585,1,0,2,0,-2
18586,1,0,70,0,-70
18587,1,0,89,0,-89
18588,1,1,588,1251,663
18589,1,0,41,0,-41
18590,1,0,112,0,-112
18591,1,1,214,1238,1024
18592,0,0,9,0,-9
18593,0,0,56,0,-56
18594,1,0,20,0,-20
18595,1,1,669,1240,571
18596,1,0,11,0,-11
18597,0,0,16,0,-16
18598,0,0,34,0,-34
18599,1,0,68,0,-68
18600,0,0,28,0,-28
18601,1,0,88,0,-88
18602,0,0,24,0,-24
18603,0,0,70,0,-70
18604,1,1,267,1383,1116
18605,1,1,109,1463,1354
18606,1,1,319,1286,967
18607,1,1,168,1250,1082
18608,1,1,506,1435,929
18609,0,0,39,0,-39
18610,1,1,386,1237,851
18611,0,0,99,0,-99
18612,1,0,9,0,-9
18613,1,0,93,0,-93
18614,1,1,658,2838,2180
18615,0,0,12,0,-12
18616,1,1,264,2895,2631
18617,1,0,76,0,-76
18618,0,0,101,0,-101
18619,1,1,57,1317,1260
18620,0,0,9,0,-9
18621,1,0,155,0,-155
18622,1,1,247,1278,1031
18623,0,0,159,0,-159
18624,1,1,112,1950,1838
18625,1,1,339,1436,1097
18626,1,1,452,1361,909
18627,1,0,148,0,-148
18628,1,1,481,1985,1504
18629,1,0,6,0,-6
18630,1,1,25,1524,1499
18631,0,0,31,0,-31
18632,1,0,329,0,-329
18633,1,0,61,0,-61
18634,0,0,4,0,-4
18635,1,1,246,3149,2903
18636,1,0,5,0,-5
18637,1,0,10,0,-10
18638,1,0,22,0,-22
18639,0,0,2,0,-2
18640,0,0,7,0,-7
18641,1,1,332,1817,1485
18642,1,0,73,0,-73
18643,0,0,47,0,-47
18644,1,0,19,0,-19
18645,0,0,16,0,-16
18646,1,1,914,1309,395
18647,1,0,32,0,-32
18648,0,0,1,0,-1
18649,1,1,317,1356,1039
18650,0,0,45,0,-45
18651,1,1,289,1362,1073
18652,1,1,325,1832,1507
18653,0,0,55,0,-55
18654,1,0,74,0,-74
18655,0,0,12,0,-12
18656,1,1,218,1249,1031
18657,0,0,6,0,-6
18658,1,1,1960,2361,401
18659,1,1,56,1485,1429
18660,1,1,405,1326,921
18661,1,1,351,3398,3047
18662,1,1,588,1529,941
18663,0,0,75,0,-75
18664,1,1,188,1349,1161
18665,1,0,25,0,-25
18666,0,0,49,0,-49
18667,0,0,10,0,-10
18668,1,0,40,0,-40
18669,1,0,151,0,-151
18670,0,0,2,0,-2
18671,1,1,721,1278,557
18672,0,0,72,0,-72
18673,0,0,23,0,-23
18674,1,1,1321,1643,322
18675,0,0,53,0,-53
18676,1,0,14,0,-14
18677,1,0,129,0,-129
18678,0,0,68,0,-68
18679,1,1,305,1696,1391
18680,1,0,32,0,-32
18681,1,0,53,0,-53
18682,1,1,1797,1331,-466
18683,1,0,9,0,-9
18684,0,0,14,0,-14
18685,0,0,22,0,-22
18686,1,0,202,0,-202
18687,1,1,302,1303,1001
18688,0,0,8,0,-8
18689,0,0,57,0,-57
18690,0,0,1,0,-1
18691,1,1,701,2056,1355
18692,0,0,17,0,-17
18693,1,1,1778,1527,-251
18694,1,0,44,0,-44
18695,0,0,50,0,-50
18696,1,0,34,0,-34
18697,0,0,46,0,-46
18698,0,0,64,0,-64
18699,0,0,29,0,-29
18700,1,1,413,2152,1739
18701,1,1,1001,1343,342
18702,0,0,25,0,-25
18703,1,0,7,0,-7
18704,1,0,3,0,-3
18705,1,0,32,0,-32
18706,1,1,200,1343,1143
18707,1,1,398,1340,942
18708,0,0,53,0,-53
18709,1,1,212,1633,1421
18710,1,0,16,0,-16
18711,0,0,48,0,-48
18712,0,0,1,0,-1
18713,1,0,1,0,-1
18714,1,0,59,0,-59
18715,1,0,17,0,-17
18716,1,0,48,0,-48
18717,1,0,12,0,-12
18718,0,0,20,0,-20
18719,1,0,10,0,-10
18720,1,1,502,1539,1037
18721,1,1,1081,2776,1695
18722,1,0,6,0,-6
18723,0,0,8,0,-8
18724,0,0,7,0,-7
18725,1,0,19,0,-19
18726,1,0,65,0,-65
18727,0,0,190,0,-190
18728,1,0,76,0,-76
18729,1,1,1619,1300,-319
18730,1,1,1041,1823,782
18731,0,0,34,0,-34
18732,1,0,63,0,-63
18733,0,0,5,0,-5
18734,1,1,748,1908,1160
18735,0,0,39,0,-39
18736,0,0,66,0,-66
18737,1,1,46,2260,2214
18738,0,0,27,0,-27
18739,1,1,16,1965,1949
18740,1,0,84,0,-84
18741,0,0,28,0,-28
18742,1,1,275,1353,1078
18743,0,0,15,0,-15
18744,1,0,26,0,-26
18745,0,0,3,0,-3
18746,1,1,355,2142,1787
18747,1,0,9,0,-9
18748,1,1,565,1728,1163
18749,1,0,55,0,-55
18750,1,0,11,0,-11
18751,0,0,7,0,-7
18752,0,0,74,0,-74
18753,0,0,0,0,0
18754,1,1,668,2882,2214
18755,1,0,110,0,-110
18756,0,0,9,0,-9
18757,1,0,14,0,-14
18758,0,0,9,0,-9
18759,1,1,420,1482,1062
18760,1,1,1225,1546,321
18761,1,1,69,1646,1577
18762,1,0,25,0,-25
18763,0,0,38,0,-38
18764,0,0,14,0,-14
18765,0,0,57,0,-57
18766,1,1,156,1802,1646
18767,0,0,96,0,-96
18768,1,1,1371,1933,562
18769,1,1,405,1455,1050
18770,1,1,787,1312,525
18771,1,0,64,0,-64
18772,1,0,18,0,-18
18773,1,0,27,0,-27
18774,1,1,309,1440,1131
18775,1,1,205,1235,1030
18776,1,0,22,0,-22
18777,1,0,187,0,-187
18778,0,0,7,0,-7
18779,1,0,20,0,-20
18780,1,1,169,1321,1152
18781,0,0,25,0,-25
18782,0,0,37,0,-37
18783,1,1,839,1267,428
18784,1,0,81,0,-81
18785,0,0,183,0,-183
18786,1,1,151,2292,2141
18787,0,0,24,0,-24
18788,1,0,81,0,-81
18789,0,0,37,0,-37
18790,0,0,2,0,-2
18791,1,1,326,1338,1012
18792,0,0,40,0,-40
18793,0,0,1,0,-1
18794,1,1,176,2051,1875
18795,1,0,23,0,-23
18796,1,1,960,1247,287
18797,1,1,313,1708,1395
18798,1,1,1588,1601,13
18799,1,0,11,0,-11
18800,1,0,21,0,-21
18801,1,1,840,1853,1013
18802,1,1,521,1409,888
18803,1,1,1038,1452,414
18804,1,0,16,0,-16
18805,1,0,85,0,-85
18806,0,0,60,0,-60
18807,0,0,8,0,-8
18808,1,0,37,0,-37
18809,0,0,42,0,-42
18810,1,0,109,0,-109
18811,1,0,2,0,-2
18812,0,0,2,0,-2
18813,1,0,114,0,-114
18814,0,0,15,0,-15
18815,1,1,317,1286,969
18816,0,0,13,0,-13
18817,1,0,16,0,-16
18818,0,0,4,0,-4
18819,1,1,77,3525,3448
18820,1,1,39,1450,1411
18821,0,0,20,0,-20
18822,1,0,40,0,-40
18823,0,0,30,0,-30
18824,1,0,75,0,-75
18825,0,0,13,0,-13
18826,0,0,46,0,-46
18827,1,1,99,1256,1157
18828,0,0,68,0,-68
18829,0,0,87,0,-87
18830,0,0,30,0,-30
18831,1,0,182,0,-182
18832,0,0,172,0,-172
18833,1,1,1069,3428,2359
18834,0,0,1,0,-1
18835,0,0,25,0,-25
18836,1,1,370,1305,935
18837,1,1,695,2137,1442
18838,1,1,179,1325,1146
18839,1,0,98,0,-98
18840,1,0,10,0,-10
18841,1,0,41,0,-41
18842,0,0,89,0,-89
18843,1,0,154,0,-154
18844,0,0,20,0,-20
18845,1,1,226,3025,2799
18846,0,0,10,0,-10
18847,1,1,204,1295,1091
18848,1,1,250,2284,2034
18849,0,0,182,0,-182
18850,1,0,26,0,-26
18851,0,0,10,0,-10
18852,1,0,38,0,-38
18853,1,0,4,0,-4
18854,1,1,743,1443,700
18855,1,1,2645,1341,-1304
18856,1,1,187,1794,1607
18857,1,1,192,1245,1053
18858,1,0,141,0,-141
18859,1,1,871,1503,632
18860,1,1,432,1774,1342
18861,1,0,2,0,-2
18862,1,0,10,0,-10
18863,0,0,12,0,-12
18864,1,1,1239,1551,312
18865,0,0,0,0,0
18866,1,0,20,0,-20
18867,1,0,5,0,-5
18868,0,0,11,0,-11
18869,0,0,32,0,-32
18870,0,0,199,0,-199
18871,1,1,882,1656,774
18872,0,0,206,0,-206
18873,1,1,1062,1620,558
18874,0,0,4,0,-4
18875,1,0,25,0,-25
18876,0,0,176,0,-176
18877,1,1,811,1237,426
18878,1,0,61,0,-61
18879,1,1,566,1310,744
18880,1,1,291,1933,1642
18881,1,1,444,2354,1910
18882,1,1,1898,1243,-655
18883,0,0,82,0,-82
18884,1,1,157,1289,1132
18885,0,0,153,0,-153
18886,1,1,296,1281,985
18887,1,0,19,0,-19
18888,0,0,44,0,-44
18889,1,1,60,3192,3132
18890,1,0,40,0,-40
18891,0,0,4,0,-4
18892,0,0,23,0,-23
18893,0,0,29,0,-29
18894,1,1,303,1344,1041
18895,1,0,15,0,-15
18896,1,1,490,2351,1861
18897,0,0,35,0,-35
18898,0,0,107,0,-107
18899,1,0,177,0,-177
18900,1,1,1237,1408,171
18901,0,0,33,0,-33
18902,1,0,28,0,-28
18903,0,0,47,0,-47
18904,0,0,201,0,-201
18905,0,0,26,0,-26
18906,0,0,85,0,-85
18907,1,0,62,0,-62
18908,1,1,515,1645,1130
18909,1,0,43,0,-43
18910,1,0,15,0,-15
18911,1,0,65,0,-65
18912,1,0,42,0,-42
18913,0,0,35,0,-35
18914,1,0,44,0,-44
18915,0,0,14,0,-14
18916,0,0,53,0,-53
18917,0,0,10,0,-10
18918,1,1,639,1596,957
18919,1,1,1132,1376,244
18920,1,1,204,1291,1087
18921,1,1,42,1360,1318
18922,0,0,0,0,0
18923,1,1,222,1416,1194
18924,1,0,31,0,-31
18925,1,0,2,0,-2
18926,0,0,39,0,-39
18927,1,1,282,1465,1183
18928,1,1,385,2220,1835
18929,0,0,35,0,-35
18930,1,0,13,0,-13
18931,1,1,124,1564,1440
18932,0,0,88,0,-88
18933,1,1,435,1441,1006
18934,1,1,382,1626,1244
18935,1,1,726,1386,660
18936,0,0,6,0,-6
18937,1,0,2,0,-2
18938,0,0,59,0,-59
18939,1,1,940,2465,1525
18940,0,0,16,0,-16
18941,0,0,14,0,-14
18942,1,1,803,1369,566
18943,1,0,11,0,-11
18944,1,0,21,0,-21
18945,1,1,830,1333,503
18946,1,1,163,1522,1359
18947,0,0,8,0,-8
18948,1,1,227,1337,1110
18949,1,0,31,0,-31
18950,0,0,51,0,-51
18951,1,0,33,0,-33
18952,0,0,77,0,-77
18953,0,0,74,0,-74
18954,1,1,365,1308,943
18955,1,0,120,0,-120
18956,0,0,120,0,-120
18957,1,0,13,0,-13
18958,0,0,71,0,-71
18959,0,0,9,0,-9
18960,1,1,694,1754,1060
18961,1,1,72,1716,1644
18962,1,0,8,0,-8
18963,1,1,104,1748,1644
18964,1,0,44,0,-44
18965,1,0,8,0,-8
18966,0,0,69,0,-69
18967,1,0,117,0,-117
18968,0,0,24,0,-24
18969,0,0,22,0,-22
18970,1,1,90,1852,1762
18971,1,0,34,0,-34
18972,1,1,541,1298,757
18973,1,1,77,1250,1173
18974,1,1,126,1595,1469
18975,1,1,368,1975,1607
18976,1,0,273,0,-273
18977,0,0,33,0,-33
18978,1,0,70,0,-70
18979,1,1,680,1847,1167
18980,1,1,379,1316,937
18981,0,0,54,0,-54
18982,1,0,27,0,-27
18983,0,0,7,0,-7
18984,1,1,949,1347,398
18985,1,1,493,1247,754
18986,1,0,42,0,-42
18987,1,1,263,1287,1024
18988,0,0,65,0,-65
18989,1,1,500,1448,948
18990,1,1,537,1352,815
18991,1,1,408,1344,936
18992,0,0,16,0,-16
18993,0,0,7,0,-7
18994,0,0,37,0,-37
18995,1,0,10,0,-10
18996,1,1,240,1286,1046
18997,1,1,405,1556,1151
18998,1,0,12,0,-12
18999,1,1,244,1277,1033
19000,1,0,61,0,-61
19001,0,0,80,0,-80
19002,1,0,141,0,-141
19003,0,0,87,0,-87
19004,0,0,1,0,-1
19005,0,0,65,0,-65
19006,1,1,97,2550,2453
19007,0,0,6,0,-6
19008,0,0,20,0,-20
19009,0,0,28,0,-28
19010,1,0,2,0,-2
19011,1,1,1088,1699,611
19012,0,0,6,0,-6
19013,1,1,786,2069,1283
19014,1,0,64,0,-64
19015,1,0,1,0,-1
19016,0,0,58,0,-58
19017,0,0,25,0,-25
19018,1,1,348,2287,1939
19019,0,0,5,0,-5
19020,1,1,697,1505,808
19021,1,0,48,0,-48
19022,1,0,64,0,-64
19023,1,1,1094,1840,746
19024,1,1,164,1354,1190
19025,1,0,29,0,-29
19026,0,0,85,0,-85
19027,1,1,739,7098,6359
19028,1,1,255,1860,1605
19029,1,1,1282,2058,776
19030,0,0,4,0,-4
19031,0,0,47,0,-47
19032,1,1,540,3104,2564
19033,1,0,0,0,0
19034,1,1,895,1781,886
19035,1,1,164,1298,1134
19036,1,0,123,0,-123
19037,0,0,54,0,-54
19038,0,0,10,0,-10
19039,1,1,19,1369,1350
19040,0,0,28,0,-28
19041,0,0,116,0,-116
19042,1,1,1022,1373,351
19043,0,0,48,0,-48
19044,0,0,50,0,-50
19045,0,0,22,0,-22
19046,0,0,2,0,-2
19047,1,1,664,1563,899
19048,0,0,60,0,-60
19049,0,0,29,0,-29
19050,0,0,71,0,-71
19051,1,1,530,1376,846
19052,0,0,37,0,-37
19053,1,1,602,1435,833
19054,1,0,14,0,-14
19055,1,1,344,1650,1306
19056,0,0,6,0,-6
19057,0,0,34,0,-34
19058,1,0,121,0,-121
19059,1,1,614,1527,913
19060,1,1,184,1403,1219
19061,0,0,19,0,-19
19062,1,0,1,0,-1
19063,1,1,687,1278,591
19064,1,0,33,0,-33
19065,1,0,10,0,-10
19066,0,0,19,0,-19
19067,0,0,29,0,-29
19068,1,0,12,0,-12
19069,0,0,1,0,-1
19070,0,0,84,0,-84
19071,0,0,31,0,-31
19072,0,0,138,0,-138
19073,1,1,153,1287,1134
19074,1,0,49,0,-49
19075,1,0,24,0,-24
19076,0,0,8,0,-8
19077,0,0,43,0,-43
19078,0,0,69,0,-69
19079,1,1,88,1492,1404
19080,1,0,4,0,-4
19081,1,0,85,0,-85
19082,1,0,64,0,-64
19083,0,0,17,0,-17
19084,0,0,26,0,-26
19085,0,0,56,0,-56
19086,1,0,117,0,-117
19087,1,0,71,0,-71
19088,1,1,74,1369,1295
19089,1,0,48,0,-48
19090,0,0,93,0,-93
19091,0,0,116,0,-116
19092,0,0,2,0,-2
19093,0,0,8,0,-8
19094,0,0,145,0,-145
19095,0,0,49,0,-49
19096,0,0,11,0,-11
19097,1,1,112,1593,1481
19098,1,0,50,0,-50
19099,1,1,451,2167,1716
19100,0,0,52,0,-52
19101,1,0,13,0,-13
19102,0,0,44,0,-44
19103,1,0,212,0,-212
19104,1,1,204,2206,2002
19105,0,0,64,0,-64
19106,0,0,9,0,-9
19107,1,1,690,1282,592
19108,0,0,24,0,-24
19109,0,0,11,0,-11
19110,1,0,37,0,-37
19111,1,1,104,1553,1449
19112,0,0,111,0,-111
19113,0,0,57,0,-57
19114,1,1,179,1909,1730
19115,1,1,477,1408,931
19116,1,1,1959,1615,-344
19117,1,1,848,1358,510
19118,1,1,339,1323,984
19119,0,0,42,0,-42
19120,1,0,29,0,-29
19121,0,0,63,0,-63
19122,1,0,2,0,-2
19123,1,1,240,1960,1720
19124,0,0,145,0,-145
19125,1,0,8,0,-8
19126,1,0,109,0,-109
19127,1,0,10,0,-10
19128,0,0,78,0,-78
19129,1,0,135,0,-135
19130,1,0,82,0,-82
19131,1,0,5,0,-5
19132,1,0,98,0,-98
19133,0,0,71,0,-71
19134,1,0,31,0,-31
19135,0,0,143,0,-143
19136,0,0,181,0,-181
19137,0,0,57,0,-57
19138,0,0,16,0,-16
19139,1,0,27,0,-27
19140,1,1,1064,1269,205
19141,1,1,1645,2745,1100
19142,1,1,1865,2844,979
19143,0,0,14,0,-14
19144,0,0,1,0,-1
19145,1,0,62,0,-62
19146,1,0,61,0,-61
19147,1,0,23,0,-23
19148,1,1,317,1276,959
19149,1,0,50,0,-50
19150,1,1,967,1235,268
19151,0,0,48,0,-48
19152,0,0,41,0,-41
19153,1,0,0,0,0
19154,1,0,49,0,-49
19155,1,0,102,0,-102
19156,0,0,36,0,-36
19157,1,1,1222,1979,757
19158,0,0,127,0,-127
19159,1,1,417,1367,950
19160,1,1,489,1315,826
19161,0,0,1,0,-1
19162,0,0,78,0,-78
19163,1,1,527,1368,841
19164,0,0,102,0,-102
19165,1,1,828,1300,472
19166,1,1,103,3829,3726
19167,1,1,176,1343,1167
19168,1,1,1198,2536,1338
19169,1,1,724,1335,611
19170,0,0,42,0,-42
19171,0,0,43,0,-43
19172,0,0,14,0,-14
19173,0,0,91,0,-91
19174,0,0,29,0,-29
19175,1,0,2,0,-2
19176,0,0,24,0,-24
19177,0,0,10,0,-10
19178,1,0,236,0,-236
19179,1,0,8,0,-8
19180,0,0,14,0,-14
19181,0,0,104,0,-104
19182,0,0,38,0,-38
19183,1,1,1190,4097,2907
19184,1,0,53,0,-53
19185,1,0,12,0,-12
19186,0,0,264,0,-264
19187,0,0,7,0,-7
19188,0,0,72,0,-72
19189,1,0,5,0,-5
19190,0,0,31,0,-31
19191,1,0,111,0,-111
19192,1,0,16,0,-16
19193,1,1,489,1928,1439
19194,0,0,27,0,-27
19195,1,1,241,2050,1809
19196,1,1,73,1754,1681
19197,0,0,42,0,-42
19198,0,0,19,0,-19
19199,0,0,69,0,-69
19200,1,1,890,1235,345
19201,0,0,17,0,-17
19202,1,0,12,0,-12
19203,1,0,47,0,-47
19204,1,1,223,1737,1514
19205,0,0,23,0,-23
19206,1,0,4,0,-4
19207,1,0,17,0,-17
19208,1,1,946,1547,601
19209,0,0,0,0,0
19210,0,0,80,0,-80
19211,1,0,53,0,-53
19212,0,0,4,0,-4
19213,1,0,64,0,-64
19214,0,0,6,0,-6
19215,1,1,316,1411,1095
19216,1,0,45,0,-45
19217,1,1,1045,1264,219
19218,1,1,2508,6630,4122
19219,1,0,1,0,-1
19220,0,0,48,0,-48
19221,1,0,64,0,-64
19222,1,1,677,1278,601
19223,1,0,7,0,-7
19224,1,0,40,0,-40
19225,0,0,25,0,-25
19226,1,0,34,0,-34
19227,1,0,18,0,-18
19228,1,0,3,0,-3
19229,1,0,25,0,-25
19230,1,0,2,0,-2
19231,1,0,19,0,-19
19232,1,1,93,1263,1170
19233,1,1,1048,1248,200
19234,1,0,3,0,-3
19235,0,0,7,0,-7
19236,0,0,17,0,-17
19237,0,0,131,0,-131
19238,1,0,18,0,-18
19239,1,0,26,0,-26
19240,0,0,17,0,-17
19241,1,1,449,1700,1251
19242,1,1,91,1371,1280
19243,1,0,57,0,-57
19244,0,0,10,0,-10
19245,0,0,192,0,-192
19246,1,0,224,0,-224
19247,0,0,24,0,-24
19248,1,1,897,1452,555
19249,0,0,171,0,-171
19250,1,0,52,0,-52
19251,1,0,30,0,-30
19252,0,0,53,0,-53
19253,1,0,22,0,-22
19254,1,1,25,1319,1294
19255,1,1,1537,2568,1031
19256,1,0,95,0,-95
19257,0,0,68,0,-68
19258,1,0,31,0,-31
19259,1,1,209,1538,1329
19260,1,0,6,0,-6
19261,1,0,122,0,-122
19262,1,1,920,1346,426
19263,1,1,154,1828,1674
19264,1,1,328,2134,1806
19265,1,0,52,0,-52
19266,1,1,473,1700,1227
19267,0,0,169,0,-169
19268,0,0,11,0,-11
19269,0,0,31,0,-31
19270,1,1,954,2724,1770
19271,1,0,60,0,-60
19272,0,0,13,0,-13
19273,1,0,29,0,-29
19274,0,0,214,0,-214
19275,0,0,72,0,-72
19276,0,0,56,0,-56
19277,1,1,1061,1239,178
19278,0,0,1,0,-1
19279,0,0,57,0,-57
19280,1,0,36,0,-36
19281,1,0,35,0,-35
19282,0,0,29,0,-29
19283,0,0,46,0,-46
19284,0,0,99,0,-99
19285,1,1,282,1544,1262
19286,0,0,21,0,-21
19287,0,0,17,0,-17
19288,1,0,18,0,-18
19289,1,1,656,1471,815
19290,0,0,21,0,-21
19291,1,0,67,0,-67
19292,0,0,55,0,-55
19293,0,0,161,0,-161
19294,1,0,3,0,-3
19295,1,1,947,1438,491
19296,1,0,10,0,-10
19297,1,0,95,0,-95
19298,0,0,51,0,-51
19299,0,0,53,0,-53
19300,1,1,680,1667,987
19301,1,0,40,0,-40
19302,0,0,29,0,-29
19303,0,0,14,0,-14
19304,1,0,137,0,-137
19305,1,1,106,2524,2418
19306,0,0,25,0,-25
19307,1,0,53,0,-53
19308,1,0,25,0,-25
19309,0,0,9,0,-9
19310,0,0,9,0,-9
19311,0,0,14,0,-14
19312,1,1,447,1543,1096
19313,1,0,50,0,-50
19314,1,1,125,1478,1353
19315,1,1,794,2101,1307
19316,0,0,51,0,-51
19317,1,1,160,1403,1243
19318,0,0,13,0,-13
19319,1,0,215,0,-215
19320,1,0,46,0,-46
19321,1,0,18,0,-18
19322,1,0,136,0,-136
19323,1,0,3,0,-3
19324,1,1,350,1359,1009
19325,1,1,79,1495,1416
19326,1,1,330,1570,1240
19327,0,0,15,0,-15
19328,0,0,0,0,0
19329,1,1,51,1491,1440
19330,0,0,35,0,-35
19331,1,1,412,1640,1228
19332,1,1,743,1471,728
19333,1,1,170,1253,1083
19334,1,1,96,1889,1793
19335,0,0,61,0,-61
19336,1,0,23,0,-23
19337,0,0,2,0,-2
19338,1,1,170,1678,1508
19339,1,0,4,0,-4
19340,0,0,140,0,-140
19341,0,0,41,0,-41
19342,1,0,40,0,-40
19343,0,0,8,0,-8
19344,0,0,106,0,-106
19345,1,0,5,0,-5
19346,0,0,0,0,0
19347,0,0,25,0,-25
19348,0,0,17,0,-17
19349,1,0,9,0,-9
19350,1,1,24,1471,1447
19351,0,0,3,0,-3
19352,1,0,190,0,-190
19353,1,1,236,1328,1092
19354,0,0,9,0,-9
19355,0,0,29,0,-29
19356,0,0,7,0,-7
19357,1,1,354,1475,1121
19358,1,1,380,2418,2038
19359,1,0,112,0,-112
19360,0,0,16,0,-16
19361,0,0,99,0,-99
19362,0,0,37,0,-37
19363,1,1,178,4861,4683
19364,1,0,43,0,-43
19365,0,0,19,0,-19
19366,0,0,25,0,-25
19367,1,1,379,1891,1512
19368,0,0,18,0,-18
19369,0,0,18,0,-18
19370,0,0,3,0,-3
19371,1,1,1175,1322,147
19372,1,1,286,1412,1126
19373,0,0,58,0,-58
19374,1,1,892,2738,1846
19375,0,0,20,0,-20
19376,1,1,452,2178,1726
19377,0,0,51,0,-51
19378,1,1,213,1460,1247
19379,1,1,152,1320,1168
19380,1,0,148,0,-148
19381,1,0,1,0,-1
19382,1,1,155,1650,1495
19383,1,1,812,1390,578
19384,0,0,143,0,-143
19385,1,0,154,0,-154
19386,1,1,496,1572,1076
19387,1,0,48,0,-48
19388,1,0,35,0,-35
19389,1,1,94,1775,1681
19390,0,0,85,0,-85
19391,1,0,1,0,-1
19392,1,1,401,1289,888
19393,1,1,1183,1303,120
19394,1,0,0,0,0
19395,1,1,422,1417,995
19396,1,0,16,0,-16
19397,1,1,608,1541,933
19398,0,0,22,0,-22
19399,1,1,496,1237,741
19400,0,0,35,0,-35
19401,0,0,33,0,-33
19402,1,0,7,0,-7
19403,1,0,90,0,-90
19404,1,1,654,1323,669
19405,0,0,241,0,-241
19406,0,0,38,0,-38
19407,0,0,6,0,-6
19408,1,1,138,1581,1443
19409,0,0,22,0,-22
19410,1,0,157,0,-157
19411,0,0,4,0,-4
19412,1,1,452,4759,4307
19413,1,1,839,1944,1105
19414,0,0,20,0,-20
19415,1,1,501,1369,868
19416,1,1,629,1264,635
19417,1,1,356,1433,1077
19418,0,0,139,0,-139
19419,1,0,21,0,-21
19420,0,0,31,0,-31
19421,1,0,44,0,-44
19422,0,0,21,0,-21
19423,1,0,53,0,-53
19424,1,1,1257,1683,426
19425,1,1,806,1344,538
19426,0,0,188,0,-188
19427,1,0,65,0,-65
19428,1,0,38,0,-38
19429,1,1,1454,1267,-187
19430,1,0,55,0,-55
19431,0,0,69,0,-69
19432,1,0,60,0,-60
19433,0,0,21,0,-21
19434,1,1,1340,1588,248
19435,1,1,920,1440,520
19436,0,0,11,0,-11
19437,1,1,599,4460,3861
19438,0,0,65,0,-65
19439,1,0,114,0,-114
19440,1,0,19,0,-19
19441,1,1,984,1267,283
19442,1,0,19,0,-19
19443,1,1,245,1589,1344
19444,1,0,10,0,-10
19445,1,0,11,0,-11
19446,1,1,134,2650,2516
19447,0,0,65,0,-65
19448,1,1,198,1459,1261
19449,0,0,30,0,-30
19450,0,0,9,0,-9
19451,1,1,1051,1421,370
19452,0,0,7,0,-7
19453,1,1,560,1239,679
19454,1,1,457,1346,889
19455,1,1,1083,1445,362
19456,1,0,11,0,-11
19457,0,0,8,0,-8
19458,1,1,1794,1295,-499
19459,0,0,31,0,-31
19460,1,0,1,0,-1
19461,0,0,53,0,-53
19462,0,0,23,0,-23
19463,1,0,5,0,-5
19464,1,0,9,0,-9
19465,1,0,37,0,-37
19466,0,0,120,0,-120
19467,0,0,33,0,-33
19468,1,0,14,0,-14
19469,1,0,85,0,-85
19470,0,0,52,0,-52
19471,1,1,34,1426,1392
19472,1,1,1246,1537,291
19473,0,0,336,0,-336
19474,1,0,4,0,-4
19475,0,0,85,0,-85
19476,0,0,173,0,-173
19477,0,0,4,0,-4
19478,1,1,655,1263,608
19479,1,0,10,0,-10
19480,1,0,51,0,-51
19481,1,1,289,2167,1878
19482,1,0,17,0,-17
19483,1,1,180,2535,2355
19484,1,1,416,2212,1796
19485,0,0,20,0,-20
19486,1,1,1140,3747,2607
19487,1,1,260,1423,1163
19488,1,1,1100,1403,303
19489,1,1,629,2300,1671
19490,1,0,23,0,-23
19491,1,1,239,1314,1075
19492,0,0,4,0,-4
19493,0,0,50,0,-50
19494,1,0,59,0,-59
19495,1,1,171,1404,1233
19496,1,1,1208,1519,311
19497,1,1,723,1348,625
19498,1,1,329,1249,920
19499,1,1,202,1320,1118
19500,1,1,229,1466,1237
19501,1,1,106,2313,2207
19502,1,0,27,0,-27
19503,1,0,71,0,-71
19504,1,1,345,1342,997
19505,0,0,58,0,-58
19506,1,1,367,1807,1440
19507,0,0,12,0,-12
19508,0,0,96,0,-96
19509,1,0,9,0,-9
19510,0,0,18,0,-18
19511,0,0,149,0,-149
19512,1,1,1092,1259,167
19513,1,0,118,0,-118
19514,0,0,64,0,-64
19515,1,1,38,1273,1235
19516,0,0,16,0,-16
19517,1,1,337,1375,1038
19518,0,0,61,0,-61
19519,0,0,2,0,-2
19520,0,0,80,0,-80
19521,1,0,0,0,0
19522,0,0,30,0,-30
19523,0,0,20,0,-20
19524,1,0,59,0,-59
19525,1,0,16,0,-16
19526,1,1,1941,1444,-497
19527,1,1,475,1392,917
19528,1,0,63,0,-63
19529,1,1,284,1703,1419
19530,1,0,65,0,-65
19531,0,0,18,0,-18
19532,0,0,15,0,-15
19533,0,0,109,0,-109
19534,0,0,178,0,-178
19535,1,0,45,0,-45
19536,0,0,3,0,-3
19537,1,0,61,0,-61
19538,0,0,10,0,-10
19539,1,1,307,2032,1725
19540,1,0,6,0,-6
19541,1,1,412,1510,1098
19542,1,1,510,1325,815
19543,1,0,76,0,-76
19544,1,1,810,1571,761
19545,1,1,1299,2201,902
19546,1,1,382,1418,1036
19547,1,0,41,0,-41
19548,0,0,12,0,-12
19549,0,0,20,0,-20
19550,1,0,17,0,-17
19551,1,1,202,1749,1547
19552,0,0,59,0,-59
19553,1,0,4,0,-4
19554,1,1,1721,1326,-395
19555,0,0,18,0,-18
19556,0,0,4,0,-4
19557,1,0,80,0,-80
19558,0,0,99,0,-99
19559,1,0,34,0,-34
19560,1,0,154,0,-154
19561,0,0,46,0,-46
19562,1,0,40,0,-40
19563,1,0,15,0,-15
19564,0,0,78,0,-78
19565,1,0,67,0,-67
19566,0,0,3,0,-3
19567,0,0,57,0,-57
19568,1,0,85,0,-85
19569,1,1,53,2709,2656
19570,1,0,31,0,-31
19571,1,0,18,0,-18
19572,1,1,52,1438,1386
19573,0,0,22,0,-22
19574,0,0,125,0,-125
19575,1,0,68,0,-68
19576,1,0,33,0,-33
19577,1,1,220,1282,1062
19578,0,0,28,0,-28
19579,1,1,295,1380,1085
19580,0,0,21,0,-21
19581,1,0,87,0,-87
19582,1,1,1479,1244,-235
19583,1,0,85,0,-85
19584,0,0,58,0,-58
19585,1,0,69,0,-69
19586,1,0,106,0,-106
19587,1,0,100,0,-100
19588,0,0,47,0,-47
19589,0,0,8,0,-8
19590,1,1,449,1511,1062
19591,0,0,20,0,-20
19592,1,1,111,1252,1141
19593,0,0,46,0,-46
19594,0,0,26,0,-26
19595,0,0,88,0,-88
19596,1,1,941,1249,308
19597,0,0,50,0,-50
19598,0,0,12,0,-12
19599,0,0,79,0,-79
19600,1,1,396,1313,917
19601,1,0,106,0,-106
19602,1,1,325,1621,1296
19603,0,0,28,0,-28
19604,1,1,371,1456,1085
19605,1,1,419,1438,1019
19606,1,1,129,1533,1404
19607,1,1,1200,2053,853
19608,0,0,53,0,-53
19609,1,1,567,1301,734
19610,0,0,4,0,-4
19611,1,1,684,2545,1861
19612,0,0,110,0,-110
19613,1,1,456,1489,1033
19614,1,0,58,0,-58
19615,0,0,89,0,-89
19616,1,1,476,1529,1053
19617,0,0,48,0,-48
19618,0,0,2,0,-2
19619,0,0,78,0,-78
19620,0,0,54,0,-54
19621,0,0,35,0,-35
19622,1,1,186,1272,1086
19623,1,1,389,1552,1163
19624,1,0,73,0,-73
19625,1,1,1285,1461,176
19626,1,0,17,0,-17
19627,1,1,347,1361,1014
19628,1,1,206,1354,1148
19629,0,0,95,0,-95
19630,1,0,13,0,-13
19631,0,0,58,0,-58
19632,0,0,4,0,-4
19633,1,0,95,0,-95
19634,1,1,499,1503,1004
19635,1,0,5,0,-5
19636,1,1,194,1501,1307
19637,1,1,77,2704,2627
19638,1,1,1350,1635,285
19639,1,1,981,1375,394
19640,1,1,568,2134,1566
19641,0,0,19,0,-19
19642,1,0,230,0,-230
19643,0,0,2,0,-2
19644,0,0,12,0,-12
19645,0,0,67,0,-67
19646,1,0,50,0,-50
19647,0,0,120,0,-120
19648,1,0,12,0,-12
19649,1,0,3,0,-3
19650,1,0,32,0,-32
19651,1,1,618,1291,673
19652,1,0,32,0,-32
19653,1,1,94,1322,1228
19654,1,0,1,0,-1
19655,1,1,197,1284,1087
19656,0,0,33,0,-33
19657,1,0,161,0,-161
19658,0,0,18,0,-18
19659,1,0,12,0,-12
19660,1,1,126,1891,1765
19661,0,0,52,0,-52
19662,1,1,39,1303,1264
19663,1,1,157,1566,1409
19664,1,0,96,0,-96
19665,1,1,142,2739,2597
19666,0,0,62,0,-62
19667,0,0,49,0,-49
19668,1,0,60,0,-60
19669,1,1,170,1719,1549
19670,1,0,21,0,-21
19671,0,0,26,0,-26
19672,1,1,396,3641,3245
19673,0,0,69,0,-69
19674,0,0,20,0,-20
19675,1,0,12,0,-12
19676,0,0,38,0,-38
19677,1,1,428,2025,1597
19678,0,0,32,0,-32
19679,1,0,51,0,-51
19680,1,1,601,1660,1059
19681,1,0,3,0,-3
19682,1,1,382,1289,907
19683,0,0,5,0,-5
19684,1,0,42,0,-42
19685,1,0,15,0,-15
19686,1,1,259,1425,1166
19687,1,1,234,2953,2719
19688,0,0,36,0,-36
19689,1,1,80,1316,1236
19690,1,0,86,0,-86
19691,0,0,30,0,-30
19692,1,1,681,1653,972
19693,1,1,782,1343,561
19694,0,0,50,0,-50
19695,0,0,28,0,-28
19696,0,0,49,0,-49
19697,0,0,34,0,-34
19698,1,0,19,0,-19
19699,0,0,201,0,-201
19700,1,1,1029,1500,471
19701,1,1,249,2105,1856
19702,1,1,720,1405,685
19703,1,0,73,0,-73
19704,1,1,103,1491,1388
19705,0,0,6,0,-6
19706,1,1,300,1411,1111
19707,0,0,133,0,-133
19708,1,0,6,0,-6
19709,1,1,545,3264,2719
19710,1,1,746,1680,934
19711,1,0,4,0,-4
19712,1,0,75,0,-75
19713,1,1,233,1648,1415
19714,1,0,134,0,-134
19715,1,0,88,0,-88
19716,0,0,59,0,-59
19717,0,0,128,0,-128
19718,1,0,108,0,-108
19719,0,0,36,0,-36
19720,1,1,817,1680,863
19721,1,0,42,0,-42
19722,0,0,63,0,-63
19723,1,0,41,0,-41
19724,0,0,72,0,-72
19725,1,0,74,0,-74
19726,0,0,16,0,-16
19727,0,0,0,0,0
19728,0,0,53,0,-53
19729,1,1,352,1636,1284
19730,0,0,4,0,-4
19731,1,1,829,1291,462
19732,0,0,66,0,-66
19733,1,0,125,0,-125
19734,1,1,863,1280,417
19735,0,0,162,0,-162
19736,0,0,122,0,-122
19737,0,0,36,0,-36
19738,1,1,532,1494,962
19739,1,1,399,1857,1458
19740,1,0,25,0,-25
19741,1,0,108,0,-108
19742,1,1,850,1279,429
19743,1,0,37,0,-37
19744,1,1,710,1564,854
19745,1,0,34,0,-34
19746,1,0,217,0,-217
19747,1,1,509,1308,799
19748,1,1,645,1292,647
19749,0,0,42,0,-42
19750,1,0,120,0,-120
19751,1,1,696,1708,1012
19752,0,0,58,0,-58
19753,1,1,164,1585,1421
19754,1,0,33,0,-33
19755,0,0,19,0,-19
19756,1,1,1637,1437,-200
19757,1,1,351,1480,1129
19758,1,1,321,1382,1061
19759,1,0,33,0,-33
19760,1,1,632,1379,747
19761,0,0,31,0,-31
19762,1,1,1061,1350,289
19763,0,0,49,0,-49
19764,1,0,4,0,-4
19765,0,0,62,0,-62
19766,1,0,30,0,-30
19767,1,0,30,0,-30
19768,1,0,66,0,-66
19769,1,1,1064,1812,748
19770,0,0,8,0,-8
19771,1,0,116,0,-116
19772,0,0,13,0,-13
19773,0,0,119,0,-119
19774,0,0,20,0,-20
19775,1,1,306,1580,1274
19776,1,0,31,0,-31
19777,1,1,690,1554,864
19778,1,1,106,2583,2477
19779,0,0,64,0,-64
19780,0,0,17,0,-17
19781,1,0,31,0,-31
19782,0,0,12,0,-12
19783,1,0,19,0,-19
19784,1,0,6,0,-6
19785,0,0,2,0,-2
19786,1,0,26,0,-26
19787,1,0,30,0,-30
19788,1,0,98,0,-98
19789,1,0,1,0,-1
19790,0,0,9,0,-9
19791,1,1,54,1309,1255
19792,1,0,29,0,-29
19793,1,0,51,0,-51
19794,1,1,431,1384,953
19795,0,0,50,0,-50
19796,1,0,0,0,0
19797,0,0,61,0,-61
19798,1,0,67,0,-67
19799,1,0,34,0,-34
19800,1,0,139,0,-139
19801,1,0,15,0,-15
19802,1,0,50,0,-50
19803,1,0,155,0,-155
19804,1,1,343,1552,1209
19805,1,1,1885,1784,-101
19806,1,0,12,0,-12
19807,1,0,68,0,-68
19808,0,0,9,0,-9
19809,1,1,188,1344,1156
19810,1,1,84,1328,1244
19811,0,0,0,0,0
19812,0,0,18,0,-18
19813,0,0,111,0,-111
19814,1,0,158,0,-158
19815,1,1,232,1296,1064
19816,1,1,158,1293,1135
19817,1,1,760,2213,1453
19818,0,0,16,0,-16
19819,0,0,108,0,-108
19820,1,0,2,0,-2
19821,1,0,2,0,-2
19822,1,0,24,0,-24
19823,1,1,468,1353,885
19824,0,0,36,0,-36
19825,0,0,104,0,-104
19826,1,1,539,1314,775
19827,0,0,94,0,-94
19828,0,0,56,0,-56
19829,1,1,650,2078,1428
19830,1,0,106,0,-106
19831,1,1,162,1563,1401
19832,0,0,44,0,-44
19833,0,0,51,0,-51
19834,1,0,3,0,-3
19835,0,0,12,0,-12
19836,1,0,191,0,-191
19837,1,1,336,2033,1697
19838,0,0,6,0,-6
19839,1,1,1497,1293,-204
19840,1,0,6,0,-6
19841,1,0,3,0,-3
19842,0,0,26,0,-26
19843,0,0,73,0,-73
19844,1,1,156,1395,1239
19845,0,0,3,0,-3
19846,0,0,2,0,-2
19847,1,1,326,1397,1071
19848,1,0,4,0,-4
19849,0,0,6,0,-6
19850,1,1,130,1574,1444
19851,0,0,3,0,-3
19852,0,0,29,0,-29
19853,1,1,314,1400,1086
19854,1,1,759,2116,1357
19855,1,1,133,1617,1484
19856,0,0,90,0,-90
19857,0,0,19,0,-19
19858,0,0,21,0,-21
19859,1,0,79,0,-79
19860,1,0,0,0,0
19861,1,0,6,0,-6
19862,0,0,2,0,-2
19863,1,0,42,0,-42
19864,0,0,45,0,-45
19865,1,1,461,2304,1843
19866,0,0,41,0,-41
19867,0,0,52,0,-52
19868,1,1,261,1488,1227
19869,1,0,91,0,-91
19870,1,0,18,0,-18
19871,1,1,651,1727,1076
19872,0,0,31,0,-31
19873,1,0,28,0,-28
19874,1,0,31,0,-31
19875,1,1,399,2119,1720
19876,0,0,17,0,-17
19877,0,0,13,0,-13
19878,1,1,1051,1556,505
19879,0,0,57,0,-57
19880,1,0,285,0,-285
19881,1,0,45,0,-45
19882,1,0,89,0,-89
19883,0,0,139,0,-139
19884,0,0,19,0,-19
19885,1,1,219,1686,1467
19886,0,0,7,0,-7
19887,0,0,18,0,-18
19888,1,0,55,0,-55
19889,0,0,27,0,-27
19890,1,0,15,0,-15
19891,0,0,46,0,-46
19892,1,0,18,0,-18
19893,1,1,730,1334,604
19894,1,0,23,0,-23
19895,0,0,29,0,-29
19896,1,1,97,1461,1364
19897,1,1,894,2103,1209
19898,0,0,19,0,-19
19899,1,1,490,1585,1095
19900,1,1,594,1673,1079
19901,1,0,13,0,-13
19902,0,0,51,0,-51
19903,1,0,159,0,-159
19904,0,0,27,0,-27
19905,0,0,15,0,-15
19906,0,0,27,0,-27
19907,0,0,58,0,-58
19908,1,1,322,1241,919
19909,0,0,91,0,-91
19910,1,0,20,0,-20
19911,0,0,20,0,-20
19912,1,1,271,2159,1888
19913,0,0,71,0,-71
19914,0,0,7,0,-7
19915,1,1,276,1728,1452
19916,1,0,57,0,-57
19917,1,0,48,0,-48
19918,0,0,6,0,-6
19919,1,0,38,0,-38
19920,0,0,57,0,-57
19921,1,0,30,0,-30
19922,0,0,45,0,-45
19923,0,0,32,0,-32
19924,1,1,694,1586,892
19925,0,0,128,0,-128
19926,1,0,21,0,-21
19927,0,0,8,0,-8
19928,0,0,0,0,0
19929,1,0,37,0,-37
19930,1,0,31,0,-31
19931,0,0,44,0,-44
19932,1,0,31,0,-31
19933,1,1,449,1418,969
19934,0,0,11,0,-11
19935,0,0,27,0,-27
19936,1,1,409,1631,1222
19937,0,0,7,0,-7
19938,1,0,110,0,-110
19939,1,1,397,2438,2041
19940,0,0,96,0,-96
19941,1,0,6,0,-6
19942,0,0,53,0,-53
19943,1,1,291,1371,1080
19944,1,0,65,0,-65
19945,0,0,54,0,-54
19946,1,1,627,1486,859
19947,1,0,3,0,-3
19948,0,0,9,0,-9
19949,1,1,29,1548,1519
19950,0,0,40,0,-40
19951,0,0,34,0,-34
19952,0,0,25,0,-25
19953,1,1,520,1577,1057
19954,1,1,380,1404,1024
19955,1,0,4,0,-4
19956,1,0,10,0,-10
19957,1,0,25,0,-25
19958,0,0,39,0,-39
19959,0,0,47,0,-47
19960,0,0,70,0,-70
19961,1,1,28,1629,1601
19962,1,0,0,0,0
19963,0,0,27,0,-27
19964,1,0,113,0,-113
19965,0,0,22,0,-22
19966,0,0,37,0,-37
19967,1,1,359,1338,979
19968,0,0,76,0,-76
19969,1,1,541,1245,704
19970,0,0,54,0,-54
19971,0,0,30,0,-30
19972,0,0,99,0,-99
19973,0,0,5,0,-5
19974,1,0,80,0,-80
19975,1,1,733,1467,734
19976,1,1,582,1922,1340
19977,1,0,38,0,-38
19978,1,1,97,2264,2167
19979,1,1,48,1926,1878
19980,1,1,300,1644,1344
19981,0,0,12,0,-12
19982,1,1,291,1258,967
19983,1,1,133,1559,1426
19984,1,1,437,2789,2352
19985,0,0,61,0,-61
19986,1,1,408,1601,1193
19987,0,0,85,0,-85
19988,1,0,50,0,-50
19989,0,0,13,0,-13
19990,0,0,46,0,-46
19991,1,0,2,0,-2
19992,1,1,693,1410,717
19993,1,1,554,2705,2151
19994,1,0,19,0,-19
19995,1,1,164,1317,1153
19996,0,0,34,0,-34
19997,0,0,114,0,-114
19998,1,0,5,0,-5
19999,0,0,23,0,-23
20000,0,0,9,0,-9
20001,1,1,238,1236,998
20002,1,1,665,1784,1119
20003,0,0,3,0,-3
20004,0,0,7,0,-7
20005,1,1,160,1991,1831
20006,1,0,61,0,-61
20007,1,1,643,1337,694
20008,1,1,1070,1790,720
20009,0,0,55,0,-55
20010,0,0,36,0,-36
20011,0,0,102,0,-102
20012,0,0,20,0,-20
20013,0,0,137,0,-137
20014,0,0,14,0,-14
20015,0,0,9,0,-9
20016,1,1,519,1543,1024
20017,0,0,30,0,-30
20018,1,1,439,2096,1657
20019,1,0,160,0,-160
20020,0,0,101,0,-101
20021,1,0,53,0,-53
20022,1,1,261,1266,1005
20023,0,0,119,0,-119
20024,1,0,17,0,-17
20025,0,0,7,0,-7
20026,0,0,4,0,-4
20027,1,1,1128,1654,526
20028,0,0,11,0,-11
20029,1,1,590,1656,1066
20030,1,0,167,0,-167
20031,0,0,82,0,-82
20032,0,0,43,0,-43
20033,0,0,2,0,-2
20034,1,1,360,1431,1071
20035,0,0,13,0,-13
20036,0,0,98,0,-98
20037,1,1,1499,1596,97
20038,0,0,22,0,-22
20039,1,1,224,1896,1672
20040,1,0,10,0,-10
20041,0,0,168,0,-168
20042,0,0,11,0,-11
20043,0,0,61,0,-61
20044,1,1,157,1549,1392
20045,1,1,431,1262,831
20046,0,0,41,0,-41
20047,0,0,21,0,-21
20048,1,0,112,0,-112
20049,1,0,73,0,-73
20050,0,0,1,0,-1
20051,0,0,6,0,-6
20052,1,1,449,2714,2265
20053,1,0,10,0,-10
20054,1,1,1107,1545,438
20055,0,0,65,0,-65
20056,1,0,14,0,-14
20057,0,0,61,0,-61
20058,0,0,9,0,-9
20059,1,0,23,0,-23
20060,1,1,75,1346,1271
20061,0,0,40,0,-40
20062,1,1,371,1416,1045
20063,1,0,5,0,-5
20064,1,0,64,0,-64
20065,1,1,1726,1298,-428
20066,0,0,44,0,-44
20067,0,0,18,0,-18
20068,0,0,228,0,-228
20069,1,1,806,1281,475
20070,0,0,35,0,-35
20071,0,0,6,0,-6
20072,1,1,372,2109,1737
20073,1,0,48,0,-48
20074,1,1,61,1360,1299
20075,0,0,37,0,-37
20076,1,1,409,1468,1059
20077,1,0,35,0,-35
20078,0,0,50,0,-50
20079,0,0,27,0,-27
20080,1,0,47,0,-47
20081,0,0,39,0,-39
20082,0,0,6,0,-6
20083,1,1,675,1249,574
20084,0,0,20,0,-20
20085,0,0,7,0,-7
20086,1,0,25,0,-25
20087,0,0,12,0,-12
20088,1,1,342,1314,972
20089,1,1,1082,1590,508
20090,1,1,322,1442,1120
20091,1,1,50,3694,3644
20092,0,0,40,0,-40
20093,1,1,67,1412,1345
20094,1,1,758,1525,767
20095,0,0,83,0,-83
20096,1,1,780,1377,597
20097,1,0,103,0,-103
20098,0,0,8,0,-8
20099,1,1,2668,2211,-457
20100,0,0,12,0,-12
20101,1,1,1155,1672,517
20102,0,0,51,0,-51
20103,1,1,754,1399,645
20104,1,1,252,1271,1019
20105,1,1,31,1551,1520
20106,1,0,10,0,-10
20107,0,0,5,0,-5
20108,1,1,281,1827,1546
20109,0,0,66,0,-66
20110,1,0,23,0,-23
20111,1,1,26,1397,1371
20112,1,1,310,1614,1304
20113,1,1,405,2119,1714
20114,1,1,409,2387,1978
20115,0,0,8,0,-8
20116,1,1,245,1581,1336
20117,1,0,36,0,-36
20118,1,1,131,2265,2134
20119,1,0,82,0,-82
20120,0,0,92,0,-92
20121,1,0,42,0,-42
20122,1,0,41,0,-41
20123,1,0,36,0,-36
20124,0,0,36,0,-36
20125,0,0,21,0,-21
20126,0,0,24,0,-24
20127,1,0,90,0,-90
20128,1,1,113,1830,1717
20129,1,0,77,0,-77
20130,0,0,8,0,-8
20131,1,0,69,0,-69
20132,0,0,73,0,-73
20133,1,0,161,0,-161
20134,1,1,330,1268,938
20135,1,0,76,0,-76
20136,1,1,1167,1259,92
20137,0,0,5,0,-5
20138,1,1,388,1299,911
20139,0,0,214,0,-214
20140,1,1,95,1955,1860
20141,1,1,439,1309,870
20142,0,0,9,0,-9
20143,1,1,1372,1266,-106
20144,0,0,102,0,-102
20145,0,0,62,0,-62
20146,0,0,169,0,-169
20147,0,0,167,0,-167
20148,0,0,74,0,-74
20149,0,0,216,0,-216
20150,1,0,17,0,-17
20151,0,0,119,0,-119
20152,1,0,39,0,-39
20153,1,1,980,1677,697
20154,1,1,180,1495,1315
20155,1,0,24,0,-24
20156,1,1,340,1407,1067
20157,1,0,38,0,-38
20158,0,0,42,0,-42
20159,1,1,173,1239,1066
20160,1,1,955,1751,796
20161,1,1,248,1707,1459
20162,1,1,882,1251,369
20163,0,0,2,0,-2
20164,1,0,23,0,-23
20165,0,0,7,0,-7
20166,1,0,9,0,-9
20167,0,0,40,0,-40
20168,1,0,57,0,-57
20169,1,0,69,0,-69
20170,1,1,594,1832,1238
20171,1,1,691,1437,746
20172,1,0,125,0,-125
20173,0,0,100,0,-100
20174,0,0,15,0,-15
20175,1,0,35,0,-35
20176,0,0,57,0,-57
20177,0,0,135,0,-135
20178,0,0,18,0,-18
20179,0,0,10,0,-10
20180,1,1,730,1535,805
20181,0,0,79,0,-79
20182,1,1,111,1269,1158
20183,0,0,18,0,-18
20184,1,0,54,0,-54
20185,0,0,58,0,-58
20186,0,0,34,0,-34
20187,0,0,139,0,-139
20188,1,0,108,0,-108
20189,1,1,40,2367,2327
20190,0,0,15,0,-15
20191,0,0,15,0,-15
20192,1,1,760,1736,976
20193,0,0,8,0,-8
20194,0,0,5,0,-5
20195,0,0,37,0,-37
20196,0,0,19,0,-19
20197,0,0,27,0,-27
20198,1,1,171,2391,2220
20199,1,1,1024,1810,786
20200,0,0,23,0,-23
20201,0,0,50,0,-50
20202,1,1,198,1321,1123
20203,1,1,176,1706,1530
20204,0,0,1,0,-1
20205,1,0,12,0,-12
20206,1,0,33,0,-33
20207,1,0,61,0,-61
20208,1,0,17,0,-17
20209,0,0,18,0,-18
20210,1,1,2021,2013,-8
20211,1,0,10,0,-10
20212,1,0,18,0,-18
20213,0,0,49,0,-49
20214,1,1,498,2571,2073
20215,1,0,177,0,-177
20216,0,0,44,0,-44
20217,1,1,1969,1297,-672
20218,1,1,520,1300,780
20219,0,0,19,0,-19
20220,0,0,21,0,-21
20221,1,1,302,1651,1349
20222,0,0,103,0,-103
20223,1,0,48,0,-48
20224,0,0,26,0,-26
20225,1,0,17,0,-17
20226,1,0,6,0,-6
20227,0,0,20,0,-20
20228,0,0,97,0,-97
20229,1,1,140,1259,1119
20230,1,0,49,0,-49
20231,1,0,14,0,-14
20232,1,0,25,0,-25
20233,1,0,70,0,-70
20234,0,0,42,0,-42
20235,0,0,38,0,-38
20236,0,0,25,0,-25
20237,1,1,490,1339,849
20238,0,0,87,0,-87
20239,1,0,30,0,-30
20240,1,1,1217,1237,20
20241,1,1,1533,1845,312
20242,1,0,6,0,-6
20243,0,0,108,0,-108
20244,0,0,2,0,-2
20245,0,0,7,0,-7
20246,0,0,40,0,-40
20247,1,1,53,1933,1880
20248,1,1,1317,1359,42
20249,1,0,59,0,-59
20250,0,0,28,0,-28
20251,0,0,246,0,-246
20252,0,0,3,0,-3
20253,0,0,6,0,-6
20254,1,1,475,1269,794
20255,1,1,1330,1275,-55
20256,1,1,1279,1364,85
20257,0,0,72,0,-72
20258,1,1,176,1281,1105
20259,0,0,16,0,-16
20260,1,1,800,1872,1072
20261,1,0,51,0,-51
20262,0,0,2,0,-2
20263,1,0,143,0,-143
20264,1,0,105,0,-105
20265,0,0,2,0,-2
20266,1,1,205,2115,1910
20267,1,1,576,1501,925
20268,0,0,4,0,-4
20269,0,0,37,0,-37
20270,1,0,121,0,-121
20271,0,0,54,0,-54
20272,0,0,29,0,-29
20273,0,0,18,0,-18
20274,1,0,3,0,-3
20275,0,0,51,0,-51
20276,1,1,92,1403,1311
20277,0,0,20,0,-20
20278,1,1,124,1357,1233
20279,0,0,67,0,-67
20280,1,1,1342,1430,88
20281,1,0,133,0,-133
20282,1,0,86,0,-86
20283,1,1,53,1414,1361
20284,1,0,6,0,-6
20285,0,0,58,0,-58
20286,1,0,56,0,-56
20287,1,0,66,0,-66
20288,0,0,7,0,-7
20289,1,1,845,1534,689
20290,1,1,90,1739,1649
20291,0,0,70,0,-70
20292,1,1,570,1643,1073
20293,1,0,29,0,-29
20294,0,0,39,0,-39
20295,0,0,15,0,-15
20296,1,1,250,2990,2740
20297,1,0,12,0,-12
20298,1,0,91,0,-91
20299,1,0,17,0,-17
20300,1,1,1044,1551,507
20301,1,0,58,0,-58
20302,1,1,1867,2790,923
20303,0,0,7,0,-7
20304,0,0,15,0,-15
20305,1,1,221,2572,2351
20306,0,0,19,0,-19
20307,1,1,280,1439,1159
20308,1,1,892,1448,556
20309,1,0,16,0,-16
20310,1,0,123,0,-123
20311,1,1,137,2251,2114
20312,1,1,281,1685,1404
20313,1,0,12,0,-12
20314,0,0,69,0,-69
20315,1,0,20,0,-20
20316,1,1,146,3241,3095
20317,1,0,177,0,-177
20318,0,0,7,0,-7
20319,1,0,10,0,-10
20320,1,0,357,0,-357
20321,1,0,100,0,-100
20322,1,1,802,2028,1226
20323,1,1,145,1755,1610
20324,1,1,713,1245,532
20325,0,0,94,0,-94
20326,1,1,2458,1388,-1070
20327,0,0,196,0,-196
20328,1,0,8,0,-8
20329,0,0,51,0,-51
20330,1,0,125,0,-125
20331,0,0,2,0,-2
20332,0,0,7,0,-7
20333,1,0,5,0,-5
20334,1,0,16,0,-16
20335,0,0,58,0,-58
20336,1,1,55,1465,1410
20337,1,0,13,0,-13
20338,0,0,7,0,-7
20339,1,0,39,0,-39
20340,0,0,2,0,-2
20341,1,1,1211,2033,822
20342,1,0,55,0,-55
20343,1,0,6,0,-6
20344,0,0,3,0,-3
20345,0,0,16,0,-16
20346,1,0,32,0,-32
20347,0,0,64,0,-64
20348,0,0,36,0,-36
20349,1,1,331,1897,1566
20350,0,0,69,0,-69
20351,1,1,38,1282,1244
20352,1,1,654,1358,704
20353,1,1,203,2186,1983
20354,0,0,37,0,-37
20355,1,0,13,0,-13
20356,1,0,96,0,-96
20357,1,1,401,1331,930
20358,0,0,0,0,0
20359,1,0,74,0,-74
20360,0,0,94,0,-94
20361,0,0,58,0,-58
20362,1,0,124,0,-124
20363,1,1,832,1525,693
20364,1,0,3,0,-3
20365,1,1,659,1533,874
20366,0,0,5,0,-5
20367,1,0,55,0,-55
20368,0,0,39,0,-39
20369,0,0,9,0,-9
20370,0,0,43,0,-43
20371,0,0,26,0,-26
20372,1,0,3,0,-3
20373,0,0,5,0,-5
20374,0,0,48,0,-48
20375,0,0,29,0,-29
20376,1,1,468,1308,840
20377,0,0,103,0,-103
20378,0,0,2,0,-2
20379,0,0,7,0,-7
20380,0,0,7,0,-7
20381,1,1,484,7118,6634
20382,1,1,684,1245,561
20383,0,0,30,0,-30
20384,1,1,307,1555,1248
20385,1,0,103,0,-103
20386,1,1,263,1677,1414
20387,0,0,91,0,-91
20388,1,0,62,0,-62
20389,0,0,21,0,-21
20390,1,1,169,1363,1194
20391,1,1,235,1318,1083
20392,1,0,32,0,-32
20393,0,0,68,0,-68
20394,0,0,16,0,-16
20395,1,1,314,1413,1099
20396,1,1,1001,1251,250
20397,1,0,1,0,-1
20398,0,0,27,0,-27
20399,1,1,462,1392,930
20400,1,1,314,1417,1103
20401,1,1,276,1357,1081
20402,1,0,36,0,-36
20403,1,1,93,1361,1268
20404,1,1,1557,1410,-147
20405,0,0,18,0,-18
20406,0,0,21,0,-21
20407,1,0,13,0,-13
20408,1,0,17,0,-17
20409,1,1,366,1341,975
20410,1,1,82,1963,1881
20411,1,0,45,0,-45
20412,0,0,114,0,-114
20413,1,1,904,1728,824
20414,1,1,196,1501,1305
20415,1,1,464,1355,891
20416,0,0,1,0,-1
20417,1,0,35,0,-35
20418,1,1,815,2100,1285
20419,1,1,26,1398,1372
20420,1,1,971,1237,266
20421,1,1,156,1407,1251
20422,1,0,21,0,-21
20423,0,0,8,0,-8
20424,1,0,127,0,-127
20425,0,0,74,0,-74
20426,0,0,11,0,-11
20427,1,0,109,0,-109
20428,1,1,1160,1288,128
20429,1,1,1442,2093,651
20430,1,1,863,1486,623
20431,1,0,41,0,-41
20432,1,1,941,1265,324
20433,1,0,115,0,-115
20434,1,0,15,0,-15
20435,0,0,61,0,-61
20436,0,0,61,0,-61
20437,0,0,8,0,-8
20438,0,0,90,0,-90
20439,0,0,16,0,-16
20440,1,0,18,0,-18
20441,0,0,75,0,-75
20442,1,0,39,0,-39
20443,0,0,37,0,-37
20444,1,1,148,1266,1118
20445,1,0,170,0,-170
20446,1,0,73,0,-73
20447,1,1,72,1297,1225
20448,1,1,426,1283,857
20449,0,0,92,0,-92
20450,0,0,101,0,-101
20451,0,0,102,0,-102
20452,1,0,4,0,-4
20453,1,1,1811,1435,-376
20454,1,0,7,0,-7
20455,1,0,29,0,-29
20456,1,0,66,0,-66
20457,0,0,46,0,-46
20458,1,0,47,0,-47
20459,0,0,35,0,-35
20460,1,0,5,0,-5
20461,1,1,700,1392,692
20462,1,1,256,1413,1157
20463,1,1,742,1288,546
20464,0,0,8,0,-8
20465,1,0,7,0,-7
20466,0,0,0,0,0
20467,0,0,5,0,-5
20468,0,0,1,0,-1
20469,1,0,9,0,-9
20470,0,0,10,0,-10
20471,0,0,117,0,-117
20472,1,1,131,2103,1972
20473,1,1,239,1644,1405
20474,0,0,47,0,-47
20475,0,0,119,0,-119
20476,1,0,22,0,-22
20477,1,0,35,0,-35
20478,1,1,560,1277,717
20479,1,1,68,1276,1208
20480,1,0,13,0,-13
20481,1,1,824,1306,482
20482,0,0,3,0,-3
20483,1,0,56,0,-56
20484,0,0,10,0,-10
20485,0,0,65,0,-65
20486,1,1,1123,1290,167
20487,0,0,24,0,-24
20488,1,0,18,0,-18
20489,1,0,16,0,-16
20490,0,0,1,0,-1
20491,1,0,0,0,0
20492,1,1,585,1253,668
20493,1,1,211,1427,1216
20494,1,1,655,1364,709
20495,1,0,90,0,-90
20496,1,1,834,1285,451
20497,0,0,41,0,-41
20498,0,0,37,0,-37
20499,1,1,295,1812,1517
20500,1,0,20,0,-20
20501,1,1,871,1689,818
20502,0,0,130,0,-130
20503,1,1,240,2127,1887
20504,0,0,52,0,-52
20505,1,0,48,0,-48
20506,1,1,246,1315,1069
20507,1,0,32,0,-32
20508,1,0,24,0,-24
20509,0,0,26,0,-26
20510,1,1,376,2015,1639
20511,0,0,91,0,-91
20512,1,1,332,1589,1257
20513,1,0,27,0,-27
20514,0,0,62,0,-62
20515,1,0,11,0,-11
20516,1,0,117,0,-117
20517,0,0,4,0,-4
20518,0,0,131,0,-131
20519,1,1,318,1370,1052
20520,1,0,20,0,-20
20521,0,0,16,0,-16
20522,1,0,85,0,-85
20523,0,0,18,0,-18
20524,0,0,70,0,-70
20525,1,1,400,1804,1404
20526,0,0,31,0,-31
20527,0,0,43,0,-43
20528,0,0,6,0,-6
20529,1,1,488,1658,1170
20530,1,0,1,0,-1
20531,1,0,249,0,-249
20532,0,0,22,0,-22
20533,0,0,41,0,-41
20534,0,0,12,0,-12
20535,1,1,499,1273,774
20536,0,0,62,0,-62
20537,0,0,43,0,-43
20538,0,0,11,0,-11
20539,1,0,114,0,-114
20540,0,0,10,0,-10
20541,1,0,56,0,-56
20542,0,0,25,0,-25
20543,1,0,12,0,-12
20544,0,0,42,0,-42
20545,0,0,31,0,-31
20546,1,0,5,0,-5
20547,1,0,68,0,-68
20548,1,0,17,0,-17
20549,1,0,49,0,-49
20550,0,0,11,0,-11
20551,1,1,363,1424,1061
20552,1,0,144,0,-144
20553,0,0,10,0,-10
20554,1,1,76,2033,1957
20555,1,1,524,1828,1304
20556,1,0,51,0,-51
20557,1,0,65,0,-65
20558,0,0,20,0,-20
20559,1,1,307,1542,1235
20560,0,0,34,0,-34
20561,0,0,4,0,-4
20562,0,0,36,0,-36
20563,1,0,27,0,-27
20564,0,0,4,0,-4
20565,0,0,21,0,-21
20566,1,1,226,1266,1040
20567,1,1,186,1298,1112
20568,1,1,67,1303,1236
20569,1,1,842,1318,476
20570,0,0,13,0,-13
20571,1,0,5,0,-5
20572,1,1,756,1445,689
20573,0,0,19,0,-19
20574,1,0,352,0,-352
20575,1,0,19,0,-19
20576,0,0,25,0,-25
20577,0,0,30,0,-30
20578,0,0,29,0,-29
20579,0,0,37,0,-37
20580,1,1,1129,1341,212
20581,0,0,84,0,-84
20582,1,0,18,0,-18
20583,1,0,68,0,-68
20584,0,0,70,0,-70
20585,0,0,14,0,-14
20586,1,1,207,1549,1342
20587,1,0,12,0,-12
20588,1,0,31,0,-31
20589,1,0,177,0,-177
20590,0,0,8,0,-8
20591,0,0,118,0,-118
20592,1,0,21,0,-21
20593,0,0,12,0,-12
20594,0,0,40,0,-40
20595,0,0,7,0,-7
20596,1,1,93,1639,1546
20597,1,1,294,2026,1732
20598,0,0,75,0,-75
20599,0,0,8,0,-8
20600,1,0,83,0,-83
20601,1,1,868,1279,411
20602,1,0,1,0,-1
20603,1,0,9,0,-9
20604,1,0,29,0,-29
20605,1,1,222,1607,1385
20606,1,0,39,0,-39
20607,1,1,166,1682,1516
20608,1,1,1357,1833,476
20609,0,0,79,0,-79
20610,1,0,19,0,-19
20611,1,0,9,0,-9
20612,0,0,39,0,-39
20613,1,0,18,0,-18
20614,1,0,192,0,-192
20615,0,0,14,0,-14
20616,0,0,40,0,-40
20617,1,0,13,0,-13
20618,1,1,409,1411,1002
20619,1,0,31,0,-31
20620,1,0,38,0,-38
20621,1,0,50,0,-50
20622,1,0,27,0,-27
20623,0,0,13,0,-13
20624,0,0,11,0,-11
20625,1,1,586,2036,1450
20626,1,1,438,1374,936
20627,0,0,26,0,-26
20628,1,1,320,1452,1132
20629,1,1,17,1266,1249
20630,1,0,13,0,-13
20631,0,0,19,0,-19
20632,1,1,2318,1461,-857
20633,1,0,36,0,-36
20634,1,0,83,0,-83
20635,0,0,11,0,-11
20636,1,1,952,1766,814
20637,0,0,36,0,-36
20638,0,0,18,0,-18
20639,1,1,467,1430,963
20640,1,0,16,0,-16
20641,1,1,432,1609,1177
20642,1,1,1025,1708,683
20643,0,0,63,0,-63
20644,0,0,29,0,-29
20645,1,1,199,2173,1974
20646,0,0,44,0,-44
20647,1,0,17,0,-17
20648,0,0,15,0,-15
20649,1,0,19,0,-19
20650,1,0,141,0,-141
20651,0,0,32,0,-32
20652,1,1,107,1492,1385
20653,1,1,1690,1372,-318
20654,0,0,82,0,-82
20655,1,1,1106,1308,202
20656,1,1,1408,1425,17
20657,1,0,107,0,-107
20658,1,1,153,1583,1430
20659,1,0,6,0,-6
20660,0,0,129,0,-129
20661,1,1,878,1662,784
20662,1,0,10,0,-10
20663,1,1,904,1487,583
20664,0,0,43,0,-43
20665,0,0,39,0,-39
20666,1,1,759,1572,813
20667,0,0,42,0,-42
20668,1,1,365,1633,1268
20669,1,1,256,1442,1186
20670,1,1,503,1381,878
20671,1,0,63,0,-63
20672,0,0,20,0,-20
20673,0,0,16,0,-16
20674,0,0,112,0,-112
20675,1,0,124,0,-124
20676,0,0,7,0,-7
20677,1,1,365,1236,871
20678,0,0,61,0,-61
20679,1,0,14,0,-14
20680,1,1,298,1687,1389
20681,1,1,77,1369,1292
20682,1,1,161,1867,1706
20683,1,0,17,0,-17
20684,1,1,451,1478,1027
20685,0,0,28,0,-28
20686,1,0,53,0,-53
20687,0,0,27,0,-27
20688,1,0,44,0,-44
20689,0,0,64,0,-64
20690,0,0,11,0,-11
20691,0,0,22,0,-22
20692,1,0,51,0,-51
20693,0,0,7,0,-7
20694,0,0,16,0,-16
20695,1,0,20,0,-20
20696,0,0,109,0,-109
20697,1,1,655,2192,1537
20698,1,0,33,0,-33
20699,1,0,26,0,-26
20700,1,1,127,1517,1390
20701,0,0,67,0,-67
20702,0,0,2,0,-2
20703,0,0,3,0,-3
20704,1,0,18,0,-18
20705,1,0,24,0,-24
20706,1,1,1116,1731,615
20707,1,1,516,1569,1053
20708,1,1,437,2163,1726
20709,1,1,378,1301,923
20710,1,0,10,0,-10
20711,1,0,230,0,-230
20712,0,0,42,0,-42
20713,0,0,95,0,-95
20714,1,1,40,1514,1474
20715,1,0,124,0,-124
20716,1,0,125,0,-125
20717,1,0,71,0,-71
20718,1,0,67,0,-67
20719,1,1,838,1443,605
20720,1,1,1073,2075,1002
20721,1,1,96,4038,3942
20722,1,0,81,0,-81
20723,1,1,256,1406,1150
20724,1,1,925,2685,1760
20725,1,1,318,1814,1496
20726,0,0,90,0,-90
20727,0,0,54,0,-54
20728,0,0,33,0,-33
20729,0,0,2,0,-2
20730,1,1,1429,1260,-169
20731,1,1,285,1587,1302
20732,0,0,26,0,-26
20733,1,1,356,1605,1249
20734,0,0,41,0,-41
20735,1,0,38,0,-38
20736,1,1,578,1873,1295
20737,0,0,79,0,-79
20738,1,1,100,2181,2081
20739,1,1,173,1694,1521
20740,1,1,425,1354,929
20741,0,0,56,0,-56
20742,1,0,172,0,-172
20743,0,0,13,0,-13
20744,1,0,22,0,-22
20745,0,0,7,0,-7
20746,0,0,3,0,-3
20747,1,0,2,0,-2
20748,1,0,27,0,-27
20749,1,1,582,2500,1918
20750,1,1,493,1320,827
20751,1,0,15,0,-15
20752,1,1,2024,1257,-767
20753,1,0,27,0,-27
20754,0,0,67,0,-67
20755,1,0,136,0,-136
20756,0,0,67,0,-67
20757,0,0,47,0,-47
20758,0,0,6,0,-6
20759,0,0,27,0,-27
20760,0,0,13,0,-13
20761,0,0,53,0,-53
20762,0,0,20,0,-20
20763,1,1,837,1662,825
20764,1,1,769,1275,506
20765,1,1,278,1265,987
20766,0,0,62,0,-62
20767,1,0,163,0,-163
20768,1,1,1247,1269,22
20769,1,1,299,1479,1180
20770,0,0,18,0,-18
20771,1,0,103,0,-103
20772,1,0,15,0,-15
20773,0,0,5,0,-5
20774,1,1,1093,1452,359
20775,0,0,44,0,-44
20776,0,0,8,0,-8
20777,1,0,59,0,-59
20778,1,1,589,1991,1402
20779,0,0,1,0,-1
20780,1,0,18,0,-18
20781,1,0,45,0,-45
20782,1,1,358,1659,1301
20783,1,1,1628,1433,-195
20784,1,0,32,0,-32
20785,1,1,384,3189,2805
20786,0,0,55,0,-55
20787,1,0,6,0,-6
20788,1,1,477,1293,816
20789,0,0,49,0,-49
20790,1,0,11,0,-11
20791,0,0,9,0,-9
20792,1,1,599,1559,960
20793,1,0,74,0,-74
20794,0,0,28,0,-28
20795,0,0,31,0,-31
20796,1,1,286,1330,1044
20797,0,0,30,0,-30
20798,1,0,27,0,-27
20799,1,1,191,1315,1124
20800,1,1,348,1880,1532
20801,1,0,30,0,-30
20802,0,0,2,0,-2
20803,0,0,39,0,-39
20804,1,0,20,0,-20
20805,0,0,8,0,-8
20806,0,0,127,0,-127
20807,1,0,129,0,-129
20808,0,0,26,0,-26
20809,1,0,55,0,-55
20810,1,0,38,0,-38
20811,0,0,38,0,-38
20812,0,0,39,0,-39
20813,0,0,12,0,-12
20814,1,1,765,2078,1313
20815,0,0,83,0,-83
20816,1,1,138,1873,1735
20817,0,0,152,0,-152
20818,1,0,31,0,-31
20819,0,0,75,0,-75
20820,1,0,6,0,-6
20821,1,0,19,0,-19
20822,1,1,1111,1425,314
20823,1,0,193,0,-193
20824,1,0,22,0,-22
20825,0,0,1,0,-1
20826,0,0,54,0,-54
20827,1,1,32,1639,1607
20828,1,0,106,0,-106
20829,0,0,64,0,-64
20830,0,0,15,0,-15
20831,1,1,283,1271,988
20832,1,1,387,2853,2466
20833,1,1,433,1326,893
20834,0,0,3,0,-3
20835,0,0,207,0,-207
20836,1,1,227,1560,1333
20837,0,0,25,0,-25
20838,1,1,545,1341,796
20839,0,0,63,0,-63
20840,0,0,15,0,-15
20841,1,0,25,0,-25
20842,1,1,398,1385,987
20843,1,0,21,0,-21
20844,1,1,81,1256,1175
20845,0,0,60,0,-60
20846,1,1,119,1681,1562
20847,0,0,44,0,-44
20848,0,0,56,0,-56
20849,1,0,142,0,-142
20850,0,0,106,0,-106
20851,1,1,428,1315,887
20852,1,0,5,0,-5
20853,1,1,1358,2322,964
20854,0,0,107,0,-107
20855,1,1,1034,1273,239
20856,0,0,13,0,-13
20857,1,0,34,0,-34
20858,1,1,432,1379,947
20859,1,1,492,1243,751
20860,1,1,142,1262,1120
20861,1,0,64,0,-64
20862,1,1,343,1513,1170
20863,0,0,68,0,-68
20864,1,1,1025,3893,2868
20865,1,1,316,1993,1677
20866,0,0,21,0,-21
20867,1,1,386,1431,1045
20868,0,0,10,0,-10
20869,0,0,8,0,-8
20870,1,1,379,2297,1918
20871,1,0,124,0,-124
20872,1,1,413,1395,982
20873,0,0,43,0,-43
20874,1,0,11,0,-11
20875,1,1,281,1349,1068
20876,1,1,855,2028,1173
20877,1,0,7,0,-7
20878,1,1,269,2531,2262
20879,1,0,40,0,-40
20880,0,0,39,0,-39
20881,0,0,64,0,-64
20882,0,0,40,0,-40
20883,0,0,111,0,-111
20884,0,0,63,0,-63
20885,1,1,111,3885,3774
20886,0,0,9,0,-9
20887,1,0,6,0,-6
20888,1,0,17,0,-17
20889,0,0,11,0,-11
20890,0,0,74,0,-74
20891,1,1,790,1367,577
20892,1,0,63,0,-63
20893,0,0,107,0,-107
20894,0,0,19,0,-19
20895,1,1,145,1348,1203
20896,0,0,112,0,-112
20897,1,0,2,0,-2
20898,1,1,1885,1590,-295
20899,1,0,41,0,-41
20900,0,0,17,0,-17
20901,0,0,9,0,-9
20902,1,1,1029,1329,300
20903,0,0,95,0,-95
20904,1,0,3,0,-3
20905,1,1,325,1342,1017
20906,1,1,1103,1837,734
20907,0,0,41,0,-41
20908,0,0,36,0,-36
20909,1,1,488,2706,2218
20910,0,0,21,0,-21
20911,1,0,24,0,-24
20912,1,0,85,0,-85
20913,1,1,715,2784,2069
20914,1,0,6,0,-6
20915,0,0,14,0,-14
20916,0,0,9,0,-9
20917,0,0,30,0,-30
20918,0,0,44,0,-44
20919,1,0,18,0,-18
20920,0,0,38,0,-38
20921,1,1,1119,1575,456
20922,1,1,2736,1285,-1451
20923,1,1,1443,3046,1603
20924,1,1,998,1763,765
20925,1,0,66,0,-66
20926,1,1,351,1713,1362
20927,0,0,29,0,-29
20928,1,0,22,0,-22
20929,0,0,81,0,-81
20930,0,0,16,0,-16
20931,1,1,590,1420,830
20932,0,0,103,0,-103
20933,1,0,5,0,-5
20934,1,0,72,0,-72
20935,1,1,33,1326,1293
20936,1,1,31,1359,1328
20937,0,0,32,0,-32
20938,1,1,1287,1363,76
20939,1,0,46,0,-46
20940,1,1,999,1309,310
20941,0,0,56,0,-56
20942,1,0,75,0,-75
20943,1,0,129,0,-129
20944,1,0,27,0,-27
20945,1,1,340,1297,957
20946,1,0,53,0,-53
20947,1,1,649,1791,1142
20948,0,0,48,0,-48
20949,0,0,91,0,-91
20950,1,0,21,0,-21
20951,1,1,30,1913,1883
20952,1,0,68,0,-68
20953,1,1,1250,2336,1086
20954,1,0,1,0,-1
20955,0,0,2,0,-2
20956,1,1,81,1299,1218
20957,1,0,1,0,-1
20958,1,0,17,0,-17
20959,0,0,117,0,-117
20960,1,0,72,0,-72
20961,1,1,814,1422,608
20962,1,1,704,1732,1028
20963,1,1,102,1821,1719
20964,0,0,8,0,-8
20965,1,0,76,0,-76
20966,1,1,1567,2125,558
20967,1,1,697,1341,644
20968,0,0,85,0,-85
20969,1,1,356,1326,970
20970,1,0,31,0,-31
20971,0,0,34,0,-34
20972,1,1,304,5718,5414
20973,1,0,137,0,-137
20974,1,1,91,1489,1398
20975,0,0,84,0,-84
20976,0,0,59,0,-59
20977,0,0,82,0,-82
20978,0,0,15,0,-15
20979,0,0,26,0,-26
20980,1,1,311,1298,987
20981,1,0,0,0,0
20982,1,0,21,0,-21
20983,1,1,130,1394,1264
20984,0,0,66,0,-66
20985,0,0,40,0,-40
20986,1,0,57,0,-57
20987,1,0,39,0,-39
20988,1,0,0,0,0
20989,1,0,14,0,-14
20990,1,1,337,1340,1003
20991,1,1,796,1306,510
20992,1,1,128,1371,1243
20993,0,0,30,0,-30
20994,1,0,54,0,-54
20995,1,1,612,1479,867
20996,1,1,245,1283,1038
20997,1,1,2551,3071,520
20998,1,0,6,0,-6
20999,0,0,1,0,-1
21000,1,0,55,0,-55
21001,0,0,12,0,-12
21002,0,0,56,0,-56
21003,1,1,760,1241,481
21004,1,0,10,0,-10
21005,1,0,35,0,-35
21006,0,0,36,0,-36
21007,1,0,24,0,-24
21008,0,0,53,0,-53
21009,1,0,7,0,-7
21010,1,0,32,0,-32
21011,1,1,2443,2048,-395
21012,0,0,7,0,-7
21013,0,0,89,0,-89
21014,1,0,3,0,-3
21015,1,1,169,1718,1549
21016,0,0,46,0,-46
21017,0,0,11,0,-11
21018,0,0,21,0,-21
21019,1,0,32,0,-32
21020,1,0,52,0,-52
21021,0,0,17,0,-17
21022,1,0,10,0,-10
21023,1,1,513,1287,774
21024,0,0,41,0,-41
21025,1,0,1,0,-1
21026,0,0,52,0,-52
21027,0,0,53,0,-53
21028,1,1,1077,1766,689
21029,0,0,36,0,-36
21030,1,1,725,1616,891
21031,1,0,1,0,-1
21032,0,0,128,0,-128
21033,1,0,102,0,-102
21034,1,0,96,0,-96
21035,1,0,102,0,-102
21036,0,0,14,0,-14
21037,1,1,1014,1303,289
21038,1,0,128,0,-128
21039,1,0,88,0,-88
21040,1,0,80,0,-80
21041,0,0,10,0,-10
21042,0,0,44,0,-44
21043,0,0,89,0,-89
21044,1,1,1321,1692,371
21045,1,0,24,0,-24
21046,1,1,452,1624,1172
21047,0,0,9,0,-9
21048,0,0,83,0,-83
21049,1,0,23,0,-23
21050,1,0,95,0,-95
21051,1,1,1547,2780,1233
21052,0,0,129,0,-129
21053,1,1,1447,3070,1623
21054,0,0,61,0,-61
21055,0,0,5,0,-5
21056,0,0,51,0,-51
21057,1,1,225,1753,1528
21058,0,0,140,0,-140
21059,1,0,39,0,-39
21060,0,0,58,0,-58
21061,1,0,93,0,-93
21062,1,0,4,0,-4
21063,0,0,21,0,-21
21064,0,0,21,0,-21
21065,1,0,58,0,-58
21066,1,1,262,2567,2305
21067,0,0,125,0,-125
21068,1,1,158,1777,1619
21069,1,1,636,1252,616
21070,0,0,21,0,-21
21071,0,0,9,0,-9
21072,1,1,1409,1299,-110
21073,0,0,3,0,-3
21074,1,1,1084,1277,193
21075,0,0,7,0,-7
21076,0,0,127,0,-127
21077,1,0,20,0,-20
21078,1,1,50,1433,1383
21079,1,1,746,1442,696
21080,0,0,0,0,0
21081,0,0,81,0,-81
21082,1,0,39,0,-39
21083,1,0,26,0,-26
21084,0,0,34,0,-34
21085,0,0,7,0,-7
21086,1,0,9,0,-9
21087,1,0,84,0,-84
21088,1,0,173,0,-173
21089,1,0,72,0,-72
21090,1,1,205,2169,1964
21091,0,0,165,0,-165
21092,1,0,255,0,-255
21093,0,0,1,0,-1
21094,1,1,156,1299,1143
21095,0,0,12,0,-12
21096,1,0,8,0,-8
21097,0,0,44,0,-44
21098,1,1,157,1443,1286
21099,1,0,29,0,-29
21100,1,0,29,0,-29
21101,1,1,180,1322,1142
21102,1,1,1812,1530,-282
21103,0,0,80,0,-80
21104,1,0,4,0,-4
21105,1,1,294,1313,1019
21106,0,0,76,0,-76
21107,1,0,4,0,-4
21108,1,1,255,1504,1249
21109,1,1,338,1716,1378
21110,1,0,71,0,-71
21111,0,0,67,0,-67
21112,1,1,715,1948,1233
21113,1,1,503,1562,1059
21114,1,0,14,0,-14
21115,0,0,4,0,-4
21116,1,1,417,1547,1130
21117,1,0,25,0,-25
21118,0,0,11,0,-11
21119,0,0,3,0,-3
21120,1,1,1021,1598,577
21121,1,1,596,1321,725
21122,1,0,77,0,-77
21123,0,0,15,0,-15
21124,1,0,34,0,-34
21125,1,1,1093,1290,197
21126,1,1,388,2219,1831
21127,0,0,25,0,-25
21128,0,0,11,0,-11
21129,0,0,54,0,-54
21130,1,0,42,0,-42
21131,0,0,8,0,-8
21132,0,0,30,0,-30
21133,1,1,871,1602,731
21134,1,0,39,0,-39
21135,1,1,724,1588,864
21136,1,0,3,0,-3
21137,1,0,18,0,-18
21138,1,0,2,0,-2
21139,0,0,45,0,-45
21140,1,1,3157,3022,-135
21141,1,1,360,1537,1177
21142,0,0,60,0,-60
21143,1,1,389,1561,1172
21144,1,0,109,0,-109
21145,0,0,110,0,-110
21146,1,1,2173,1679,-494
21147,1,1,157,2262,2105
21148,0,0,37,0,-37
21149,0,0,96,0,-96
21150,0,0,6,0,-6
21151,1,1,936,1468,532
21152,1,0,21,0,-21
21153,0,0,103,0,-103
21154,1,0,143,0,-143
21155,1,0,151,0,-151
21156,0,0,28,0,-28
21157,0,0,106,0,-106
21158,1,0,45,0,-45
21159,1,1,854,1299,445
21160,1,1,878,1514,636
21161,1,1,213,1453,1240
21162,1,0,116,0,-116
21163,0,0,27,0,-27
21164,1,1,275,1243,968
21165,0,0,61,0,-61
21166,1,1,414,1416,1002
21167,1,0,12,0,-12
21168,1,0,32,0,-32
21169,1,1,436,1343,907
21170,0,0,10,0,-10
21171,0,0,56,0,-56
21172,0,0,0,0,0
21173,1,0,30,0,-30
21174,0,0,47,0,-47
21175,0,0,0,0,0
21176,1,0,45,0,-45
21177,1,0,24,0,-24
21178,1,0,10,0,-10
21179,1,1,172,1421,1249
21180,1,0,33,0,-33
21181,1,1,158,2408,2250
21182,0,0,2,0,-2
21183,1,0,12,0,-12
21184,1,1,458,1387,929
21185,1,1,57,1257,1200
21186,0,0,2,0,-2
21187,0,0,77,0,-77
21188,0,0,15,0,-15
21189,1,0,34,0,-34
21190,1,0,22,0,-22
21191,0,0,58,0,-58
21192,0,0,29,0,-29
21193,0,0,67,0,-67
21194,1,0,40,0,-40
21195,0,0,32,0,-32
21196,0,0,4,0,-4
21197,1,1,1018,1322,304
21198,0,0,52,0,-52
21199,1,0,51,0,-51
21200,1,1,105,1646,1541
21201,0,0,140,0,-140
21202,0,0,16,0,-16
21203,1,0,146,0,-146
21204,0,0,64,0,-64
21205,0,0,61,0,-61
21206,1,0,1,0,-1
21207,1,0,53,0,-53
21208,0,0,43,0,-43
21209,0,0,18,0,-18
21210,1,0,41,0,-41
21211,1,1,316,1318,1002
21212,1,1,1023,1960,937
21213,0,0,49,0,-49
21214,0,0,156,0,-156
21215,1,0,10,0,-10
21216,0,0,64,0,-64
21217,1,1,1745,1248,-497
21218,1,0,16,0,-16
21219,1,0,62,0,-62
21220,1,1,124,2171,2047
21221,1,0,24,0,-24
21222,0,0,136,0,-136
21223,1,1,603,1801,1198
21224,1,1,389,2076,1687
21225,0,0,47,0,-47
21226,1,1,1036,2980,1944
21227,1,1,55,1412,1357
21228,0,0,29,0,-29
21229,0,0,14,0,-14
21230,0,0,22,0,-22
21231,0,0,135,0,-135
21232,0,0,72,0,-72
21233,0,0,84,0,-84
21234,0,0,79,0,-79
21235,0,0,123,0,-123
21236,0,0,32,0,-32
21237,1,0,32,0,-32
21238,1,0,20,0,-20
21239,1,1,1065,1858,793
21240,1,0,55,0,-55
21241,0,0,8,0,-8
21242,1,1,350,1297,947
21243,0,0,7,0,-7
21244,0,0,162,0,-162
21245,0,0,1,0,-1
21246,0,0,26,0,-26
21247,0,0,212,0,-212
21248,0,0,82,0,-82
21249,0,0,3,0,-3
21250,1,1,531,1767,1236
21251,1,0,9,0,-9
21252,1,0,3,0,-3
21253,1,0,76,0,-76
21254,1,0,8,0,-8
21255,0,0,65,0,-65
21256,0,0,45,0,-45
21257,1,1,145,3309,3164
21258,0,0,10,0,-10
21259,1,0,100,0,-100
21260,1,0,50,0,-50
21261,0,0,56,0,-56
21262,1,0,5,0,-5
21263,1,0,21,0,-21
21264,0,0,31,0,-31
21265,1,0,16,0,-16
21266,1,1,272,2742,2470
21267,1,1,1460,1993,533
21268,0,0,6,0,-6
21269,0,0,49,0,-49
21270,1,1,190,2334,2144
21271,1,0,18,0,-18
21272,1,1,120,1877,1757
21273,1,1,1039,2289,1250
21274,1,0,23,0,-23
21275,0,0,28,0,-28
21276,1,0,54,0,-54
21277,1,1,655,1287,632
21278,0,0,84,0,-84
21279,0,0,34,0,-34
21280,0,0,8,0,-8
21281,0,0,264,0,-264
21282,1,0,20,0,-20
21283,0,0,45,0,-45
21284,1,1,1034,1362,328
21285,0,0,21,0,-21
21286,0,0,0,0,0
21287,1,1,1628,1350,-278
21288,1,1,153,1314,1161
21289,0,0,166,0,-166
21290,0,0,179,0,-179
21291,1,1,16,1289,1273
21292,0,0,45,0,-45
21293,1,1,115,1365,1250
21294,1,1,1088,2997,1909
21295,0,0,125,0,-125
21296,0,0,52,0,-52
21297,0,0,48,0,-48
21298,0,0,9,0,-9
21299,1,0,118,0,-118
21300,1,1,875,1278,403
21301,0,0,33,0,-33
21302,1,0,50,0,-50
21303,0,0,79,0,-79
21304,1,1,110,1576,1466
21305,0,0,41,0,-41
21306,0,0,98,0,-98
21307,1,0,80,0,-80
21308,1,1,113,1763,1650
21309,1,1,236,1393,1157
21310,1,0,44,0,-44
21311,1,1,1199,1532,333
21312,0,0,26,0,-26
21313,1,1,46,1746,1700
21314,0,0,11,0,-11
21315,0,0,47,0,-47
21316,0,0,110,0,-110
21317,1,0,94,0,-94
21318,1,0,15,0,-15
21319,0,0,9,0,-9
21320,0,0,22,0,-22
21321,0,0,34,0,-34
21322,1,0,0,0,0
21323,1,1,292,2071,1779
21324,1,0,143,0,-143
21325,0,0,80,0,-80
21326,0,0,96,0,-96
21327,1,0,33,0,-33
21328,1,1,259,1607,1348
21329,1,1,539,1977,1438
21330,1,1,232,2317,2085
21331,1,1,1539,1237,-302
21332,0,0,0,0,0
21333,1,1,238,1466,1228
21334,1,0,43,0,-43
21335,0,0,0,0,0
21336,0,0,22,0,-22
21337,0,0,6,0,-6
21338,1,1,356,1586,1230
21339,1,1,101,1579,1478
21340,1,0,30,0,-30
21341,0,0,21,0,-21
21342,0,0,63,0,-63
21343,1,0,58,0,-58
21344,0,0,90,0,-90
21345,1,0,12,0,-12
21346,1,0,115,0,-115
21347,1,0,16,0,-16
21348,1,0,14,0,-14
21349,1,1,655,1424,769
21350,1,0,108,0,-108
21351,1,1,271,1449,1178
21352,1,0,3,0,-3
21353,1,0,46,0,-46
21354,0,0,34,0,-34
21355,1,0,9,0,-9
21356,1,0,26,0,-26
21357,1,0,9,0,-9
21358,1,1,772,1776,1004
21359,0,0,64,0,-64
21360,1,1,376,1713,1337
21361,1,0,12,0,-12
21362,1,1,225,1275,1050
21363,1,1,82,1411,1329
21364,1,1,405,1243,838
21365,1,0,18,0,-18
21366,1,0,28,0,-28
21367,1,0,32,0,-32
21368,1,1,642,2048,1406
21369,1,1,320,1433,1113
21370,1,0,85,0,-85
21371,1,1,355,1379,1024
21372,1,1,228,1306,1078
21373,1,0,70,0,-70
21374,1,1,146,1370,1224
21375,0,0,113,0,-113
21376,1,1,109,3080,2971
21377,1,0,6,0,-6
21378,0,0,17,0,-17
21379,1,1,187,1272,1085
21380,1,0,118,0,-118
21381,0,0,11,0,-11
21382,1,0,54,0,-54
21383,1,0,180,0,-180
21384,1,1,168,1288,1120
21385,0,0,104,0,-104
21386,1,1,271,1577,1306
21387,0,0,16,0,-16
21388,0,0,55,0,-55
21389,0,0,0,0,0
21390,1,0,149,0,-149
21391,1,1,93,1575,1482
21392,1,1,1604,1256,-348
21393,0,0,58,0,-58
21394,1,0,13,0,-13
21395,0,0,115,0,-115
21396,1,1,375,1424,1049
21397,1,0,64,0,-64
21398,0,0,29,0,-29
21399,1,1,364,1587,1223
21400,1,1,566,1425,859
21401,0,0,41,0,-41
21402,1,0,169,0,-169
21403,0,0,49,0,-49
21404,1,1,724,1634,910
21405,1,0,10,0,-10
21406,1,0,44,0,-44
21407,1,0,46,0,-46
21408,1,1,1319,2916,1597
21409,0,0,16,0,-16
21410,1,1,277,1547,1270
21411,1,0,28,0,-28
21412,0,0,54,0,-54
21413,0,0,17,0,-17
21414,1,1,188,1352,1164
21415,1,0,18,0,-18
21416,0,0,19,0,-19
21417,0,0,10,0,-10
21418,0,0,68,0,-68
21419,0,0,60,0,-60
21420,1,0,42,0,-42
21421,1,0,60,0,-60
21422,1,1,1934,1235,-699
21423,0,0,29,0,-29
21424,1,0,30,0,-30
21425,1,0,0,0,0
21426,1,0,43,0,-43
21427,1,1,240,1285,1045
21428,0,0,16,0,-16
21429,1,0,35,0,-35
21430,0,0,7,0,-7
21431,1,1,565,1277,712
21432,1,0,10,0,-10
21433,0,0,67,0,-67
21434,0,0,43,0,-43
21435,1,0,78,0,-78
21436,0,0,20,0,-20
21437,1,1,256,1421,1165
21438,1,0,5,0,-5
21439,1,0,127,0,-127
21440,1,0,7,0,-7
21441,0,0,46,0,-46
21442,0,0,27,0,-27
21443,1,1,333,1239,906
21444,1,0,8,0,-8
21445,0,0,15,0,-15
21446,0,0,25,0,-25
21447,1,1,957,1491,534
21448,1,0,90,0,-90
21449,1,0,2,0,-2
21450,1,1,1742,1239,-503
21451,0,0,40,0,-40
21452,1,0,154,0,-154
21453,0,0,8,0,-8
21454,1,1,1314,1509,195
21455,0,0,45,0,-45
21456,1,1,991,1562,571
21457,1,0,41,0,-41
21458,0,0,57,0,-57
21459,1,0,41,0,-41
21460,1,0,142,0,-142
21461,0,0,119,0,-119
21462,1,1,213,2235,2022
21463,1,0,23,0,-23
21464,1,1,991,1596,605
21465,1,0,115,0,-115
21466,1,0,116,0,-116
21467,1,0,5,0,-5
21468,1,1,513,2373,1860
21469,1,1,1119,1440,321
21470,1,0,36,0,-36
21471,0,0,2,0,-2
21472,0,0,152,0,-152
21473,0,0,12,0,-12
21474,0,0,50,0,-50
21475,1,1,842,1428,586
21476,0,0,55,0,-55
21477,1,1,341,1306,965
21478,1,1,1185,1421,236
21479,0,0,19,0,-19
21480,1,1,121,1272,1151
21481,1,1,501,1793,1292
21482,0,0,16,0,-16
21483,0,0,13,0,-13
21484,0,0,94,0,-94
21485,1,1,1521,1671,150
21486,0,0,35,0,-35
21487,0,0,30,0,-30
21488,0,0,85,0,-85
21489,1,0,6,0,-6
21490,1,1,1172,1539,367
21491,1,1,232,1643,1411
21492,1,1,167,1474,1307
21493,0,0,78,0,-78
21494,1,1,343,3090,2747
21495,1,0,66,0,-66
21496,0,0,15,0,-15
21497,0,0,58,0,-58
21498,1,0,14,0,-14
21499,0,0,9,0,-9
21500,0,0,37,0,-37
21501,1,1,243,1401,1158
21502,1,0,2,0,-2
21503,1,0,42,0,-42
21504,1,1,1454,1791,337
21505,0,0,5,0,-5
21506,0,0,17,0,-17
21507,0,0,19,0,-19
21508,0,0,29,0,-29
21509,1,0,46,0,-46
21510,1,0,7,0,-7
21511,1,0,8,0,-8
21512,1,1,1491,2243,752
21513,0,0,2,0,-2
21514,1,0,63,0,-63
21515,1,0,49,0,-49
21516,1,1,306,1372,1066
21517,1,1,1056,1277,221
21518,1,1,398,1254,856
21519,1,0,58,0,-58
21520,0,0,27,0,-27
21521,1,0,88,0,-88
21522,1,1,136,1907,1771
21523,1,0,61,0,-61
21524,0,0,165,0,-165
21525,0,0,32,0,-32
21526,1,0,13,0,-13
21527,1,1,548,1446,898
21528,0,0,23,0,-23
21529,0,0,8,0,-8
21530,0,0,60,0,-60
21531,1,1,165,1240,1075
21532,0,0,119,0,-119
21533,0,0,66,0,-66
21534,1,1,282,1565,1283
21535,1,1,213,1261,1048
21536,0,0,3,0,-3
21537,1,0,37,0,-37
21538,0,0,60,0,-60
21539,0,0,15,0,-15
21540,1,0,119,0,-119
21541,0,0,50,0,-50
21542,1,1,145,1279,1134
21543,0,0,17,0,-17
21544,1,0,3,0,-3
21545,1,1,491,1445,954
21546,0,0,14,0,-14
21547,1,0,38,0,-38
21548,1,0,26,0,-26
21549,1,1,903,1235,332
21550,1,1,203,1356,1153
21551,1,0,32,0,-32
21552,0,0,61,0,-61
21553,1,1,283,2516,2233
21554,1,0,122,0,-122
21555,0,0,129,0,-129
21556,1,0,51,0,-51
21557,0,0,17,0,-17
21558,0,0,208,0,-208
21559,1,0,239,0,-239
21560,1,1,431,1244,813
21561,1,1,1027,1250,223
21562,1,1,518,1437,919
21563,1,1,324,1887,1563
21564,1,1,54,1467,1413
21565,1,1,352,2003,1651
21566,0,0,151,0,-151
21567,0,0,9,0,-9
21568,1,0,32,0,-32
21569,0,0,0,0,0
21570,1,0,68,0,-68
21571,1,1,771,1297,526
21572,1,0,5,0,-5
21573,0,0,14,0,-14
21574,0,0,28,0,-28
21575,1,1,193,1280,1087
21576,1,1,40,1886,1846
21577,1,1,97,1376,1279
21578,0,0,94,0,-94
21579,0,0,6,0,-6
21580,0,0,71,0,-71
21581,0,0,76,0,-76
21582,1,1,429,1438,1009
21583,1,1,305,1313,1008
21584,0,0,57,0,-57
21585,1,0,48,0,-48
21586,0,0,129,0,-129
21587,1,0,7,0,-7
21588,1,0,24,0,-24
21589,1,0,179,0,-179
21590,1,0,27,0,-27
21591,0,0,28,0,-28
21592,1,1,254,2047,1793
21593,0,0,76,0,-76
21594,1,0,54,0,-54
21595,0,0,45,0,-45
21596,0,0,101,0,-101
21597,0,0,2,0,-2
21598,1,0,26,0,-26
21599,1,0,43,0,-43
21600,1,0,81,0,-81
21601,1,0,25,0,-25
21602,1,0,15,0,-15
21603,1,0,17,0,-17
21604,1,0,25,0,-25
21605,0,0,48,0,-48
21606,0,0,152,0,-152
21607,1,0,71,0,-71
21608,1,1,1554,2525,971
21609,0,0,187,0,-187
21610,1,0,51,0,-51
21611,0,0,9,0,-9
21612,0,0,81,0,-81
21613,0,0,139,0,-139
21614,0,0,34,0,-34
21615,0,0,22,0,-22
21616,1,0,3,0,-3
21617,0,0,22,0,-22
21618,0,0,23,0,-23
21619,0,0,43,0,-43
21620,0,0,23,0,-23
21621,0,0,30,0,-30
21622,1,0,20,0,-20
21623,0,0,8,0,-8
21624,0,0,18,0,-18
21625,0,0,20,0,-20
21626,1,0,87,0,-87
21627,0,0,73,0,-73
21628,0,0,25,0,-25
21629,1,0,26,0,-26
21630,0,0,30,0,-30
21631,0,0,41,0,-41
21632,1,0,18,0,-18
21633,1,1,32,1250,1218
21634,0,0,108,0,-108
21635,1,0,7,0,-7
21636,0,0,98,0,-98
21637,1,0,26,0,-26
21638,0,0,30,0,-30
21639,1,0,32,0,-32
21640,1,1,2462,2298,-164
21641,0,0,26,0,-26
21642,1,1,1284,1245,-39
21643,1,0,50,0,-50
21644,1,0,34,0,-34
21645,1,1,427,1268,841
21646,1,1,931,1908,977
21647,0,0,9,0,-9
21648,0,0,1,0,-1
21649,1,1,370,2043,1673
21650,1,0,17,0,-17
21651,1,0,21,0,-21
21652,1,1,259,1243,984
21653,0,0,60,0,-60
21654,1,1,136,1259,1123
21655,0,0,90,0,-90
21656,0,0,60,0,-60
21657,1,1,15,1513,1498
21658,1,0,23,0,-23
21659,1,0,6,0,-6
21660,1,1,226,1427,1201
21661,0,0,106,0,-106
21662,1,1,350,1862,1512
21663,0,0,6,0,-6
21664,1,0,114,0,-114
21665,1,0,54,0,-54
21666,0,0,25,0,-25
21667,0,0,19,0,-19
21668,1,0,7,0,-7
21669,1,1,1474,1319,-155
21670,0,0,1,0,-1
21671,1,1,124,1341,1217
21672,0,0,25,0,-25
21673,1,1,45,1378,1333
21674,0,0,18,0,-18
21675,0,0,3,0,-3
21676,0,0,72,0,-72
21677,0,0,39,0,-39
21678,0,0,8,0,-8
21679,0,0,3,0,-3
21680,1,1,81,1737,1656
21681,1,1,799,1244,445
21682,1,0,115,0,-115
21683,1,0,9,0,-9
21684,1,0,40,0,-40
21685,0,0,144,0,-144
21686,0,0,5,0,-5
21687,1,1,212,2047,1835
21688,1,1,149,1996,1847
21689,0,0,140,0,-140
21690,1,0,13,0,-13
21691,0,0,2,0,-2
21692,1,1,310,1451,1141
21693,0,0,49,0,-49
21694,0,0,15,0,-15
21695,0,0,51,0,-51
21696,0,0,126,0,-126
21697,0,0,4,0,-4
21698,0,0,16,0,-16
21699,0,0,2,0,-2
21700,0,0,36,0,-36
21701,1,1,791,2185,1394
21702,1,1,127,1454,1327
21703,1,0,7,0,-7
21704,0,0,12,0,-12
21705,1,1,325,1477,1152
21706,0,0,27,0,-27
21707,1,0,6,0,-6
21708,0,0,16,0,-16
21709,1,1,139,1766,1627
21710,0,0,15,0,-15
21711,1,0,159,0,-159
21712,1,1,650,3265,2615
21713,1,1,867,1275,408
21714,0,0,9,0,-9
21715,0,0,51,0,-51
21716,0,0,9,0,-9
21717,0,0,148,0,-148
21718,1,1,714,2107,1393
21719,1,1,626,1496,870
21720,0,0,31,0,-31
21721,0,0,2,0,-2
21722,1,0,301,0,-301
21723,0,0,19,0,-19
21724,0,0,194,0,-194
21725,1,1,352,1266,914
21726,1,0,51,0,-51
21727,0,0,36,0,-36
21728,1,0,35,0,-35
21729,1,0,1,0,-1
21730,1,1,385,1276,891
21731,1,1,447,1339,892
21732,0,0,4,0,-4
21733,0,0,177,0,-177
21734,1,0,124,0,-124
21735,1,0,67,0,-67
21736,1,0,93,0,-93
21737,0,0,6,0,-6
21738,1,1,706,1582,876
21739,1,1,148,2104,1956
21740,1,1,277,1624,1347
21741,1,0,143,0,-143
21742,0,0,27,0,-27
21743,1,0,160,0,-160
21744,1,0,5,0,-5
21745,1,1,399,1466,1067
21746,1,1,330,3956,3626
21747,1,1,319,1974,1655
21748,0,0,35,0,-35
21749,0,0,35,0,-35
21750,1,1,618,1596,978
21751,1,1,240,1340,1100
21752,0,0,1,0,-1
21753,0,0,34,0,-34
21754,1,0,4,0,-4
21755,1,0,81,0,-81
21756,0,0,82,0,-82
21757,0,0,35,0,-35
21758,1,1,1289,1567,278
21759,1,0,5,0,-5
21760,1,0,19,0,-19
21761,1,0,6,0,-6
21762,1,0,15,0,-15
21763,1,1,275,1590,1315
21764,0,0,15,0,-15
21765,0,0,68,0,-68
21766,0,0,55,0,-55
21767,1,1,462,1521,1059
21768,1,1,247,3344,3097
21769,1,1,155,2181,2026
21770,0,0,92,0,-92
21771,1,1,419,1501,1082
21772,1,0,67,0,-67
21773,1,1,1007,1777,770
21774,0,0,90,0,-90
21775,1,0,136,0,-136
21776,1,0,23,0,-23
21777,0,0,3,0,-3
21778,1,1,285,1506,1221
21779,1,1,610,1574,964
21780,0,0,40,0,-40
21781,1,0,48,0,-48
21782,0,0,79,0,-79
21783,1,1,2731,1432,-1299
21784,0,0,37,0,-37
21785,1,1,73,1523,1450
21786,0,0,28,0,-28
21787,0,0,17,0,-17
21788,1,1,2213,1702,-511
21789,0,0,25,0,-25
21790,1,1,156,1794,1638
21791,0,0,34,0,-34
21792,1,0,13,0,-13
21793,1,0,2,0,-2
21794,1,1,719,1368,649
21795,0,0,12,0,-12
21796,1,0,55,0,-55
21797,0,0,85,0,-85
21798,0,0,42,0,-42
21799,0,0,7,0,-7
21800,0,0,26,0,-26
21801,0,0,56,0,-56
21802,1,0,7,0,-7
21803,1,0,8,0,-8
21804,1,1,387,1456,1069
21805,1,1,771,1538,767
21806,1,0,7,0,-7
21807,1,0,10,0,-10
21808,0,0,116,0,-116
21809,1,1,396,1832,1436
21810,0,0,209,0,-209
21811,0,0,32,0,-32
21812,0,0,14,0,-14
21813,0,0,21,0,-21
21814,1,0,62,0,-62
21815,0,0,91,0,-91
21816,1,1,142,2005,1863
21817,1,1,481,1481,1000
21818,1,1,148,1504,1356
21819,1,1,144,1976,1832
21820,0,0,5,0,-5
21821,1,1,612,1689,1077
21822,1,1,366,1326,960
21823,1,1,554,1239,685
21824,1,1,225,2000,1775
21825,1,0,58,0,-58
21826,1,1,947,1254,307
21827,1,0,25,0,-25
21828,1,1,711,1389,678
21829,0,0,220,0,-220
21830,1,0,16,0,-16
21831,1,1,384,1381,997
21832,1,1,404,1643,1239
21833,1,1,172,1250,1078
21834,1,1,671,1823,1152
21835,0,0,103,0,-103
21836,0,0,10,0,-10
21837,0,0,26,0,-26
21838,1,0,23,0,-23
21839,0,0,98,0,-98
21840,1,0,53,0,-53
21841,1,1,123,3107,2984
21842,0,0,56,0,-56
21843,0,0,85,0,-85
21844,0,0,58,0,-58
21845,1,1,320,2597,2277
21846,0,0,12,0,-12
21847,1,0,29,0,-29
21848,0,0,35,0,-35
21849,0,0,55,0,-55
21850,1,1,209,1432,1223
21851,0,0,51,0,-51
21852,1,0,86,0,-86
21853,1,1,475,2593,2118
21854,0,0,196,0,-196
21855,0,0,89,0,-89
21856,0,0,113,0,-113
21857,1,0,270,0,-270
21858,1,1,652,1866,1214
21859,1,1,351,1597,1246
21860,1,1,1446,1359,-87
21861,1,0,42,0,-42
21862,1,0,45,0,-45
21863,0,0,13,0,-13
21864,1,0,35,0,-35
21865,0,0,40,0,-40
21866,1,0,166,0,-166
21867,1,0,223,0,-223
21868,0,0,136,0,-136
21869,0,0,77,0,-77
21870,1,0,21,0,-21
21871,1,1,22,3751,3729
21872,1,0,41,0,-41
21873,1,1,946,1476,530
21874,0,0,149,0,-149
21875,1,1,2426,1499,-927
21876,1,0,27,0,-27
21877,1,0,139,0,-139
21878,1,0,42,0,-42
21879,0,0,2,0,-2
21880,1,1,727,1713,986
21881,1,1,205,1367,1162
21882,1,0,30,0,-30
21883,0,0,47,0,-47
21884,0,0,10,0,-10
21885,0,0,119,0,-119
21886,0,0,7,0,-7
21887,0,0,23,0,-23
21888,0,0,26,0,-26
21889,0,0,4,0,-4
21890,1,0,33,0,-33
21891,1,1,291,1523,1232
21892,1,1,66,1545,1479
21893,1,0,39,0,-39
21894,1,0,0,0,0
21895,1,1,2344,7325,4981
21896,1,1,742,1277,535
21897,0,0,13,0,-13
21898,1,1,65,1468,1403
21899,0,0,35,0,-35
21900,1,1,249,1394,1145
21901,1,0,60,0,-60
21902,1,0,46,0,-46
21903,0,0,50,0,-50
21904,1,1,83,1959,1876
21905,1,1,948,1246,298
21906,0,0,1,0,-1
21907,1,1,748,2516,1768
21908,1,1,97,1722,1625
21909,1,1,825,5235,4410
21910,1,0,154,0,-154
21911,1,1,393,1413,1020
21912,1,1,163,1921,1758
21913,0,0,5,0,-5
21914,1,0,64,0,-64
21915,0,0,11,0,-11
21916,0,0,50,0,-50
21917,1,1,647,1869,1222
21918,1,0,23,0,-23
21919,1,0,8,0,-8
21920,0,0,74,0,-74
21921,1,1,339,1320,981
21922,0,0,81,0,-81
21923,0,0,14,0,-14
21924,1,0,15,0,-15
21925,0,0,61,0,-61
21926,1,0,34,0,-34
21927,1,1,580,1562,982
21928,1,1,1457,1532,75
21929,1,0,46,0,-46
21930,0,0,85,0,-85
21931,0,0,10,0,-10
21932,1,1,1793,1333,-460
21933,0,0,109,0,-109
21934,1,1,195,2747,2552
21935,0,0,17,0,-17
21936,0,0,124,0,-124
21937,1,0,17,0,-17
21938,1,1,258,1480,1222
21939,0,0,25,0,-25
21940,1,1,163,1661,1498
21941,0,0,56,0,-56
21942,1,1,474,1412,938
21943,1,0,8,0,-8
21944,1,0,27,0,-27
21945,1,0,24,0,-24
21946,1,0,175,0,-175
21947,0,0,23,0,-23
21948,1,1,38,1241,1203
21949,0,0,5,0,-5
21950,1,0,208,0,-208
21951,0,0,10,0,-10
21952,0,0,131,0,-131
21953,0,0,15,0,-15
21954,0,0,36,0,-36
21955,1,1,139,1349,1210
21956,1,1,430,1335,905
21957,1,1,434,1275,841
21958,1,0,76,0,-76
21959,1,1,209,1630,1421
21960,1,0,71,0,-71
21961,1,1,58,1398,1340
21962,0,0,14,0,-14
21963,1,1,820,1673,853
21964,1,1,277,1430,1153
21965,1,0,9,0,-9
21966,1,0,31,0,-31
21967,1,0,48,0,-48
21968,0,0,90,0,-90
21969,1,0,8,0,-8
21970,1,0,35,0,-35
21971,0,0,104,0,-104
21972,1,0,87,0,-87
21973,0,0,33,0,-33
21974,1,0,71,0,-71
21975,1,1,262,1601,1339
21976,0,0,0,0,0
21977,0,0,59,0,-59
21978,1,1,365,1243,878
21979,1,0,145,0,-145
21980,1,1,144,1260,1116
21981,1,0,24,0,-24
21982,1,1,339,1238,899
21983,1,1,389,1858,1469
21984,0,0,89,0,-89
21985,0,0,5,0,-5
21986,0,0,11,0,-11
21987,1,0,68,0,-68
21988,1,0,193,0,-193
21989,1,1,1331,3112,1781
21990,1,0,4,0,-4
21991,1,1,280,1663,1383
21992,1,1,1162,1850,688
21993,0,0,32,0,-32
21994,1,0,56,0,-56
21995,0,0,8,0,-8
21996,0,0,47,0,-47
21997,1,1,119,2009,1890
21998,1,1,1541,1768,227
21999,0,0,19,0,-19
22000,1,1,272,1241,969
22001,0,0,89,0,-89
22002,1,0,26,0,-26
22003,0,0,22,0,-22
22004,0,0,50,0,-50
22005,1,1,1127,1369,242
22006,1,1,459,1366,907
22007,0,0,69,0,-69
22008,0,0,28,0,-28
22009,1,1,1585,1244,-341
22010,1,1,351,1288,937
22011,0,0,26,0,-26
22012,1,0,2,0,-2
22013,1,1,68,1607,1539
22014,1,0,70,0,-70
22015,1,1,245,2901,2656
22016,0,0,32,0,-32
22017,1,1,317,1946,1629
22018,0,0,21,0,-21
22019,1,0,79,0,-79
22020,0,0,35,0,-35
22021,0,0,0,0,0
22022,1,0,16,0,-16
22023,0,0,252,0,-252
22024,0,0,119,0,-119
22025,1,0,0,0,0
22026,1,1,590,2203,1613
22027,1,1,302,1252,950
22028,1,1,251,1315,1064
22029,1,1,137,1337,1200
22030,1,0,73,0,-73
22031,0,0,72,0,-72
22032,1,0,14,0,-14
22033,0,0,19,0,-19
22034,1,0,9,0,-9
22035,1,0,68,0,-68
22036,1,1,94,1434,1340
22037,0,0,82,0,-82
22038,0,0,137,0,-137
22039,1,0,54,0,-54
22040,1,0,76,0,-76
22041,0,0,5,0,-5
22042,1,0,30,0,-30
22043,0,0,14,0,-14
22044,0,0,12,0,-12
22045,1,0,75,0,-75
22046,0,0,68,0,-68
22047,0,0,18,0,-18
22048,1,0,76,0,-76
22049,0,0,25,0,-25
22050,0,0,31,0,-31
22051,1,1,527,1434,907
22052,1,0,17,0,-17
22053,0,0,97,0,-97
22054,1,1,384,2778,2394
22055,0,0,37,0,-37
22056,1,0,7,0,-7
22057,1,0,30,0,-30
22058,0,0,13,0,-13
22059,1,1,52,1594,1542
22060,1,1,524,1250,726
22061,1,1,3359,1661,-1698
22062,1,0,27,0,-27
22063,1,0,10,0,-10
22064,1,1,252,1337,1085
22065,0,0,46,0,-46
22066,1,1,204,1326,1122
22067,0,0,54,0,-54
22068,1,0,41,0,-41
22069,0,0,67,0,-67
22070,1,1,860,1841,981
22071,1,0,32,0,-32
22072,1,1,1617,1643,26
22073,1,0,3,0,-3
22074,0,0,8,0,-8
22075,0,0,37,0,-37
22076,1,1,276,1623,1347
22077,1,1,144,1362,1218
22078,1,0,46,0,-46
22079,0,0,34,0,-34
22080,1,0,119,0,-119
22081,1,1,1046,1346,300
22082,1,1,870,1532,662
22083,0,0,20,0,-20
22084,1,0,38,0,-38
22085,0,0,10,0,-10
22086,0,0,111,0,-111
22087,1,0,23,0,-23
22088,1,1,335,1251,916
22089,0,0,25,0,-25
22090,1,1,241,1362,1121
22091,1,1,2036,2476,440
22092,1,1,540,1757,1217
22093,0,0,13,0,-13
22094,0,0,6,0,-6
22095,1,1,965,1249,284
22096,1,0,4,0,-4
22097,0,0,1,0,-1
22098,1,0,21,0,-21
22099,1,1,203,1352,1149
22100,0,0,9,0,-9
22101,1,1,446,1552,1106
22102,1,1,918,2291,1373
22103,1,1,284,2431,2147
22104,0,0,13,0,-13
22105,1,1,168,1496,1328
22106,1,0,21,0,-21
22107,1,1,391,1372,981
22108,1,1,75,1325,1250
22109,0,0,40,0,-40
22110,0,0,62,0,-62
22111,1,0,16,0,-16
22112,1,0,49,0,-49
22113,1,0,97,0,-97
22114,1,1,846,1462,616
22115,0,0,14,0,-14
22116,1,1,550,1238,688
22117,1,0,13,0,-13
22118,0,0,12,0,-12
22119,1,0,136,0,-136
22120,1,0,125,0,-125
22121,0,0,30,0,-30
22122,1,0,2,0,-2
22123,1,1,38,1929,1891
22124,0,0,80,0,-80
22125,1,1,419,1243,824
22126,1,0,29,0,-29
22127,1,0,19,0,-19
22128,0,0,0,0,0
22129,1,0,73,0,-73
22130,1,0,65,0,-65
22131,1,0,92,0,-92
22132,0,0,38,0,-38
22133,0,0,6,0,-6
22134,0,0,23,0,-23
22135,1,1,400,1289,889
22136,0,0,123,0,-123
22137,0,0,29,0,-29
22138,0,0,8,0,-8
22139,0,0,11,0,-11
22140,1,1,217,1261,1044
22141,0,0,44,0,-44
22142,1,1,252,1426,1174
22143,1,1,953,2179,1226
22144,0,0,218,0,-218
22145,0,0,43,0,-43
22146,0,0,58,0,-58
22147,1,1,430,1495,1065
22148,1,1,126,1818,1692
22149,0,0,67,0,-67
22150,1,0,65,0,-65
22151,1,0,79,0,-79
22152,1,1,292,1410,1118
22153,1,0,31,0,-31
22154,1,1,427,1402,975
22155,0,0,1,0,-1
22156,1,1,260,1373,1113
22157,0,0,93,0,-93
22158,1,0,25,0,-25
22159,1,1,447,4190,3743
22160,1,1,418,1363,945
22161,1,0,24,0,-24
22162,1,1,1050,1596,546
22163,0,0,15,0,-15
22164,1,1,361,2237,1876
22165,0,0,42,0,-42
22166,1,1,1691,1415,-276
22167,0,0,49,0,-49
22168,1,0,6,0,-6
22169,1,0,31,0,-31
22170,0,0,0,0,0
22171,0,0,117,0,-117
22172,0,0,46,0,-46
22173,0,0,8,0,-8
22174,0,0,12,0,-12
22175,0,0,25,0,-25
22176,0,0,48,0,-48
22177,0,0,190,0,-190
22178,1,1,328,1731,1403
22179,0,0,28,0,-28
22180,1,0,8,0,-8
22181,1,1,37,1462,1425
22182,0,0,11,0,-11
22183,0,0,12,0,-12
22184,0,0,11,0,-11
22185,1,1,234,1289,1055
22186,0,0,17,0,-17
22187,1,1,998,1291,293
22188,1,0,0,0,0
22189,1,0,50,0,-50
22190,0,0,102,0,-102
22191,0,0,2,0,-2
22192,0,0,65,0,-65
22193,1,0,20,0,-20
22194,1,1,116,1268,1152
22195,1,0,81,0,-81
22196,1,1,500,1435,935
22197,0,0,13,0,-13
22198,1,0,18,0,-18
22199,1,1,272,1432,1160
22200,1,0,33,0,-33
22201,1,0,51,0,-51
22202,1,1,356,1525,1169
22203,0,0,11,0,-11
22204,0,0,36,0,-36
22205,0,0,28,0,-28
22206,1,0,16,0,-16
22207,1,0,9,0,-9
22208,1,1,352,1278,926
22209,1,0,46,0,-46
22210,0,0,34,0,-34
22211,0,0,70,0,-70
22212,1,1,47,1351,1304
22213,1,0,4,0,-4
22214,0,0,23,0,-23
22215,0,0,52,0,-52
22216,1,1,2622,1258,-1364
22217,1,1,706,1672,966
22218,1,0,19,0,-19
22219,1,0,12,0,-12
22220,1,1,1171,1638,467
22221,0,0,217,0,-217
22222,1,1,415,1578,1163
22223,1,0,49,0,-49
22224,0,0,66,0,-66
22225,1,0,20,0,-20
22226,1,0,219,0,-219
22227,1,0,3,0,-3
22228,1,1,2642,1280,-1362
22229,1,0,41,0,-41
22230,0,0,62,0,-62
22231,1,0,50,0,-50
22232,1,1,155,1677,1522
22233,0,0,188,0,-188
22234,0,0,22,0,-22
22235,0,0,45,0,-45
22236,1,0,18,0,-18
22237,1,1,166,1280,1114
22238,0,0,55,0,-55
22239,0,0,112,0,-112
22240,1,0,1,0,-1
22241,1,0,13,0,-13
22242,1,1,588,1528,940
22243,1,1,62,1592,1530
22244,1,0,20,0,-20
22245,1,1,1446,1362,-84
22246,1,0,111,0,-111
22247,0,0,19,0,-19
22248,0,0,6,0,-6
22249,1,1,224,1243,1019
22250,0,0,48,0,-48
22251,0,0,20,0,-20
22252,1,0,22,0,-22
22253,0,0,164,0,-164
22254,0,0,5,0,-5
22255,0,0,34,0,-34
22256,1,0,22,0,-22
22257,1,1,1208,1486,278
22258,0,0,18,0,-18
22259,1,0,10,0,-10
22260,1,1,482,1605,1123
22261,0,0,117,0,-117
22262,1,0,29,0,-29
22263,0,0,8,0,-8
22264,0,0,63,0,-63
22265,1,0,23,0,-23
22266,1,1,1661,1754,93
22267,1,0,65,0,-65
22268,1,0,25,0,-25
22269,0,0,6,0,-6
22270,1,1,62,1847,1785
22271,1,1,836,2290,1454
22272,0,0,4,0,-4
22273,1,1,422,1480,1058
22274,1,1,352,1348,996
22275,1,0,20,0,-20
22276,1,0,14,0,-14
22277,0,0,51,0,-51
22278,1,1,194,2166,1972
22279,1,1,141,1627,1486
22280,1,1,81,1347,1266
22281,0,0,92,0,-92
22282,1,0,68,0,-68
22283,0,0,17,0,-17
22284,0,0,44,0,-44
22285,0,0,6,0,-6
22286,1,0,40,0,-40
22287,0,0,92,0,-92
22288,1,0,48,0,-48
22289,0,0,55,0,-55
22290,1,0,15,0,-15
22291,1,1,109,3086,2977
22292,0,0,40,0,-40
22293,1,0,10,0,-10
22294,1,0,0,0,0
22295,0,0,30,0,-30
22296,0,0,41,0,-41
22297,1,0,114,0,-114
22298,0,0,163,0,-163
22299,0,0,36,0,-36
22300,0,0,76,0,-76
22301,1,1,525,2099,1574
22302,1,1,1658,1801,143
22303,1,0,17,0,-17
22304,0,0,26,0,-26
22305,0,0,63,0,-63
22306,0,0,36,0,-36
22307,1,0,30,0,-30
22308,1,1,8,1314,1306
22309,1,1,244,1236,992
22310,1,0,114,0,-114
22311,1,1,141,1334,1193
22312,0,0,346,0,-346
22313,0,0,89,0,-89
22314,1,0,0,0,0
22315,0,0,16,0,-16
22316,1,1,138,1365,1227
22317,1,0,72,0,-72
22318,1,1,323,1368,1045
22319,1,1,208,1730,1522
22320,1,1,378,1272,894
22321,0,0,55,0,-55
22322,1,1,94,1691,1597
22323,0,0,0,0,0
22324,1,1,208,1349,1141
22325,1,1,222,5217,4995
22326,1,1,776,1504,728
22327,1,0,42,0,-42
22328,1,1,776,1497,721
22329,0,0,23,0,-23
22330,0,0,70,0,-70
22331,1,1,103,1693,1590
22332,1,1,795,1659,864
22333,0,0,66,0,-66
22334,1,0,72,0,-72
22335,1,0,15,0,-15
22336,0,0,10,0,-10
22337,1,0,80,0,-80
22338,0,0,59,0,-59
22339,1,0,62,0,-62
22340,0,0,14,0,-14
22341,0,0,55,0,-55
22342,1,1,153,1331,1178
22343,0,0,2,0,-2
22344,1,1,623,1300,677
22345,0,0,18,0,-18
22346,0,0,8,0,-8
22347,0,0,155,0,-155
22348,1,1,582,1358,776
22349,1,0,59,0,-59
22350,1,1,1182,2239,1057
22351,0,0,10,0,-10
22352,0,0,6,0,-6
22353,0,0,0,0,0
22354,0,0,46,0,-46
22355,0,0,11,0,-11
22356,0,0,14,0,-14
22357,0,0,36,0,-36
22358,0,0,8,0,-8
22359,0,0,37,0,-37
22360,0,0,22,0,-22
22361,1,1,259,1402,1143
22362,1,0,0,0,0
22363,1,0,22,0,-22
22364,1,1,380,1374,994
22365,0,0,13,0,-13
22366,1,1,391,1309,918
22367,0,0,36,0,-36
22368,0,0,11,0,-11
22369,1,0,60,0,-60
22370,0,0,9,0,-9
22371,1,0,2,0,-2
22372,1,0,23,0,-23
22373,1,0,76,0,-76
22374,1,0,91,0,-91
22375,1,1,805,1432,627
22376,1,0,40,0,-40
22377,1,0,66,0,-66
22378,1,0,44,0,-44
22379,1,0,72,0,-72
22380,0,0,35,0,-35
22381,1,0,36,0,-36
22382,0,0,2,0,-2
22383,1,0,14,0,-14
22384,1,0,82,0,-82
22385,1,0,83,0,-83
22386,0,0,9,0,-9
22387,1,1,578,1521,943
22388,0,0,41,0,-41
22389,1,0,68,0,-68
22390,0,0,0,0,0
22391,1,1,425,1745,1320
22392,0,0,17,0,-17
22393,0,0,22,0,-22
22394,0,0,87,0,-87
22395,0,0,4,0,-4
22396,1,1,132,1896,1764
22397,1,0,75,0,-75
22398,1,0,24,0,-24
22399,0,0,20,0,-20
22400,1,1,74,1360,1286
22401,1,1,183,1274,1091
22402,1,0,55,0,-55
22403,1,0,69,0,-69
22404,1,0,80,0,-80
22405,1,0,115,0,-115
22406,1,0,59,0,-59
22407,1,1,339,1257,918
22408,0,0,32,0,-32
22409,0,0,36,0,-36
22410,0,0,87,0,-87
22411,1,0,16,0,-16
22412,1,1,113,1280,1167
22413,1,1,62,1398,1336
22414,1,1,264,1928,1664
22415,1,0,14,0,-14
22416,0,0,28,0,-28
22417,1,0,314,0,-314
22418,1,0,51,0,-51
22419,1,0,15,0,-15
22420,0,0,19,0,-19
22421,1,1,537,1493,956
22422,1,1,712,1770,1058
22423,0,0,19,0,-19
22424,1,0,66,0,-66
22425,1,0,11,0,-11
22426,1,1,310,1680,1370
22427,1,0,55,0,-55
22428,0,0,178,0,-178
22429,0,0,2,0,-2
22430,0,0,54,0,-54
22431,1,0,16,0,-16
22432,0,0,21,0,-21
22433,0,0,71,0,-71
22434,0,0,68,0,-68
22435,1,0,0,0,0
22436,1,1,82,1283,1201
22437,0,0,6,0,-6
22438,0,0,48,0,-48
22439,1,0,47,0,-47
22440,1,1,117,1576,1459
22441,0,0,69,0,-69
22442,0,0,21,0,-21
22443,0,0,153,0,-153
22444,1,0,234,0,-234
22445,0,0,52,0,-52
22446,0,0,6,0,-6
22447,1,0,9,0,-9
22448,0,0,43,0,-43
22449,0,0,10,0,-10
22450,0,0,58,0,-58
22451,1,1,325,1278,953
22452,1,1,858,1251,393
22453,1,0,3,0,-3
22454,1,0,92,0,-92
22455,1,1,672,1484,812
22456,1,0,19,0,-19
22457,1,0,7,0,-7
22458,0,0,6,0,-6
22459,1,1,209,1295,1086
22460,1,0,95,0,-95
22461,1,0,48,0,-48
22462,0,0,141,0,-141
22463,1,1,658,1253,595
22464,0,0,266,0,-266
22465,1,1,2396,1722,-674
22466,1,0,18,0,-18
22467,1,1,15,1358,1343
22468,1,0,23,0,-23
22469,1,0,84,0,-84
22470,0,0,31,0,-31
22471,1,0,42,0,-42
22472,1,0,28,0,-28
22473,1,1,731,1358,627
22474,1,0,38,0,-38
22475,0,0,77,0,-77
22476,1,0,73,0,-73
22477,0,0,16,0,-16
22478,0,0,79,0,-79
22479,0,0,106,0,-106
22480,0,0,32,0,-32
22481,1,0,32,0,-32
22482,0,0,25,0,-25
22483,0,0,24,0,-24
22484,0,0,1,0,-1
22485,1,0,12,0,-12
22486,0,0,20,0,-20
22487,1,1,407,2333,1926
22488,1,0,2,0,-2
22489,1,1,388,1338,950
22490,1,1,334,1466,1132
22491,0,0,124,0,-124
22492,1,1,2460,1316,-1144
22493,1,1,592,1813,1221
22494,1,0,6,0,-6
22495,1,1,608,1794,1186
22496,1,1,635,1546,911
22497,1,1,47,1292,1245
22498,0,0,20,0,-20
22499,0,0,117,0,-117
22500,1,1,204,1526,1322
22501,1,1,133,1258,1125
22502,1,1,1884,1295,-589
22503,1,1,1018,1652,634
22504,1,1,1095,1385,290
22505,1,0,186,0,-186
22506,1,0,66,0,-66
22507,1,1,220,1368,1148
22508,1,0,130,0,-130
22509,0,0,14,0,-14
22510,0,0,9,0,-9
22511,1,1,41,1617,1576
22512,1,1,234,1344,1110
22513,0,0,4,0,-4
22514,1,0,0,0,0
22515,1,1,925,2171,1246
22516,0,0,6,0,-6
22517,0,0,61,0,-61
22518,0,0,93,0,-93
22519,1,0,95,0,-95
22520,1,0,67,0,-67
22521,0,0,11,0,-11
22522,0,0,40,0,-40
22523,1,0,62,0,-62
22524,1,0,42,0,-42
22525,0,0,47,0,-47
22526,0,0,58,0,-58
22527,0,0,25,0,-25
22528,0,0,5,0,-5
22529,1,0,38,0,-38
22530,0,0,110,0,-110
22531,0,0,29,0,-29
22532,1,1,416,3220,2804
22533,0,0,43,0,-43
22534,1,0,52,0,-52
22535,1,1,2006,1649,-357
22536,1,0,97,0,-97
22537,1,0,2,0,-2
22538,0,0,86,0,-86
22539,1,0,162,0,-162
22540,0,0,7,0,-7
22541,0,0,4,0,-4
22542,1,0,24,0,-24
22543,1,1,151,5013,4862
22544,1,0,38,0,-38
22545,1,1,370,3075,2705
22546,1,0,33,0,-33
22547,1,1,735,1656,921
22548,1,1,566,1482,916
22549,0,0,8,0,-8
22550,0,0,7,0,-7
22551,1,1,541,1380,839
22552,0,0,30,0,-30
22553,1,1,448,1286,838
22554,0,0,5,0,-5
22555,0,0,51,0,-51
22556,1,1,886,2085,1199
22557,1,0,148,0,-148
22558,1,1,251,2536,2285
22559,0,0,3,0,-3
22560,1,0,34,0,-34
22561,0,0,52,0,-52
22562,0,0,29,0,-29
22563,0,0,52,0,-52
22564,1,0,27,0,-27
22565,1,0,21,0,-21
22566,1,0,19,0,-19
22567,1,1,97,1368,1271
22568,0,0,0,0,0
22569,0,0,45,0,-45
22570,0,0,29,0,-29
22571,1,0,26,0,-26
22572,1,0,14,0,-14
22573,1,1,778,1543,765
22574,0,0,47,0,-47
22575,1,0,21,0,-21
22576,1,0,49,0,-49
22577,1,0,23,0,-23
22578,0,0,10,0,-10
22579,0,0,22,0,-22
22580,0,0,46,0,-46
22581,0,0,8,0,-8
22582,0,0,127,0,-127
22583,1,0,77,0,-77
22584,1,0,101,0,-101
22585,0,0,46,0,-46
22586,0,0,57,0,-57
22587,1,0,60,0,-60
22588,0,0,0,0,0
22589,1,1,896,1935,1039
22590,0,0,19,0,-19
22591,0,0,215,0,-215
22592,0,0,24,0,-24
22593,1,1,753,1316,563
22594,1,1,518,1466,948
22595,1,0,292,0,-292
22596,1,0,7,0,-7
22597,0,0,49,0,-49
22598,1,0,103,0,-103
22599,1,1,799,1496,697
22600,1,1,267,1269,1002
22601,1,0,284,0,-284
22602,1,0,41,0,-41
22603,0,0,2,0,-2
22604,0,0,10,0,-10
22605,0,0,93,0,-93
22606,1,0,22,0,-22
22607,1,0,34,0,-34
22608,1,0,76,0,-76
22609,0,0,70,0,-70
22610,0,0,25,0,-25
22611,1,1,1132,1795,663
22612,1,1,480,1504,1024
22613,0,0,29,0,-29
22614,1,0,2,0,-2
22615,1,1,69,1582,1513
22616,1,1,167,2056,1889
22617,0,0,38,0,-38
22618,0,0,47,0,-47
22619,1,0,163,0,-163
22620,0,0,21,0,-21
22621,0,0,86,0,-86
22622,1,1,307,5261,4954
22623,1,1,1343,1569,226
22624,1,0,31,0,-31
22625,0,0,33,0,-33
22626,1,1,674,1284,610
22627,0,0,11,0,-11
22628,1,0,4,0,-4
22629,1,1,45,1322,1277
22630,1,1,1466,1928,462
22631,0,0,62,0,-62
22632,1,0,50,0,-50
22633,1,0,29,0,-29
22634,1,0,34,0,-34
22635,1,0,150,0,-150
22636,1,0,44,0,-44
22637,1,1,632,1458,826
22638,1,0,53,0,-53
22639,0,0,514,0,-514
22640,1,1,535,1964,1429
22641,0,0,117,0,-117
22642,1,1,676,1342,666
22643,1,1,1186,1301,115
22644,0,0,47,0,-47
22645,0,0,48,0,-48
22646,0,0,25,0,-25
22647,0,0,93,0,-93
22648,1,0,126,0,-126
22649,1,1,776,1297,521
22650,1,0,49,0,-49
22651,0,0,45,0,-45
22652,1,0,63,0,-63
22653,0,0,14,0,-14
22654,0,0,63,0,-63
22655,1,0,176,0,-176
22656,1,1,990,1321,331
22657,0,0,50,0,-50
22658,0,0,99,0,-99
22659,1,0,165,0,-165
22660,1,1,2091,2370,279
22661,1,0,145,0,-145
22662,0,0,13,0,-13
22663,0,0,5,0,-5
22664,0,0,4,0,-4
22665,1,1,51,1602,1551
22666,0,0,16,0,-16
22667,1,1,101,1406,1305
22668,1,1,217,1409,1192
22669,0,0,159,0,-159
22670,1,0,45,0,-45
22671,1,1,743,1517,774
22672,1,0,14,0,-14
22673,1,1,232,1681,1449
22674,0,0,7,0,-7
22675,0,0,92,0,-92
22676,0,0,4,0,-4
22677,0,0,35,0,-35
22678,0,0,18,0,-18
22679,0,0,48,0,-48
22680,0,0,0,0,0
22681,1,1,289,1574,1285
22682,0,0,11,0,-11
22683,1,0,18,0,-18
22684,1,0,31,0,-31
22685,0,0,59,0,-59
22686,0,0,35,0,-35
22687,0,0,9,0,-9
22688,0,0,1,0,-1
22689,1,0,7,0,-7
22690,1,1,1284,1290,6
22691,1,0,5,0,-5
22692,1,0,6,0,-6
22693,1,1,576,1464,888
22694,1,1,513,1548,1035
22695,1,1,335,1341,1006
22696,1,0,16,0,-16
22697,1,1,40,2654,2614
22698,1,0,89,0,-89
22699,1,1,257,1866,1609
22700,0,0,1,0,-1
22701,0,0,289,0,-289
22702,1,0,7,0,-7
22703,0,0,39,0,-39
22704,1,1,1351,1536,185
22705,1,0,37,0,-37
22706,1,1,199,1753,1554
22707,0,0,40,0,-40
22708,1,0,22,0,-22
22709,0,0,61,0,-61
22710,0,0,48,0,-48
22711,0,0,8,0,-8
22712,0,0,28,0,-28
22713,0,0,10,0,-10
22714,0,0,160,0,-160
22715,0,0,18,0,-18
22716,0,0,28,0,-28
22717,1,1,952,1312,360
22718,1,0,17,0,-17
22719,1,1,258,1581,1323
22720,1,0,1,0,-1
22721,0,0,44,0,-44
22722,1,0,100,0,-100
22723,1,0,71,0,-71
22724,0,0,4,0,-4
22725,1,0,21,0,-21
22726,1,0,48,0,-48
22727,1,1,278,1393,1115
22728,1,1,323,3050,2727
22729,0,0,28,0,-28
22730,0,0,28,0,-28
22731,1,0,22,0,-22
22732,0,0,3,0,-3
22733,1,1,162,2095,1933
22734,1,1,106,1430,1324
22735,1,0,31,0,-31
22736,1,1,1460,1431,-29
22737,1,1,456,2591,2135
22738,0,0,46,0,-46
22739,1,0,13,0,-13
22740,0,0,96,0,-96
22741,1,1,2036,1427,-609
22742,0,0,50,0,-50
22743,1,1,530,1240,710
22744,1,0,12,0,-12
22745,1,1,108,1424,1316
22746,1,0,2,0,-2
22747,1,0,67,0,-67
22748,0,0,13,0,-13
22749,1,0,1,0,-1
22750,1,0,63,0,-63
22751,1,1,56,2478,2422
22752,1,0,61,0,-61
22753,0,0,20,0,-20
22754,1,1,2880,1836,-1044
22755,1,0,13,0,-13
22756,1,0,76,0,-76
22757,1,0,82,0,-82
22758,0,0,11,0,-11
22759,1,1,206,1337,1131
22760,1,1,304,1254,950
22761,0,0,8,0,-8
22762,1,1,102,1313,1211
22763,1,1,84,1650,1566
22764,1,0,71,0,-71
22765,1,1,112,1288,1176
22766,1,0,67,0,-67
22767,1,1,734,3007,2273
22768,0,0,49,0,-49
22769,0,0,26,0,-26
22770,0,0,33,0,-33
22771,0,0,2,0,-2
22772,1,0,30,0,-30
22773,0,0,39,0,-39
22774,1,1,555,1915,1360
22775,1,1,847,1338,491
22776,1,1,884,1276,392
22777,0,0,22,0,-22
22778,0,0,44,0,-44
22779,1,0,16,0,-16
22780,0,0,61,0,-61
22781,1,0,29,0,-29
22782,0,0,70,0,-70
22783,1,1,124,1310,1186
22784,0,0,5,0,-5
22785,1,0,22,0,-22
22786,1,0,27,0,-27
22787,0,0,25,0,-25
22788,1,0,60,0,-60
22789,1,0,12,0,-12
22790,1,0,9,0,-9
22791,1,1,1286,1965,679
22792,1,0,103,0,-103
22793,1,1,223,3169,2946
22794,1,0,3,0,-3
22795,1,1,152,1441,1289
22796,0,0,88,0,-88
22797,1,1,221,1268,1047
22798,1,1,144,1320,1176
22799,1,0,2,0,-2
22800,1,1,929,1250,321
22801,1,1,1879,1286,-593
22802,1,1,924,1316,392
22803,0,0,24,0,-24
22804,1,0,19,0,-19
22805,0,0,26,0,-26
22806,1,1,58,1681,1623
22807,1,0,6,0,-6
22808,1,1,670,1297,627
22809,1,0,130,0,-130
22810,1,1,78,2228,2150
22811,0,0,41,0,-41
22812,1,0,4,0,-4
22813,1,1,604,1674,1070
22814,1,1,27,1251,1224
22815,1,1,88,1247,1159
22816,0,0,69,0,-69
22817,0,0,54,0,-54
22818,0,0,107,0,-107
22819,1,1,498,1315,817
22820,0,0,51,0,-51
22821,1,1,242,1810,1568
22822,1,0,6,0,-6
22823,1,0,20,0,-20
22824,1,0,30,0,-30
22825,1,0,18,0,-18
22826,1,1,528,1849,1321
22827,1,0,6,0,-6
22828,0,0,36,0,-36
22829,1,0,13,0,-13
22830,0,0,54,0,-54
22831,0,0,58,0,-58
22832,0,0,4,0,-4
22833,1,1,332,1910,1578
22834,1,0,5,0,-5
22835,0,0,0,0,0
22836,1,1,30,1384,1354
22837,1,1,247,1307,1060
22838,0,0,33,0,-33
22839,0,0,21,0,-21
22840,0,0,15,0,-15
22841,0,0,16,0,-16
22842,0,0,196,0,-196
22843,0,0,3,0,-3
22844,0,0,2,0,-2
22845,0,0,48,0,-48
22846,0,0,7,0,-7
22847,0,0,106,0,-106
22848,1,0,1,0,-1
22849,1,1,2048,1611,-437
22850,0,0,23,0,-23
22851,0,0,4,0,-4
22852,0,0,25,0,-25
22853,1,1,2915,2204,-711
22854,1,0,19,0,-19
22855,1,1,353,1309,956
22856,0,0,25,0,-25
22857,1,1,265,1249,984
22858,0,0,16,0,-16
22859,1,1,217,1393,1176
22860,0,0,28,0,-28
22861,1,1,37,1416,1379
22862,0,0,6,0,-6
22863,0,0,27,0,-27
22864,1,0,102,0,-102
22865,1,0,40,0,-40
22866,1,1,1454,1265,-189
22867,0,0,29,0,-29
22868,0,0,1,0,-1
22869,1,1,635,1557,922
22870,0,0,119,0,-119
22871,1,0,20,0,-20
22872,0,0,135,0,-135
22873,1,0,101,0,-101
22874,0,0,97,0,-97
22875,0,0,27,0,-27
22876,1,1,129,1435,1306
22877,0,0,120,0,-120
22878,1,1,902,1427,525
22879,1,1,105,1280,1175
22880,0,0,9,0,-9
22881,1,1,650,1868,1218
22882,1,0,28,0,-28
22883,0,0,39,0,-39
22884,1,1,1586,5044,3458
22885,0,0,64,0,-64
22886,1,0,59,0,-59
22887,1,0,7,0,-7
22888,1,0,111,0,-111
22889,1,1,988,1283,295
22890,1,0,31,0,-31
22891,1,1,262,1281,1019
22892,1,0,52,0,-52
22893,1,1,1586,1837,251
22894,0,0,125,0,-125
22895,1,1,417,1748,1331
22896,0,0,8,0,-8
22897,1,1,149,1493,1344
22898,1,0,24,0,-24
22899,0,0,60,0,-60
22900,1,1,235,1924,1689
22901,1,1,298,1347,1049
22902,0,0,118,0,-118
22903,1,1,174,1713,1539
22904,1,1,250,1479,1229
22905,1,0,11,0,-11
22906,0,0,207,0,-207
22907,1,0,11,0,-11
22908,1,0,28,0,-28
22909,1,0,1,0,-1
22910,1,1,1056,1351,295
22911,0,0,9,0,-9
22912,1,0,30,0,-30
22913,1,1,368,1505,1137
22914,1,0,89,0,-89
22915,1,0,21,0,-21
22916,1,1,770,1274,504
22917,1,1,91,1327,1236
22918,1,1,602,1836,1234
22919,1,1,597,1301,704
22920,1,0,35,0,-35
22921,1,0,70,0,-70
22922,0,0,8,0,-8
22923,0,0,25,0,-25
22924,0,0,33,0,-33
22925,1,1,181,1412,1231
22926,1,1,662,1301,639
22927,1,0,70,0,-70
22928,1,1,1961,1371,-590
22929,1,1,9,1475,1466
22930,1,1,285,2058,1773
22931,1,1,561,1540,979
22932,0,0,54,0,-54
22933,0,0,68,0,-68
22934,1,1,522,1355,833
22935,0,0,13,0,-13
22936,1,1,124,1744,1620
22937,1,1,151,1436,1285
22938,0,0,75,0,-75
22939,0,0,130,0,-130
22940,0,0,49,0,-49
22941,0,0,74,0,-74
22942,1,1,746,3006,2260
22943,1,0,106,0,-106
22944,1,1,308,1513,1205
22945,1,1,321,1573,1252
22946,0,0,114,0,-114
22947,1,0,52,0,-52
22948,1,0,82,0,-82
22949,1,0,27,0,-27
22950,0,0,9,0,-9
22951,1,1,70,1332,1262
22952,1,1,2777,2268,-509
22953,1,1,344,1238,894
22954,0,0,32,0,-32
22955,0,0,2,0,-2
22956,0,0,52,0,-52
22957,1,0,58,0,-58
22958,1,1,607,1266,659
22959,0,0,2,0,-2
22960,1,0,1,0,-1
22961,1,1,2229,1337,-892
22962,0,0,19,0,-19
22963,0,0,28,0,-28
22964,1,1,27,1727,1700
22965,0,0,3,0,-3
22966,0,0,3,0,-3
22967,1,0,16,0,-16
22968,0,0,12,0,-12
22969,0,0,248,0,-248
22970,0,0,1,0,-1
22971,0,0,17,0,-17
22972,1,1,93,1320,1227
22973,1,0,62,0,-62
22974,0,0,20,0,-20
22975,1,1,267,1306,1039
22976,1,0,41,0,-41
22977,1,1,697,1916,1219
22978,0,0,52,0,-52
22979,0,0,90,0,-90
22980,1,0,144,0,-144
22981,1,0,74,0,-74
22982,1,0,3,0,-3
22983,1,1,100,1357,1257
22984,0,0,39,0,-39
22985,0,0,112,0,-112
22986,1,0,55,0,-55
22987,0,0,10,0,-10
22988,0,0,13,0,-13
22989,0,0,0,0,0
22990,1,1,864,2343,1479
22991,1,1,778,1299,521
22992,1,1,946,2659,1713
22993,1,0,30,0,-30
22994,1,0,40,0,-40
22995,1,1,481,1311,830
22996,0,0,26,0,-26
22997,0,0,84,0,-84
22998,0,0,8,0,-8
22999,1,1,182,1397,1215
23000,1,1,264,1359,1095
23001,0,0,30,0,-30
23002,1,1,874,1411,537
23003,0,0,76,0,-76
23004,1,0,28,0,-28
23005,0,0,13,0,-13
23006,0,0,103,0,-103
23007,0,0,248,0,-248
23008,0,0,100,0,-100
23009,1,1,895,1647,752
23010,0,0,35,0,-35
23011,0,0,20,0,-20
23012,1,0,10,0,-10
23013,1,1,946,1367,421
23014,0,0,23,0,-23
23015,1,1,142,1346,1204
23016,1,0,40,0,-40
23017,0,0,3,0,-3
23018,0,0,25,0,-25
23019,0,0,36,0,-36
23020,1,0,180,0,-180
23021,0,0,74,0,-74
23022,1,1,142,1590,1448
23023,0,0,14,0,-14
23024,1,1,140,1308,1168
23025,1,0,175,0,-175
23026,1,0,16,0,-16
23027,1,0,5,0,-5
23028,0,0,203,0,-203
23029,1,1,58,2324,2266
23030,1,0,59,0,-59
23031,0,0,32,0,-32
23032,1,1,321,1833,1512
23033,1,0,23,0,-23
23034,1,0,84,0,-84
23035,0,0,143,0,-143
23036,1,0,17,0,-17
23037,1,1,1123,1326,203
23038,0,0,51,0,-51
23039,1,0,13,0,-13
23040,0,0,105,0,-105
23041,0,0,96,0,-96
23042,1,0,21,0,-21
23043,1,0,7,0,-7
23044,0,0,21,0,-21
23045,1,1,1208,1248,40
23046,0,0,17,0,-17
23047,1,1,114,1332,1218
23048,1,1,201,1340,1139
23049,1,1,111,1410,1299
23050,1,1,82,2675,2593
23051,1,1,489,1811,1322
23052,1,1,277,2153,1876
23053,1,0,15,0,-15
23054,1,1,277,1440,1163
23055,0,0,1,0,-1
23056,1,0,42,0,-42
23057,0,0,27,0,-27
23058,1,1,714,1497,783
23059,1,0,46,0,-46
23060,1,1,595,1422,827
23061,0,0,12,0,-12
23062,0,0,68,0,-68
23063,0,0,45,0,-45
23064,0,0,73,0,-73
23065,1,0,19,0,-19
23066,0,0,35,0,-35
23067,1,0,83,0,-83
23068,1,1,2070,1337,-733
23069,1,1,641,1665,1024
23070,1,0,26,0,-26
23071,0,0,16,0,-16
23072,0,0,22,0,-22
23073,1,0,275,0,-275
23074,1,1,143,1246,1103
23075,1,0,23,0,-23
23076,0,0,45,0,-45
23077,1,0,63,0,-63
23078,1,1,304,3321,3017
23079,0,0,39,0,-39
23080,0,0,22,0,-22
23081,1,1,857,1388,531
23082,1,1,92,1248,1156
23083,1,1,607,1472,865
23084,1,0,34,0,-34
23085,1,0,66,0,-66
23086,0,0,53,0,-53
23087,0,0,16,0,-16
23088,1,1,307,1547,1240
23089,1,0,6,0,-6
23090,0,0,13,0,-13
23091,1,0,172,0,-172
23092,1,0,15,0,-15
23093,1,0,8,0,-8
23094,0,0,114,0,-114
23095,0,0,33,0,-33
23096,0,0,10,0,-10
23097,0,0,35,0,-35
23098,1,0,24,0,-24
23099,1,1,624,2008,1384
23100,0,0,12,0,-12
23101,0,0,103,0,-103
23102,1,0,27,0,-27
23103,0,0,80,0,-80
23104,1,1,54,1840,1786
23105,1,1,852,1503,651
23106,1,1,682,1519,837
23107,1,1,495,1235,740
23108,0,0,61,0,-61
23109,1,0,0,0,0
23110,1,1,247,1286,1039
23111,1,0,49,0,-49
23112,1,1,1060,1396,336
23113,0,0,10,0,-10
23114,0,0,16,0,-16
23115,0,0,21,0,-21
23116,0,0,4,0,-4
23117,1,0,25,0,-25
23118,0,0,62,0,-62
23119,0,0,176,0,-176
23120,0,0,4,0,-4
23121,1,0,14,0,-14
23122,0,0,26,0,-26
23123,1,1,95,1612,1517
23124,1,0,92,0,-92
23125,1,1,847,1262,415
23126,1,0,65,0,-65
23127,1,0,2,0,-2
23128,1,0,62,0,-62
23129,1,1,147,1308,1161
23130,0,0,20,0,-20
23131,1,0,177,0,-177
23132,1,1,1155,1386,231
23133,1,1,236,1272,1036
23134,0,0,68,0,-68
23135,0,0,24,0,-24
23136,0,0,30,0,-30
23137,1,0,9,0,-9
23138,1,1,556,1257,701
23139,0,0,25,0,-25
23140,1,0,50,0,-50
23141,1,0,105,0,-105
23142,0,0,94,0,-94
23143,1,0,41,0,-41
23144,1,0,48,0,-48
23145,0,0,145,0,-145
23146,1,0,93,0,-93
23147,1,0,94,0,-94
23148,1,1,555,1315,760
23149,1,1,532,2194,1662
23150,0,0,18,0,-18
23151,1,1,937,1243,306
23152,1,0,33,0,-33
23153,1,1,679,1397,718
23154,1,0,29,0,-29
23155,1,1,301,1487,1186
23156,1,1,152,1843,1691
23157,0,0,4,0,-4
23158,1,0,80,0,-80
23159,1,1,760,1466,706
23160,0,0,24,0,-24
23161,1,0,36,0,-36
23162,1,0,14,0,-14
23163,1,0,17,0,-17
23164,0,0,33,0,-33
23165,1,0,39,0,-39
23166,1,1,1185,1463,278
23167,1,1,401,3500,3099
23168,1,1,178,1673,1495
23169,1,1,156,1390,1234
23170,0,0,118,0,-118
23171,0,0,221,0,-221
23172,1,0,86,0,-86
23173,0,0,6,0,-6
23174,0,0,28,0,-28
23175,1,0,4,0,-4
23176,1,1,1189,1276,87
23177,1,0,90,0,-90
23178,1,0,31,0,-31
23179,1,0,46,0,-46
23180,1,0,23,0,-23
23181,1,0,54,0,-54
23182,1,1,613,2849,2236
23183,0,0,55,0,-55
23184,1,1,44,1526,1482
23185,0,0,35,0,-35
23186,1,0,62,0,-62
23187,1,0,125,0,-125
23188,1,1,182,2034,1852
23189,0,0,57,0,-57
23190,0,0,14,0,-14
23191,0,0,29,0,-29
23192,0,0,52,0,-52
23193,0,0,119,0,-119
23194,1,0,6,0,-6
23195,1,1,635,1322,687
23196,1,0,64,0,-64
23197,0,0,46,0,-46
23198,1,0,43,0,-43
23199,1,1,434,3272,2838
23200,1,0,95,0,-95
23201,1,0,9,0,-9
23202,0,0,21,0,-21
23203,1,1,692,1298,606
23204,1,0,120,0,-120
23205,1,0,75,0,-75
23206,1,1,1130,1243,113
23207,0,0,122,0,-122
23208,0,0,3,0,-3
23209,1,0,32,0,-32
23210,0,0,35,0,-35
23211,1,0,24,0,-24
23212,0,0,73,0,-73
23213,1,1,610,1765,1155
23214,1,0,37,0,-37
23215,0,0,68,0,-68
23216,0,0,22,0,-22
23217,1,0,20,0,-20
23218,1,0,5,0,-5
23219,1,1,1498,1301,-197
23220,0,0,7,0,-7
23221,1,1,223,1698,1475
23222,1,1,217,1741,1524
23223,0,0,46,0,-46
23224,0,0,52,0,-52
23225,1,1,353,1392,1039
23226,0,0,83,0,-83
23227,1,1,962,1247,285
23228,0,0,34,0,-34
23229,0,0,74,0,-74
23230,0,0,10,0,-10
23231,0,0,45,0,-45
23232,1,1,1438,2361,923
23233,1,0,28,0,-28
23234,0,0,4,0,-4
23235,0,0,68,0,-68
23236,1,1,567,1249,682
23237,1,1,241,1269,1028
23238,0,0,59,0,-59
23239,1,1,699,1296,597
23240,1,1,402,1313,911
23241,1,1,246,1432,1186
23242,0,0,19,0,-19
23243,0,0,129,0,-129
23244,0,0,19,0,-19
23245,0,0,6,0,-6
23246,1,1,407,1413,1006
23247,0,0,192,0,-192
23248,0,0,70,0,-70
23249,1,0,108,0,-108
23250,1,0,41,0,-41
23251,1,0,46,0,-46
23252,1,0,37,0,-37
23253,0,0,12,0,-12
23254,0,0,70,0,-70
23255,0,0,29,0,-29
23256,1,1,1148,1822,674
23257,0,0,10,0,-10
23258,0,0,8,0,-8
23259,0,0,43,0,-43
23260,1,1,1173,1324,151
23261,1,1,264,2146,1882
23262,0,0,137,0,-137
23263,1,1,311,1349,1038
23264,1,1,326,1413,1087
23265,0,0,48,0,-48
23266,1,1,280,3991,3711
23267,1,0,21,0,-21
23268,1,1,235,1566,1331
23269,1,0,76,0,-76
23270,1,1,514,1264,750
23271,1,0,5,0,-5
23272,1,0,6,0,-6
23273,0,0,16,0,-16
23274,1,1,569,1746,1177
23275,0,0,22,0,-22
23276,1,0,95,0,-95
23277,0,0,8,0,-8
23278,1,1,393,1322,929
23279,0,0,15,0,-15
23280,1,1,132,1263,1131
23281,1,1,327,1377,1050
23282,1,1,203,1439,1236
23283,1,1,159,1663,1504
23284,0,0,61,0,-61
23285,1,0,4,0,-4
23286,1,0,1,0,-1
23287,1,1,34,2709,2675
23288,0,0,27,0,-27
23289,1,1,830,1300,470
23290,0,0,10,0,-10
23291,1,1,272,2274,2002
23292,1,0,30,0,-30
23293,1,1,214,2857,2643
23294,1,0,6,0,-6
23295,1,1,1104,1624,520
23296,1,1,174,1389,1215
23297,1,0,28,0,-28
23298,0,0,10,0,-10
23299,0,0,11,0,-11
23300,1,1,269,1341,1072
23301,0,0,41,0,-41
23302,1,0,5,0,-5
23303,0,0,35,0,-35
23304,0,0,90,0,-90
23305,1,1,1328,1380,52
23306,0,0,27,0,-27
23307,0,0,76,0,-76
23308,0,0,61,0,-61
23309,1,0,21,0,-21
23310,1,1,151,1501,1350
23311,1,1,205,1267,1062
23312,1,0,17,0,-17
23313,1,0,25,0,-25
23314,0,0,37,0,-37
23315,0,0,61,0,-61
23316,1,1,28,2192,2164
23317,1,1,97,2188,2091
23318,1,1,892,1545,653
23319,1,1,800,1779,979
23320,1,1,580,1308,728
23321,1,1,1458,2200,742
23322,1,0,56,0,-56
23323,0,0,131,0,-131
23324,1,0,10,0,-10
23325,0,0,58,0,-58
23326,1,0,3,0,-3
23327,1,1,1563,1382,-181
23328,1,0,1,0,-1
23329,0,0,6,0,-6
23330,0,0,26,0,-26
23331,1,1,67,1730,1663
23332,0,0,36,0,-36
23333,1,1,119,1760,1641
23334,0,0,57,0,-57
23335,0,0,108,0,-108
23336,1,0,90,0,-90
23337,0,0,92,0,-92
23338,1,1,1107,1575,468
23339,0,0,89,0,-89
23340,0,0,4,0,-4
23341,1,0,83,0,-83
23342,1,0,37,0,-37
23343,1,0,1,0,-1
23344,1,0,7,0,-7
23345,0,0,26,0,-26
23346,1,0,79,0,-79
23347,0,0,11,0,-11
23348,1,1,476,1694,1218
23349,1,1,484,2444,1960
23350,1,1,169,1236,1067
23351,1,1,429,1398,969
23352,1,1,69,1372,1303
23353,0,0,39,0,-39
23354,0,0,51,0,-51
23355,1,1,246,1434,1188
23356,0,0,200,0,-200
23357,0,0,19,0,-19
23358,0,0,64,0,-64
23359,0,0,137,0,-137
23360,1,0,53,0,-53
23361,0,0,55,0,-55
23362,1,0,69,0,-69
23363,0,0,20,0,-20
23364,0,0,11,0,-11
23365,1,1,320,1275,955
23366,1,1,199,3058,2859
23367,0,0,27,0,-27
23368,1,0,11,0,-11
23369,1,0,52,0,-52
23370,0,0,16,0,-16
23371,1,1,243,1789,1546
23372,1,0,6,0,-6
23373,1,1,683,2975,2292
23374,1,1,880,1372,492
23375,0,0,110,0,-110
23376,0,0,23,0,-23
23377,1,1,918,1891,973
23378,1,1,39,1316,1277
23379,1,1,579,3180,2601
23380,1,0,239,0,-239
23381,1,0,40,0,-40
23382,0,0,7,0,-7
23383,1,1,39,1729,1690
23384,1,1,733,1629,896
23385,0,0,6,0,-6
23386,0,0,30,0,-30
23387,0,0,10,0,-10
23388,1,0,76,0,-76
23389,1,1,727,1471,744
23390,0,0,4,0,-4
23391,0,0,3,0,-3
23392,1,1,172,1536,1364
23393,1,1,122,1559,1437
23394,1,1,352,1290,938
23395,0,0,30,0,-30
23396,0,0,5,0,-5
23397,1,0,20,0,-20
23398,1,0,65,0,-65
23399,0,0,24,0,-24
23400,1,0,111,0,-111
23401,1,1,1289,1442,153
23402,0,0,81,0,-81
23403,1,0,84,0,-84
23404,1,0,50,0,-50
23405,0,0,40,0,-40
23406,1,1,534,1880,1346
23407,0,0,10,0,-10
23408,1,0,10,0,-10
23409,1,0,39,0,-39
23410,0,0,36,0,-36
23411,1,0,11,0,-11
23412,0,0,161,0,-161
23413,1,1,445,1357,912
23414,0,0,1,0,-1
23415,1,1,735,1298,563
23416,0,0,134,0,-134
23417,1,1,297,1296,999
23418,0,0,77,0,-77
23419,1,1,720,1295,575
23420,1,0,113,0,-113
23421,0,0,60,0,-60
23422,0,0,3,0,-3
23423,1,1,179,1521,1342
23424,0,0,27,0,-27
23425,1,0,82,0,-82
23426,0,0,14,0,-14
23427,1,0,33,0,-33
23428,0,0,26,0,-26
23429,1,1,345,1510,1165
23430,0,0,53,0,-53
23431,1,1,1717,2153,436
23432,1,1,832,2005,1173
23433,1,0,1,0,-1
23434,1,0,5,0,-5
23435,1,1,100,1292,1192
23436,1,0,22,0,-22
23437,0,0,60,0,-60
23438,1,1,213,1813,1600
23439,1,1,583,1500,917
23440,0,0,5,0,-5
23441,0,0,0,0,0
23442,1,0,26,0,-26
23443,0,0,31,0,-31
23444,0,0,76,0,-76
23445,0,0,0,0,0
23446,1,1,48,1912,1864
23447,1,0,49,0,-49
23448,0,0,55,0,-55
23449,1,1,112,1275,1163
23450,1,1,1043,1591,548
23451,1,0,0,0,0
23452,0,0,55,0,-55
23453,1,1,511,1517,1006
23454,1,0,216,0,-216
23455,1,1,173,1535,1362
23456,0,0,5,0,-5
23457,0,0,34,0,-34
23458,1,1,41,1348,1307
23459,0,0,50,0,-50
23460,1,1,40,1589,1549
23461,0,0,87,0,-87
23462,0,0,74,0,-74
23463,1,1,1423,1687,264
23464,1,0,39,0,-39
23465,1,1,216,1247,1031
23466,0,0,24,0,-24
23467,0,0,203,0,-203
23468,0,0,8,0,-8
23469,1,0,36,0,-36
23470,0,0,56,0,-56
23471,0,0,30,0,-30
23472,1,0,17,0,-17
23473,0,0,35,0,-35
23474,0,0,15,0,-15
23475,1,0,13,0,-13
23476,0,0,12,0,-12
23477,0,0,5,0,-5
23478,0,0,29,0,-29
23479,0,0,164,0,-164
23480,0,0,80,0,-80
23481,0,0,119,0,-119
23482,1,1,1021,1415,394
23483,1,1,113,1253,1140
23484,1,0,31,0,-31
23485,0,0,73,0,-73
23486,1,1,37,1241,1204
23487,0,0,62,0,-62
23488,0,0,14,0,-14
23489,0,0,77,0,-77
23490,0,0,16,0,-16
23491,1,0,32,0,-32
23492,1,0,39,0,-39
23493,0,0,51,0,-51
23494,1,0,119,0,-119
23495,1,1,679,1439,760
23496,1,0,4,0,-4
23497,1,0,40,0,-40
23498,1,0,51,0,-51
23499,0,0,35,0,-35
23500,0,0,35,0,-35
23501,1,1,169,1502,1333
23502,1,1,326,1330,1004
23503,0,0,184,0,-184
23504,1,1,516,1263,747
23505,1,0,39,0,-39
23506,0,0,4,0,-4
23507,1,1,1937,1332,-605
23508,1,0,60,0,-60
23509,0,0,81,0,-81
23510,1,0,12,0,-12
23511,1,1,92,1710,1618
23512,1,1,1515,1599,84
23513,0,0,2,0,-2
23514,0,0,25,0,-25
23515,1,0,156,0,-156
23516,0,0,7,0,-7
23517,1,0,28,0,-28
23518,0,0,11,0,-11
23519,1,1,271,2107,1836
23520,1,0,13,0,-13
23521,0,0,1,0,-1
23522,0,0,17,0,-17
23523,1,1,1220,1931,711
23524,1,0,35,0,-35
23525,1,1,2026,2244,218
23526,0,0,102,0,-102
23527,1,0,110,0,-110
23528,0,0,233,0,-233
23529,1,1,199,3153,2954
23530,1,1,210,1340,1130
23531,1,0,35,0,-35
23532,1,0,29,0,-29
23533,1,0,32,0,-32
23534,0,0,18,0,-18
23535,1,1,584,3102,2518
23536,1,1,934,1440,506
23537,0,0,50,0,-50
23538,1,1,263,1400,1137
23539,1,0,26,0,-26
23540,1,1,780,1252,472
23541,0,0,113,0,-113
23542,1,0,0,0,0
23543,0,0,88,0,-88
23544,1,1,526,1254,728
23545,1,0,170,0,-170
23546,0,0,44,0,-44
23547,1,1,80,1850,1770
23548,1,0,12,0,-12
23549,0,0,12,0,-12
23550,0,0,105,0,-105
23551,1,1,126,1530,1404
23552,1,0,196,0,-196
23553,1,1,164,1280,1116
23554,1,0,19,0,-19
23555,0,0,69,0,-69
23556,1,0,0,0,0
23557,1,1,908,1491,583
23558,1,1,105,1799,1694
23559,0,0,10,0,-10
23560,1,0,18,0,-18
23561,0,0,4,0,-4
23562,1,1,419,1321,902
23563,1,1,1314,1489,175
23564,1,0,55,0,-55
23565,0,0,31,0,-31
23566,0,0,21,0,-21
23567,0,0,96,0,-96
23568,0,0,9,0,-9
23569,0,0,25,0,-25
23570,1,0,20,0,-20
23571,1,0,36,0,-36
23572,1,0,29,0,-29
23573,1,1,125,2726,2601
23574,0,0,18,0,-18
23575,0,0,39,0,-39
23576,1,0,40,0,-40
23577,1,1,346,1252,906
23578,0,0,1,0,-1
23579,0,0,42,0,-42
23580,0,0,10,0,-10
23581,0,0,4,0,-4
23582,0,0,61,0,-61
23583,1,0,17,0,-17
23584,1,0,38,0,-38
23585,1,0,69,0,-69
23586,0,0,11,0,-11
23587,1,1,102,1763,1661
23588,0,0,127,0,-127
23589,0,0,82,0,-82
23590,0,0,131,0,-131
23591,0,0,72,0,-72
23592,0,0,90,0,-90
23593,0,0,24,0,-24
23594,0,0,72,0,-72
23595,1,1,72,1477,1405
23596,1,1,163,1237,1074
23597,1,0,2,0,-2
23598,0,0,95,0,-95
23599,1,1,358,1456,1098
23600,1,0,40,0,-40
23601,1,1,735,1283,548
23602,1,1,401,1548,1147
23603,1,1,250,1355,1105
23604,0,0,39,0,-39
23605,1,1,78,1547,1469
23606,0,0,64,0,-64
23607,0,0,56,0,-56
23608,0,0,12,0,-12
23609,1,0,13,0,-13
23610,1,1,433,1428,995
23611,0,0,40,0,-40
23612,1,1,844,1248,404
23613,0,0,85,0,-85
23614,1,0,2,0,-2
23615,1,0,10,0,-10
23616,0,0,20,0,-20
23617,1,0,43,0,-43
23618,1,0,1,0,-1
23619,1,0,24,0,-24
23620,0,0,139,0,-139
23621,1,1,648,1476,828
23622,0,0,165,0,-165
23623,0,0,24,0,-24
23624,0,0,28,0,-28
23625,1,0,38,0,-38
23626,1,0,102,0,-102
23627,0,0,75,0,-75
23628,1,0,10,0,-10
23629,0,0,26,0,-26
23630,0,0,27,0,-27
23631,1,1,860,1990,1130
23632,0,0,6,0,-6
23633,1,1,315,1305,990
23634,1,1,310,2026,1716
23635,1,0,93,0,-93
23636,1,1,85,1982,1897
23637,1,0,116,0,-116
23638,1,1,654,1676,1022
23639,0,0,0,0,0
23640,0,0,160,0,-160
23641,0,0,6,0,-6
23642,1,1,117,2152,2035
23643,1,1,206,1381,1175
23644,0,0,35,0,-35
23645,1,0,23,0,-23
23646,0,0,10,0,-10
23647,0,0,34,0,-34
23648,1,1,269,1305,1036
23649,0,0,20,0,-20
23650,1,1,312,1632,1320
23651,0,0,96,0,-96
23652,1,1,439,1397,958
23653,1,1,145,1243,1098
23654,1,0,31,0,-31
23655,1,0,40,0,-40
23656,0,0,28,0,-28
23657,0,0,25,0,-25
23658,1,1,220,1581,1361
23659,1,0,113,0,-113
23660,0,0,34,0,-34
23661,1,1,912,1465,553
23662,1,0,57,0,-57
23663,0,0,14,0,-14
23664,1,0,19,0,-19
23665,1,0,177,0,-177
23666,1,0,95,0,-95
23667,0,0,93,0,-93
23668,0,0,27,0,-27
23669,0,0,28,0,-28
23670,1,1,31,1532,1501
23671,0,0,99,0,-99
23672,1,1,212,1453,1241
23673,1,0,105,0,-105
23674,1,1,388,1299,911
23675,1,1,129,1893,1764
23676,1,1,454,1249,795
23677,1,1,482,1414,932
23678,1,0,14,0,-14
23679,1,0,32,0,-32
23680,0,0,39,0,-39
23681,1,0,7,0,-7
23682,1,0,29,0,-29
23683,1,1,1064,1492,428
23684,0,0,75,0,-75
23685,1,1,216,1369,1153
23686,1,0,30,0,-30
23687,0,0,39,0,-39
23688,0,0,44,0,-44
23689,0,0,17,0,-17
23690,1,1,217,2470,2253
23691,0,0,27,0,-27
23692,0,0,29,0,-29
23693,0,0,39,0,-39
23694,1,0,14,0,-14
23695,1,0,41,0,-41
23696,1,1,684,1381,697
23697,0,0,3,0,-3
23698,1,1,415,1730,1315
23699,1,1,419,1279,860
23700,0,0,24,0,-24
23701,1,1,103,2108,2005
23702,1,0,21,0,-21
23703,0,0,33,0,-33
23704,0,0,70,0,-70
23705,0,0,34,0,-34
23706,1,0,1,0,-1
23707,1,1,686,1841,1155
23708,0,0,44,0,-44
23709,1,1,135,1551,1416
23710,1,1,916,1235,319
23711,1,1,490,2076,1586
23712,1,1,2176,3580,1404
23713,1,1,1292,1458,166
23714,0,0,71,0,-71
23715,0,0,29,0,-29
23716,1,0,61,0,-61
23717,0,0,24,0,-24
23718,1,1,369,1333,964
23719,0,0,158,0,-158
23720,0,0,1,0,-1
23721,1,1,86,1621,1535
23722,0,0,1,0,-1
23723,0,0,39,0,-39
23724,1,1,280,1479,1199
23725,1,1,558,1295,737
23726,1,0,6,0,-6
23727,1,1,2051,2017,-34
23728,0,0,0,0,0
23729,0,0,40,0,-40
23730,0,0,9,0,-9
23731,1,0,57,0,-57
23732,1,0,47,0,-47
23733,0,0,16,0,-16
23734,0,0,15,0,-15
23735,1,1,166,2681,2515
23736,1,1,297,1632,1335
23737,1,0,82,0,-82
23738,1,1,228,1431,1203
23739,1,1,1156,1851,695
23740,0,0,7,0,-7
23741,0,0,2,0,-2
23742,1,0,40,0,-40
23743,0,0,128,0,-128
23744,0,0,25,0,-25
23745,1,0,61,0,-61
23746,0,0,1,0,-1
23747,0,0,14,0,-14
23748,1,0,52,0,-52
23749,1,0,61,0,-61
23750,1,0,1,0,-1
23751,1,1,1366,1315,-51
23752,0,0,10,0,-10
23753,0,0,40,0,-40
23754,1,0,95,0,-95
23755,1,0,39,0,-39
23756,1,1,574,1407,833
23757,0,0,54,0,-54
23758,1,0,9,0,-9
23759,1,1,64,1537,1473
23760,1,0,21,0,-21
23761,1,1,14,1849,1835
23762,1,0,77,0,-77
23763,1,0,33,0,-33
23764,0,0,15,0,-15
23765,0,0,41,0,-41
23766,0,0,133,0,-133
23767,1,0,7,0,-7
23768,0,0,21,0,-21
23769,1,0,23,0,-23
23770,0,0,18,0,-18
23771,1,1,346,1254,908
23772,1,1,706,1256,550
23773,0,0,133,0,-133
23774,1,1,92,1473,1381
23775,1,1,351,1342,991
23776,1,1,1105,1485,380
23777,0,0,55,0,-55
23778,1,0,6,0,-6
23779,1,0,20,0,-20
23780,1,1,408,1336,928
23781,1,0,28,0,-28
23782,0,0,2,0,-2
23783,1,0,28,0,-28
23784,0,0,63,0,-63
23785,1,0,12,0,-12
23786,0,0,13,0,-13
23787,0,0,13,0,-13
23788,1,0,46,0,-46
23789,1,1,74,1311,1237
23790,1,1,58,5076,5018
23791,0,0,44,0,-44
23792,1,1,387,1322,935
23793,1,1,796,1334,538
23794,0,0,5,0,-5
23795,0,0,23,0,-23
23796,0,0,64,0,-64
23797,0,0,43,0,-43
23798,0,0,198,0,-198
23799,0,0,3,0,-3
23800,0,0,138,0,-138
23801,1,1,323,1960,1637
23802,1,0,37,0,-37
23803,1,1,499,1658,1159
23804,0,0,109,0,-109
23805,0,0,97,0,-97
23806,0,0,5,0,-5
23807,1,1,47,1635,1588
23808,1,0,7,0,-7
23809,0,0,6,0,-6
23810,1,1,13,2581,2568
23811,1,0,3,0,-3
23812,0,0,30,0,-30
23813,0,0,91,0,-91
23814,0,0,61,0,-61
23815,0,0,26,0,-26
23816,1,1,3396,1245,-2151
23817,1,0,100,0,-100
23818,1,0,46,0,-46
23819,0,0,10,0,-10
23820,0,0,50,0,-50
23821,1,1,1003,2093,1090
23822,0,0,6,0,-6
23823,1,1,52,1300,1248
23824,1,0,102,0,-102
23825,0,0,3,0,-3
23826,1,0,50,0,-50
23827,1,1,123,1558,1435
23828,1,0,3,0,-3
23829,1,0,154,0,-154
23830,1,1,486,1266,780
23831,0,0,99,0,-99
23832,1,1,208,1462,1254
23833,1,0,22,0,-22
23834,1,0,35,0,-35
23835,1,1,418,5820,5402
23836,1,1,642,1712,1070
23837,1,0,181,0,-181
23838,1,1,600,1522,922
23839,0,0,1,0,-1
23840,1,1,143,1444,1301
23841,0,0,215,0,-215
23842,1,0,121,0,-121
23843,1,0,5,0,-5
23844,1,0,51,0,-51
23845,0,0,85,0,-85
23846,0,0,32,0,-32
23847,0,0,216,0,-216
23848,0,0,24,0,-24
23849,0,0,66,0,-66
23850,1,1,1224,1622,398
23851,0,0,11,0,-11
23852,0,0,8,0,-8
23853,1,1,310,2026,1716
23854,0,0,4,0,-4
23855,1,1,1708,1272,-436
23856,0,0,20,0,-20
23857,1,1,353,1295,942
23858,1,1,402,1253,851
23859,1,0,85,0,-85
23860,1,0,68,0,-68
23861,1,0,24,0,-24
23862,0,0,119,0,-119
23863,1,0,14,0,-14
23864,1,0,34,0,-34
23865,0,0,8,0,-8
23866,0,0,29,0,-29
23867,1,0,139,0,-139
23868,1,1,147,1595,1448
23869,1,1,421,1433,1012
23870,1,1,389,1242,853
23871,1,1,194,1351,1157
23872,1,0,6,0,-6
23873,1,1,36,1275,1239
23874,0,0,136,0,-136
23875,0,0,14,0,-14
23876,0,0,14,0,-14
23877,1,1,1141,1278,137
23878,0,0,32,0,-32
23879,1,1,1580,1250,-330
23880,1,1,719,1237,518
23881,0,0,51,0,-51
23882,0,0,103,0,-103
23883,0,0,11,0,-11
23884,1,1,240,1813,1573
23885,1,1,206,1374,1168
23886,1,1,1189,1443,254
23887,0,0,4,0,-4
23888,1,0,120,0,-120
23889,1,0,28,0,-28
23890,1,0,108,0,-108
23891,1,1,275,1241,966
23892,1,1,657,2476,1819
23893,1,1,67,1277,1210
23894,0,0,104,0,-104
23895,1,1,695,1384,689
23896,1,0,3,0,-3
23897,0,0,51,0,-51
23898,1,1,471,1293,822
23899,1,1,936,1244,308
23900,0,0,0,0,0
23901,1,1,722,1711,989
23902,1,1,222,1266,1044
23903,1,1,883,1450,567
23904,0,0,19,0,-19
23905,1,1,595,1464,869
23906,1,0,14,0,-14
23907,1,1,161,1610,1449
23908,1,0,25,0,-25
23909,1,1,1678,1323,-355
23910,0,0,8,0,-8
23911,1,0,0,0,0
23912,0,0,39,0,-39
23913,1,0,10,0,-10
23914,0,0,67,0,-67
23915,1,0,8,0,-8
23916,1,1,43,1636,1593
23917,1,0,5,0,-5
23918,1,0,129,0,-129
23919,0,0,344,0,-344
23920,1,1,834,1855,1021
23921,0,0,112,0,-112
23922,0,0,124,0,-124
23923,0,0,14,0,-14
23924,1,0,32,0,-32
23925,1,0,60,0,-60
23926,1,0,21,0,-21
23927,0,0,25,0,-25
23928,1,1,457,9689,9232
23929,1,1,90,1504,1414
23930,1,0,16,0,-16
23931,1,1,477,1528,1051
23932,1,1,783,3029,2246
23933,1,1,88,1365,1277
23934,0,0,144,0,-144
23935,1,1,329,1901,1572
23936,0,0,19,0,-19
23937,0,0,27,0,-27
23938,0,0,23,0,-23
23939,1,0,30,0,-30
23940,0,0,130,0,-130
23941,1,0,37,0,-37
23942,1,1,535,1273,738
23943,0,0,61,0,-61
23944,1,0,82,0,-82
23945,1,1,2288,1285,-1003
23946,1,1,333,1290,957
23947,1,1,397,2100,1703
23948,1,1,557,1485,928
23949,1,1,793,1731,938
23950,1,1,1550,1878,328
23951,1,1,527,1973,1446
23952,1,0,113,0,-113
23953,0,0,38,0,-38
23954,1,0,58,0,-58
23955,0,0,13,0,-13
23956,0,0,0,0,0
23957,1,0,83,0,-83
23958,0,0,85,0,-85
23959,0,0,37,0,-37
23960,0,0,9,0,-9
23961,1,1,192,1619,1427
23962,0,0,53,0,-53
23963,1,0,15,0,-15
23964,0,0,130,0,-130
23965,1,0,35,0,-35
23966,0,0,10,0,-10
23967,0,0,156,0,-156
23968,1,0,6,0,-6
23969,1,0,30,0,-30
23970,1,0,83,0,-83
23971,0,0,100,0,-100
23972,1,0,30,0,-30
23973,1,1,245,1517,1272
23974,0,0,52,0,-52
23975,1,1,73,3156,3083
23976,1,1,236,1620,1384
23977,1,0,182,0,-182
23978,0,0,122,0,-122
23979,0,0,46,0,-46
23980,0,0,4,0,-4
23981,0,0,43,0,-43
23982,1,1,435,1395,960
23983,0,0,2,0,-2
23984,0,0,34,0,-34
23985,1,0,49,0,-49
23986,1,1,417,1274,857
23987,0,0,130,0,-130
23988,0,0,78,0,-78
23989,1,0,13,0,-13
23990,0,0,11,0,-11
23991,1,0,6,0,-6
23992,1,0,6,0,-6
23993,1,0,241,0,-241
23994,1,0,230,0,-230
23995,1,1,98,1305,1207
23996,1,0,12,0,-12
23997,1,1,655,1563,908
23998,1,1,653,1793,1140
23999,1,0,46,0,-46
24000,1,1,112,1304,1192
24001,0,0,118,0,-118
24002,0,0,36,0,-36
24003,1,0,9,0,-9
24004,0,0,63,0,-63
24005,0,0,74,0,-74
24006,0,0,8,0,-8
24007,1,0,35,0,-35
24008,1,1,1019,1425,406
24009,0,0,32,0,-32
24010,1,0,178,0,-178
24011,1,1,658,1452,794
24012,1,1,12,1797,1785
24013,1,1,715,1253,538
24014,1,0,9,0,-9
24015,1,0,14,0,-14
24016,1,0,31,0,-31
24017,1,0,33,0,-33
24018,1,1,1416,1409,-7
24019,1,0,40,0,-40
24020,1,0,129,0,-129
24021,0,0,23,0,-23
24022,0,0,2,0,-2
24023,0,0,193,0,-193
24024,0,0,12,0,-12
24025,0,0,19,0,-19
24026,1,0,59,0,-59
24027,1,1,64,1280,1216
24028,1,1,607,1253,646
24029,1,0,16,0,-16
24030,1,1,82,1395,1313
24031,1,0,20,0,-20
24032,0,0,5,0,-5
24033,0,0,2,0,-2
24034,1,1,1869,1397,-472
24035,0,0,11,0,-11
24036,0,0,57,0,-57
24037,1,0,69,0,-69
24038,1,0,54,0,-54
24039,1,0,23,0,-23
24040,1,0,114,0,-114
24041,0,0,4,0,-4
24042,1,1,1893,2159,266
24043,1,0,25,0,-25
24044,0,0,118,0,-118
24045,0,0,23,0,-23
24046,1,0,34,0,-34
24047,1,1,235,1279,1044
24048,1,0,94,0,-94
24049,1,1,837,1311,474
24050,1,0,80,0,-80
24051,1,1,449,2600,2151
24052,0,0,166,0,-166
24053,0,0,144,0,-144
24054,1,0,67,0,-67
24055,1,1,170,1407,1237
24056,1,1,420,1937,1517
24057,0,0,66,0,-66
24058,1,1,123,2589,2466
24059,0,0,12,0,-12
24060,1,1,188,1471,1283
24061,0,0,7,0,-7
24062,1,1,525,1470,945
24063,1,1,539,1240,701
24064,0,0,131,0,-131
24065,1,0,67,0,-67
24066,1,1,178,1485,1307
24067,1,1,354,1740,1386
24068,1,0,20,0,-20
24069,1,0,4,0,-4
24070,0,0,13,0,-13
24071,1,0,67,0,-67
24072,1,0,51,0,-51
24073,0,0,15,0,-15
24074,1,1,287,1544,1257
24075,0,0,85,0,-85
24076,1,1,810,1599,789
24077,1,0,0,0,0
24078,1,0,53,0,-53
24079,1,1,711,1325,614
24080,1,1,125,1586,1461
24081,0,0,33,0,-33
24082,1,0,6,0,-6
24083,1,1,101,1631,1530
24084,0,0,0,0,0
24085,1,1,232,1403,1171
24086,0,0,40,0,-40
24087,1,1,1789,1273,-516
24088,1,1,423,3316,2893
24089,1,0,6,0,-6
24090,1,0,57,0,-57
24091,0,0,33,0,-33
24092,1,0,2,0,-2
24093,1,0,0,0,0
24094,1,0,30,0,-30
24095,1,0,5,0,-5
24096,0,0,34,0,-34
24097,0,0,23,0,-23
24098,1,0,12,0,-12
24099,0,0,13,0,-13
24100,1,1,423,1473,1050
24101,0,0,24,0,-24
24102,0,0,80,0,-80
24103,1,0,14,0,-14
24104,1,0,90,0,-90
24105,1,0,9,0,-9
24106,1,0,40,0,-40
24107,0,0,34,0,-34
24108,0,0,116,0,-116
24109,1,0,36,0,-36
24110,1,1,562,1342,780
24111,0,0,21,0,-21
24112,1,0,47,0,-47
24113,0,0,92,0,-92
24114,0,0,19,0,-19
24115,1,0,14,0,-14
24116,1,1,594,1249,655
24117,1,0,40,0,-40
24118,1,0,69,0,-69
24119,1,0,131,0,-131
24120,1,1,360,1248,888
24121,1,1,270,1372,1102
24122,1,1,347,2660,2313
24123,1,1,296,1717,1421
24124,0,0,74,0,-74
24125,0,0,130,0,-130
24126,0,0,8,0,-8
24127,1,1,428,1485,1057
24128,0,0,109,0,-109
24129,0,0,1,0,-1
24130,1,0,9,0,-9
24131,1,0,23,0,-23
24132,1,0,35,0,-35
24133,0,0,140,0,-140
24134,1,1,191,1605,1414
24135,0,0,87,0,-87
24136,1,1,523,1283,760
24137,1,0,80,0,-80
24138,0,0,95,0,-95
24139,0,0,132,0,-132
24140,0,0,21,0,-21
24141,0,0,23,0,-23
24142,0,0,75,0,-75
24143,0,0,233,0,-233
24144,1,1,1133,1259,126
24145,1,0,41,0,-41
24146,0,0,136,0,-136
24147,0,0,19,0,-19
24148,0,0,24,0,-24
24149,1,0,74,0,-74
24150,1,1,127,1332,1205
24151,1,1,138,1833,1695
24152,1,1,428,1311,883
24153,1,1,753,1262,509
24154,0,0,5,0,-5
24155,0,0,23,0,-23
24156,1,1,423,2162,1739
24157,0,0,115,0,-115
24158,1,0,3,0,-3
24159,0,0,20,0,-20
24160,1,1,160,1408,1248
24161,1,0,62,0,-62
24162,0,0,42,0,-42
24163,1,0,61,0,-61
24164,1,1,358,1509,1151
24165,0,0,24,0,-24
24166,1,0,7,0,-7
24167,1,1,892,1278,386
24168,1,1,318,1367,1049
24169,1,1,183,1237,1054
24170,1,0,1,0,-1
24171,1,0,4,0,-4
24172,1,0,8,0,-8
24173,0,0,46,0,-46
24174,0,0,31,0,-31
24175,1,0,56,0,-56
24176,0,0,78,0,-78
24177,1,1,761,2042,1281
24178,0,0,106,0,-106
24179,1,0,18,0,-18
24180,0,0,44,0,-44
24181,1,0,88,0,-88
24182,1,0,126,0,-126
24183,1,1,654,3125,2471
24184,1,0,216,0,-216
24185,1,0,12,0,-12
24186,0,0,17,0,-17
24187,1,0,57,0,-57
24188,1,1,68,1523,1455
24189,1,1,308,1765,1457
24190,1,0,30,0,-30
24191,1,0,7,0,-7
24192,0,0,63,0,-63
24193,1,1,869,1451,582
24194,1,0,25,0,-25
24195,0,0,1,0,-1
24196,0,0,46,0,-46
24197,0,0,116,0,-116
24198,1,1,271,1255,984
24199,0,0,130,0,-130
24200,0,0,37,0,-37
24201,0,0,67,0,-67
24202,1,0,5,0,-5
24203,0,0,133,0,-133
24204,0,0,3,0,-3
24205,1,1,124,1749,1625
24206,0,0,10,0,-10
24207,1,0,15,0,-15
24208,0,0,85,0,-85
24209,0,0,140,0,-140
24210,0,0,59,0,-59
24211,1,1,58,1241,1183
24212,0,0,74,0,-74
24213,1,0,160,0,-160
24214,1,1,321,1259,938
24215,1,1,362,1424,1062
24216,1,0,37,0,-37
24217,1,1,469,1286,817
24218,0,0,36,0,-36
24219,1,1,112,1956,1844
24220,0,0,3,0,-3
24221,1,1,255,1329,1074
24222,0,0,89,0,-89
24223,0,0,1,0,-1
24224,1,0,8,0,-8
24225,1,1,801,1251,450
24226,0,0,58,0,-58
24227,0,0,32,0,-32
24228,1,0,46,0,-46
24229,1,0,6,0,-6
24230,1,0,95,0,-95
24231,1,1,2614,1833,-781
24232,0,0,62,0,-62
24233,1,1,963,1689,726
24234,0,0,44,0,-44
24235,1,0,1,0,-1
24236,1,1,165,1303,1138
24237,1,0,109,0,-109
24238,1,1,687,1240,553
24239,1,1,479,1250,771
24240,0,0,67,0,-67
24241,0,0,26,0,-26
24242,0,0,218,0,-218
24243,1,1,314,1508,1194
24244,1,1,994,1495,501
24245,0,0,1,0,-1
24246,0,0,50,0,-50
24247,1,1,236,3289,3053
24248,0,0,62,0,-62
24249,1,1,1132,1593,461
24250,1,1,133,1328,1195
24251,1,1,16,1278,1262
24252,0,0,115,0,-115
24253,0,0,9,0,-9
24254,0,0,112,0,-112
24255,1,1,54,2263,2209
24256,0,0,30,0,-30
24257,1,1,490,1448,958
24258,1,1,881,1292,411
24259,1,0,62,0,-62
24260,0,0,42,0,-42
24261,1,0,140,0,-140
24262,0,0,8,0,-8
24263,1,0,32,0,-32
24264,1,1,145,1938,1793
24265,1,0,22,0,-22
24266,1,0,24,0,-24
24267,1,1,400,1270,870
24268,0,0,137,0,-137
24269,1,0,49,0,-49
24270,1,0,17,0,-17
24271,1,1,1424,2236,812
24272,1,0,33,0,-33
24273,1,1,249,1372,1123
24274,0,0,5,0,-5
24275,0,0,166,0,-166
24276,0,0,25,0,-25
24277,1,0,151,0,-151
24278,0,0,23,0,-23
24279,0,0,89,0,-89
24280,0,0,1,0,-1
24281,0,0,26,0,-26
24282,1,1,432,1436,1004
24283,1,0,15,0,-15
24284,1,0,4,0,-4
24285,1,1,1025,1426,401
24286,1,0,53,0,-53
24287,0,0,42,0,-42
24288,0,0,37,0,-37
24289,0,0,54,0,-54
24290,1,1,128,1676,1548
24291,1,0,17,0,-17
24292,1,1,1475,1309,-166
24293,1,1,299,1387,1088
24294,1,0,138,0,-138
24295,0,0,11,0,-11
24296,0,0,38,0,-38
24297,1,0,35,0,-35
24298,1,1,370,1974,1604
24299,0,0,0,0,0
24300,1,0,7,0,-7
24301,1,1,41,1441,1400
24302,0,0,61,0,-61
24303,0,0,1,0,-1
24304,1,1,274,1297,1023
24305,1,0,11,0,-11
24306,1,0,13,0,-13
24307,1,1,654,1236,582
24308,0,0,63,0,-63
24309,1,1,78,1539,1461
24310,1,1,442,6072,5630
24311,1,1,172,1461,1289
24312,1,0,13,0,-13
24313,1,0,48,0,-48
24314,1,0,29,0,-29
24315,1,1,331,2003,1672
24316,1,1,619,1300,681
24317,1,1,293,2103,1810
24318,0,0,4,0,-4
24319,1,1,2035,1397,-638
24320,0,0,48,0,-48
24321,0,0,53,0,-53
24322,1,1,530,1522,992
24323,0,0,46,0,-46
24324,0,0,38,0,-38
24325,1,0,32,0,-32
24326,0,0,38,0,-38
24327,0,0,4,0,-4
24328,1,1,1906,1704,-202
24329,1,0,8,0,-8
24330,0,0,21,0,-21
24331,0,0,7,0,-7
24332,0,0,0,0,0
24333,0,0,84,0,-84
24334,1,0,3,0,-3
24335,1,0,2,0,-2
24336,0,0,35,0,-35
24337,1,0,12,0,-12
24338,0,0,83,0,-83
24339,1,0,78,0,-78
24340,1,1,1013,1298,285
24341,1,0,104,0,-104
24342,1,1,980,1745,765
24343,1,1,125,1414,1289
24344,1,1,546,2184,1638
24345,1,1,972,2069,1097
24346,0,0,24,0,-24
24347,1,0,137,0,-137
24348,0,0,50,0,-50
24349,0,0,157,0,-157
24350,0,0,59,0,-59
24351,0,0,19,0,-19
24352,1,1,305,1378,1073
24353,0,0,18,0,-18
24354,1,0,18,0,-18
24355,0,0,63,0,-63
24356,1,1,330,1238,908
24357,0,0,29,0,-29
24358,0,0,36,0,-36
24359,1,0,6,0,-6
24360,0,0,23,0,-23
24361,1,1,773,1406,633
24362,1,0,63,0,-63
24363,1,1,128,1645,1517
24364,1,0,33,0,-33
24365,1,1,330,2444,2114
24366,0,0,16,0,-16
24367,0,0,28,0,-28
24368,1,1,761,1265,504
24369,1,0,29,0,-29
24370,0,0,23,0,-23
24371,1,0,40,0,-40
24372,1,1,350,1260,910
24373,1,1,893,1298,405
24374,0,0,48,0,-48
24375,1,1,464,1557,1093
24376,0,0,5,0,-5
24377,1,0,0,0,0
24378,1,0,42,0,-42
24379,0,0,119,0,-119
24380,1,0,19,0,-19
24381,1,1,1161,1688,527
24382,0,0,32,0,-32
24383,0,0,20,0,-20
24384,1,0,119,0,-119
24385,0,0,18,0,-18
24386,1,1,252,1237,985
24387,0,0,39,0,-39
24388,0,0,18,0,-18
24389,0,0,8,0,-8
24390,0,0,119,0,-119
24391,1,1,2032,1683,-349
24392,1,1,722,1807,1085
24393,0,0,146,0,-146
24394,1,1,1123,1316,193
24395,0,0,29,0,-29
24396,1,0,7,0,-7
24397,1,0,19,0,-19
24398,1,1,64,1735,1671
24399,0,0,49,0,-49
24400,0,0,175,0,-175
24401,0,0,171,0,-171
24402,1,1,203,2627,2424
24403,0,0,54,0,-54
24404,1,1,284,1256,972
24405,1,0,1,0,-1
24406,0,0,8,0,-8
24407,1,0,11,0,-11
24408,1,0,58,0,-58
24409,1,1,267,1240,973
24410,0,0,1,0,-1
24411,1,0,31,0,-31
24412,1,1,618,1665,1047
24413,0,0,0,0,0
24414,1,1,751,1245,494
24415,0,0,3,0,-3
24416,1,1,885,1282,397
24417,1,0,80,0,-80
24418,1,1,77,1518,1441
24419,1,0,139,0,-139
24420,0,0,14,0,-14
24421,0,0,23,0,-23
24422,1,1,91,1806,1715
24423,1,0,9,0,-9
24424,1,0,171,0,-171
24425,1,1,116,1284,1168
24426,0,0,40,0,-40
24427,1,1,906,2903,1997
24428,1,1,124,1380,1256
24429,1,0,146,0,-146
24430,0,0,26,0,-26
24431,1,0,105,0,-105
24432,0,0,18,0,-18
24433,1,0,7,0,-7
24434,1,1,231,1263,1032
24435,1,0,44,0,-44
24436,1,0,20,0,-20
24437,1,1,374,2509,2135
24438,1,0,23,0,-23
24439,1,1,612,1681,1069
24440,1,0,123,0,-123
24441,0,0,97,0,-97
24442,1,1,1439,1418,-21
24443,1,1,239,1828,1589
24444,0,0,24,0,-24
24445,0,0,26,0,-26
24446,1,0,29,0,-29
24447,1,0,57,0,-57
24448,0,0,21,0,-21
24449,0,0,31,0,-31
24450,1,1,272,1321,1049
24451,1,0,44,0,-44
24452,1,0,59,0,-59
24453,1,0,71,0,-71
24454,0,0,59,0,-59
24455,0,0,63,0,-63
24456,0,0,46,0,-46
24457,1,1,633,1360,727
24458,0,0,54,0,-54
24459,1,1,381,1237,856
24460,0,0,22,0,-22
24461,1,0,55,0,-55
24462,1,1,440,1985,1545
24463,1,0,103,0,-103
24464,1,1,128,1568,1440
24465,1,0,28,0,-28
24466,1,1,688,1356,668
24467,1,0,79,0,-79
24468,1,1,796,1257,461
24469,1,1,161,1280,1119
24470,1,0,49,0,-49
24471,1,0,91,0,-91
24472,1,0,8,0,-8
24473,1,1,214,1269,1055
24474,1,1,389,2570,2181
24475,0,0,10,0,-10
24476,0,0,44,0,-44
24477,1,0,9,0,-9
24478,0,0,71,0,-71
24479,0,0,170,0,-170
24480,1,1,500,1440,940
24481,1,1,228,1471,1243
24482,0,0,14,0,-14
24483,1,1,145,1416,1271
24484,1,0,20,0,-20
24485,1,1,872,2913,2041
24486,1,0,11,0,-11
24487,0,0,12,0,-12
24488,1,0,85,0,-85
24489,1,0,5,0,-5
24490,0,0,14,0,-14
24491,0,0,80,0,-80
24492,1,1,983,1757,774
24493,1,0,86,0,-86
24494,1,0,7,0,-7
24495,1,0,8,0,-8
24496,1,0,61,0,-61
24497,1,0,43,0,-43
24498,1,0,50,0,-50
24499,1,0,0,0,0
24500,1,0,20,0,-20
24501,0,0,117,0,-117
24502,0,0,124,0,-124
24503,1,1,699,1251,552
24504,1,1,342,1395,1053
24505,0,0,78,0,-78
24506,1,1,459,3098,2639
24507,1,0,89,0,-89
24508,1,1,292,1265,973
24509,0,0,69,0,-69
24510,1,1,218,1489,1271
24511,0,0,36,0,-36
24512,0,0,52,0,-52
24513,1,0,75,0,-75
24514,1,1,256,5385,5129
24515,1,1,1125,1915,790
24516,0,0,31,0,-31
24517,0,0,17,0,-17
24518,1,0,55,0,-55
24519,1,0,2,0,-2
24520,1,1,265,1447,1182
24521,1,0,6,0,-6
24522,1,0,98,0,-98
24523,0,0,82,0,-82
24524,1,0,40,0,-40
24525,1,0,10,0,-10
24526,1,1,770,1712,942
24527,0,0,8,0,-8
24528,0,0,31,0,-31
24529,1,1,1111,1375,264
24530,1,1,1254,1321,67
24531,0,0,3,0,-3
24532,0,0,20,0,-20
24533,1,1,276,1534,1258
24534,0,0,192,0,-192
24535,1,0,39,0,-39
24536,1,1,800,1425,625
24537,0,0,17,0,-17
24538,0,0,76,0,-76
24539,0,0,20,0,-20
24540,1,0,23,0,-23
24541,1,0,70,0,-70
24542,0,0,219,0,-219
24543,1,0,99,0,-99
24544,1,1,339,1420,1081
24545,0,0,33,0,-33
24546,0,0,15,0,-15
24547,1,1,374,2257,1883
24548,1,0,56,0,-56
24549,0,0,92,0,-92
24550,1,1,348,1331,983
24551,0,0,22,0,-22
24552,1,1,626,2489,1863
24553,1,0,84,0,-84
24554,1,0,30,0,-30
24555,1,1,1226,1704,478
24556,1,1,1407,2381,974
24557,1,0,43,0,-43
24558,0,0,2,0,-2
24559,0,0,25,0,-25
24560,1,0,11,0,-11
24561,1,1,113,1554,1441
24562,0,0,0,0,0
24563,1,1,164,1593,1429
24564,1,0,7,0,-7
24565,0,0,15,0,-15
24566,1,0,16,0,-16
24567,1,1,312,1240,928
24568,0,0,72,0,-72
24569,1,0,45,0,-45
24570,0,0,13,0,-13
24571,1,0,84,0,-84
24572,0,0,49,0,-49
24573,0,0,2,0,-2
24574,1,1,197,1385,1188
24575,1,0,263,0,-263
24576,0,0,68,0,-68
24577,1,1,435,1295,860
24578,1,1,406,1640,1234
24579,0,0,43,0,-43
24580,0,0,87,0,-87
24581,1,0,40,0,-40
24582,1,0,26,0,-26
24583,1,0,15,0,-15
24584,1,0,9,0,-9
24585,1,0,8,0,-8
24586,0,0,76,0,-76
24587,0,0,75,0,-75
24588,1,0,8,0,-8
24589,1,1,135,2388,2253
24590,1,1,609,1553,944
24591,1,0,112,0,-112
24592,1,1,145,1301,1156
24593,0,0,17,0,-17
24594,1,1,1371,2726,1355
24595,1,1,169,2558,2389
24596,1,0,11,0,-11
24597,1,0,101,0,-101
24598,1,1,164,1301,1137
24599,0,0,69,0,-69
24600,0,0,24,0,-24
24601,1,1,19,1362,1343
24602,1,0,3,0,-3
24603,0,0,23,0,-23
24604,1,0,53,0,-53
24605,0,0,0,0,0
24606,0,0,41,0,-41
24607,0,0,71,0,-71
24608,1,1,2831,2019,-812
24609,1,0,60,0,-60
24610,0,0,1,0,-1
24611,0,0,46,0,-46
24612,1,1,1260,2390,1130
24613,0,0,50,0,-50
24614,0,0,23,0,-23
24615,1,0,6,0,-6
24616,1,0,20,0,-20
24617,1,1,534,2415,1881
24618,1,0,75,0,-75
24619,1,1,1171,1886,715
24620,0,0,40,0,-40
24621,1,0,82,0,-82
24622,0,0,60,0,-60
24623,0,0,4,0,-4
24624,1,1,10,1299,1289
24625,0,0,5,0,-5
24626,0,0,118,0,-118
24627,1,0,14,0,-14
24628,1,0,14,0,-14
24629,1,1,463,1260,797
24630,1,0,29,0,-29
24631,1,1,773,1877,1104
24632,1,0,98,0,-98
24633,1,0,12,0,-12
24634,1,1,438,1671,1233
24635,1,0,15,0,-15
24636,1,1,94,2526,2432
24637,0,0,11,0,-11
24638,1,0,0,0,0
24639,1,1,1229,1468,239
24640,1,0,6,0,-6
24641,1,0,15,0,-15
24642,0,0,48,0,-48
24643,0,0,20,0,-20
24644,1,1,482,1358,876
24645,0,0,92,0,-92
24646,1,0,43,0,-43
24647,1,0,41,0,-41
24648,0,0,6,0,-6
24649,1,0,66,0,-66
24650,0,0,48,0,-48
24651,0,0,3,0,-3
24652,1,1,706,1664,958
24653,1,0,8,0,-8
24654,0,0,200,0,-200
24655,0,0,12,0,-12
24656,1,0,2,0,-2
24657,0,0,54,0,-54
24658,1,1,264,1487,1223
24659,1,1,2028,1989,-39
24660,0,0,43,0,-43
24661,1,1,383,1248,865
24662,1,0,104,0,-104
24663,1,0,29,0,-29
24664,1,0,4,0,-4
24665,1,0,43,0,-43
24666,1,1,328,1244,916
24667,1,0,5,0,-5
24668,1,0,38,0,-38
24669,1,0,14,0,-14
24670,1,1,922,1351,429
24671,0,0,55,0,-55
24672,0,0,34,0,-34
24673,1,0,23,0,-23
24674,1,0,8,0,-8
24675,1,1,72,1284,1212
24676,1,1,66,1380,1314
24677,0,0,0,0,0
24678,1,0,13,0,-13
24679,1,1,877,1345,468
24680,1,0,60,0,-60
24681,0,0,47,0,-47
24682,0,0,48,0,-48
24683,1,1,251,2382,2131
24684,0,0,20,0,-20
24685,1,0,21,0,-21
24686,1,1,176,1617,1441
24687,0,0,31,0,-31
24688,0,0,2,0,-2
24689,0,0,153,0,-153
24690,1,0,65,0,-65
24691,1,0,45,0,-45
24692,1,1,3307,1514,-1793
24693,0,0,0,0,0
24694,1,0,207,0,-207
24695,0,0,44,0,-44
24696,0,0,94,0,-94
24697,1,0,39,0,-39
24698,1,0,65,0,-65
24699,0,0,16,0,-16
24700,1,0,103,0,-103
24701,1,0,83,0,-83
24702,0,0,61,0,-61
24703,0,0,69,0,-69
24704,0,0,60,0,-60
24705,0,0,61,0,-61
24706,0,0,239,0,-239
24707,1,1,233,1249,1016
24708,1,1,1668,1338,-330
24709,1,0,66,0,-66
24710,1,1,974,1335,361
24711,0,0,90,0,-90
24712,1,1,110,1545,1435
24713,1,1,275,2160,1885
24714,1,1,22,1585,1563
24715,0,0,7,0,-7
24716,1,0,13,0,-13
24717,0,0,85,0,-85
24718,0,0,21,0,-21
24719,0,0,100,0,-100
24720,1,0,91,0,-91
24721,1,1,195,1357,1162
24722,0,0,50,0,-50
24723,0,0,52,0,-52
24724,0,0,43,0,-43
24725,0,0,5,0,-5
24726,1,0,16,0,-16
24727,0,0,61,0,-61
24728,1,0,53,0,-53
24729,0,0,89,0,-89
24730,1,1,304,1296,992
24731,1,0,15,0,-15
24732,1,1,61,3331,3270
24733,1,0,42,0,-42
24734,1,0,30,0,-30
24735,1,0,29,0,-29
24736,0,0,10,0,-10
24737,0,0,147,0,-147
24738,1,1,246,1464,1218
24739,0,0,21,0,-21
24740,1,0,23,0,-23
24741,0,0,60,0,-60
24742,1,1,795,1306,511
24743,0,0,57,0,-57
24744,1,0,37,0,-37
24745,1,1,509,1320,811
24746,1,0,6,0,-6
24747,0,0,5,0,-5
24748,1,1,26,1272,1246
24749,0,0,53,0,-53
24750,0,0,7,0,-7
24751,1,0,67,0,-67
24752,1,0,126,0,-126
24753,0,0,29,0,-29
24754,1,1,624,1564,940
24755,0,0,9,0,-9
24756,1,0,179,0,-179
24757,1,1,1337,1360,23
24758,1,0,92,0,-92
24759,0,0,9,0,-9
24760,1,1,660,1245,585
24761,1,1,688,2198,1510
24762,0,0,21,0,-21
24763,0,0,41,0,-41
24764,1,0,0,0,0
24765,1,1,648,1777,1129
24766,1,1,1922,1248,-674
24767,1,1,660,2110,1450
24768,1,1,15,1315,1300
24769,1,1,339,1710,1371
24770,0,0,40,0,-40
24771,0,0,79,0,-79
24772,0,0,11,0,-11
24773,0,0,108,0,-108
24774,1,1,144,1271,1127
24775,0,0,7,0,-7
24776,0,0,25,0,-25
24777,0,0,24,0,-24
24778,0,0,55,0,-55
24779,0,0,63,0,-63
24780,1,0,64,0,-64
24781,0,0,7,0,-7
24782,0,0,61,0,-61
24783,0,0,5,0,-5
24784,1,1,467,1341,874
24785,1,1,613,1379,766
24786,1,0,16,0,-16
24787,1,1,1386,1662,276
24788,1,1,433,1240,807
24789,1,1,36,1554,1518
24790,1,0,41,0,-41
24791,0,0,50,0,-50
24792,0,0,28,0,-28
24793,0,0,15,0,-15
24794,1,1,344,1339,995
24795,1,1,999,1329,330
24796,1,0,81,0,-81
24797,1,1,338,1809,1471
24798,0,0,54,0,-54
24799,1,1,922,1375,453
24800,0,0,60,0,-60
24801,1,1,838,1307,469
24802,1,0,15,0,-15
24803,0,0,75,0,-75
24804,1,1,264,1375,1111
24805,0,0,67,0,-67
24806,1,0,60,0,-60
24807,1,1,397,1597,1200
24808,0,0,5,0,-5
24809,0,0,82,0,-82
24810,0,0,103,0,-103
24811,1,1,542,1887,1345
24812,1,0,26,0,-26
24813,1,0,57,0,-57
24814,1,0,121,0,-121
24815,1,1,1717,1573,-144
24816,1,1,398,1249,851
24817,1,0,34,0,-34
24818,0,0,7,0,-7
24819,0,0,25,0,-25
24820,1,0,95,0,-95
24821,1,0,97,0,-97
24822,0,0,17,0,-17
24823,0,0,29,0,-29
24824,1,0,27,0,-27
24825,1,1,1241,1257,16
24826,1,1,1128,1382,254
24827,0,0,22,0,-22
24828,1,0,26,0,-26
24829,1,0,46,0,-46
24830,0,0,21,0,-21
24831,1,0,156,0,-156
24832,1,1,1236,1394,158
24833,0,0,159,0,-159
24834,0,0,7,0,-7
24835,1,0,63,0,-63
24836,0,0,171,0,-171
24837,1,1,523,1618,1095
24838,1,0,70,0,-70
24839,1,0,20,0,-20
24840,1,1,309,1246,937
24841,0,0,88,0,-88
24842,1,1,1076,3840,2764
24843,0,0,16,0,-16
24844,1,0,114,0,-114
24845,1,0,58,0,-58
24846,0,0,33,0,-33
24847,0,0,51,0,-51
24848,1,1,331,1656,1325
24849,1,0,55,0,-55
24850,0,0,118,0,-118
24851,0,0,71,0,-71
24852,1,1,1426,1321,-105
24853,1,0,15,0,-15
24854,0,0,116,0,-116
24855,1,1,15,2376,2361
24856,0,0,46,0,-46
24857,0,0,12,0,-12
24858,1,1,1181,2250,1069
24859,0,0,21,0,-21
24860,0,0,0,0,0
24861,1,0,65,0,-65
24862,1,0,69,0,-69
24863,1,0,19,0,-19
24864,1,1,2119,1866,-253
24865,1,1,731,1235,504
24866,0,0,15,0,-15
24867,0,0,90,0,-90
24868,0,0,61,0,-61
24869,1,1,758,1816,1058
24870,0,0,110,0,-110
24871,1,0,119,0,-119
24872,1,1,1079,1382,303
24873,0,0,53,0,-53
24874,0,0,44,0,-44
24875,0,0,25,0,-25
24876,1,1,15,1364,1349
24877,0,0,79,0,-79
24878,0,0,3,0,-3
24879,1,0,37,0,-37
24880,0,0,51,0,-51
24881,1,1,235,2142,1907
24882,0,0,13,0,-13
24883,1,1,542,1274,732
24884,1,0,33,0,-33
24885,1,0,1,0,-1
24886,1,1,165,1489,1324
24887,1,0,5,0,-5
24888,1,1,698,1544,846
24889,1,1,341,1542,1201
24890,1,1,281,2080,1799
24891,0,0,1,0,-1
24892,1,1,466,1524,1058
24893,1,1,833,1278,445
24894,1,1,325,1359,1034
24895,1,1,94,1296,1202
24896,0,0,30,0,-30
24897,1,0,170,0,-170
24898,1,0,152,0,-152
24899,1,0,70,0,-70
24900,1,1,532,1298,766
24901,0,0,40,0,-40
24902,0,0,2,0,-2
24903,0,0,17,0,-17
24904,0,0,3,0,-3
24905,1,0,16,0,-16
24906,1,1,105,1286,1181
24907,1,1,449,1809,1360
24908,1,1,477,1654,1177
24909,1,1,1049,1439,390
24910,1,0,28,0,-28
24911,1,1,288,2443,2155
24912,0,0,53,0,-53
24913,0,0,5,0,-5
24914,0,0,77,0,-77
24915,1,1,342,1913,1571
24916,1,1,3271,1689,-1582
24917,1,1,961,1279,318
24918,0,0,33,0,-33
24919,1,1,348,3535,3187
24920,1,1,639,1627,988
24921,1,1,149,1577,1428
24922,1,0,68,0,-68
24923,1,0,74,0,-74
24924,0,0,11,0,-11
24925,0,0,25,0,-25
24926,0,0,7,0,-7
24927,0,0,25,0,-25
24928,1,1,732,1995,1263
24929,1,1,831,1293,462
24930,0,0,87,0,-87
24931,0,0,69,0,-69
24932,0,0,17,0,-17
24933,1,0,59,0,-59
24934,0,0,16,0,-16
24935,0,0,3,0,-3
24936,0,0,82,0,-82
24937,0,0,103,0,-103
24938,0,0,67,0,-67
24939,0,0,57,0,-57
24940,1,1,1127,1534,407
24941,1,0,7,0,-7
24942,0,0,33,0,-33
24943,0,0,41,0,-41
24944,1,0,148,0,-148
24945,0,0,64,0,-64
24946,1,1,1066,1271,205
24947,0,0,85,0,-85
24948,0,0,6,0,-6
24949,0,0,1,0,-1
24950,1,0,46,0,-46
24951,1,0,11,0,-11
24952,1,0,65,0,-65
24953,0,0,29,0,-29
24954,0,0,84,0,-84
24955,1,0,9,0,-9
24956,0,0,27,0,-27
24957,0,0,38,0,-38
24958,0,0,33,0,-33
24959,0,0,22,0,-22
24960,1,0,19,0,-19
24961,0,0,2,0,-2
24962,0,0,8,0,-8
24963,0,0,54,0,-54
24964,1,0,96,0,-96
24965,1,1,694,2375,1681
24966,0,0,10,0,-10
24967,0,0,2,0,-2
24968,0,0,157,0,-157
24969,1,0,36,0,-36
24970,1,1,423,1413,990
24971,0,0,58,0,-58
24972,1,1,2510,1299,-1211
24973,1,0,40,0,-40
24974,0,0,39,0,-39
24975,0,0,4,0,-4
24976,1,1,286,2680,2394
24977,1,1,1367,1900,533
24978,1,0,7,0,-7
24979,1,1,683,1264,581
24980,1,1,912,2040,1128
24981,1,0,6,0,-6
24982,0,0,106,0,-106
24983,1,0,6,0,-6
24984,0,0,62,0,-62
24985,1,0,9,0,-9
24986,1,0,9,0,-9
24987,1,1,153,1322,1169
24988,1,0,58,0,-58
24989,1,0,101,0,-101
24990,0,0,34,0,-34
24991,0,0,50,0,-50
24992,1,1,118,1600,1482
24993,1,1,114,1441,1327
24994,0,0,24,0,-24
24995,0,0,23,0,-23
24996,1,1,877,1457,580
24997,0,0,21,0,-21
24998,0,0,129,0,-129
24999,0,0,13,0,-13
25000,1,0,2,0,-2
25001,1,1,815,1367,552
25002,0,0,9,0,-9
25003,1,1,182,1251,1069
25004,0,0,27,0,-27
25005,1,0,34,0,-34
25006,1,1,311,1738,1427
25007,1,0,68,0,-68
25008,1,1,101,1324,1223
25009,0,0,84,0,-84
25010,0,0,64,0,-64
25011,1,1,1217,1616,399
25012,1,1,481,1519,1038
25013,1,1,57,1408,1351
25014,1,1,151,1427,1276
25015,1,1,169,1934,1765
25016,1,1,529,3099,2570
25017,0,0,65,0,-65
25018,0,0,126,0,-126
25019,0,0,57,0,-57
25020,0,0,76,0,-76
25021,1,1,435,2756,2321
25022,0,0,75,0,-75
25023,0,0,5,0,-5
25024,1,0,51,0,-51
25025,1,0,16,0,-16
25026,0,0,38,0,-38
25027,1,1,408,1689,1281
25028,1,0,52,0,-52
25029,1,0,13,0,-13
25030,1,0,40,0,-40
25031,1,0,13,0,-13
25032,1,1,570,1430,860
25033,1,1,203,1305,1102
25034,1,0,35,0,-35
25035,1,1,474,1515,1041
25036,1,1,654,1702,1048
25037,1,1,273,1732,1459
25038,1,0,161,0,-161
25039,0,0,11,0,-11
25040,1,1,2232,1797,-435
25041,1,1,1440,1376,-64
25042,0,0,52,0,-52
25043,0,0,48,0,-48
25044,0,0,15,0,-15
25045,0,0,61,0,-61
25046,0,0,22,0,-22
25047,1,0,45,0,-45
25048,1,0,84,0,-84
25049,1,0,5,0,-5
25050,0,0,59,0,-59
25051,1,0,17,0,-17
25052,0,0,9,0,-9
25053,1,0,8,0,-8
25054,0,0,0,0,0
25055,1,1,131,1357,1226
25056,0,0,87,0,-87
25057,0,0,11,0,-11
25058,0,0,62,0,-62
25059,0,0,11,0,-11
25060,1,0,84,0,-84
25061,1,0,13,0,-13
25062,1,0,11,0,-11
25063,1,0,46,0,-46
25064,0,0,34,0,-34
25065,1,1,841,1849,1008
25066,1,1,1684,1714,30
25067,1,0,48,0,-48
25068,1,1,388,1577,1189
25069,1,0,81,0,-81
25070,1,0,36,0,-36
25071,1,1,289,1327,1038
25072,0,0,5,0,-5
25073,0,0,14,0,-14
25074,0,0,16,0,-16
25075,1,1,174,1633,1459
25076,0,0,153,0,-153
25077,1,1,158,1297,1139
25078,1,0,21,0,-21
25079,1,1,674,1560,886
25080,1,1,1073,1824,751
25081,0,0,18,0,-18
25082,1,0,32,0,-32
25083,1,1,199,3720,3521
25084,0,0,62,0,-62
25085,1,0,2,0,-2
25086,1,0,48,0,-48
25087,0,0,2,0,-2
25088,1,0,200,0,-200
25089,1,0,152,0,-152
25090,1,0,50,0,-50
25091,1,1,873,1299,426
25092,0,0,281,0,-281
25093,0,0,15,0,-15
25094,1,0,24,0,-24
25095,1,0,129,0,-129
25096,1,1,292,1385,1093
25097,1,1,305,1405,1100
25098,0,0,125,0,-125
25099,1,0,3,0,-3
25100,0,0,25,0,-25
25101,1,1,183,1313,1130
25102,0,0,22,0,-22
25103,1,0,19,0,-19
25104,1,0,57,0,-57
25105,0,0,28,0,-28
25106,1,1,309,1444,1135
25107,1,0,23,0,-23
25108,1,1,618,1339,721
25109,0,0,150,0,-150
25110,0,0,9,0,-9
25111,1,0,2,0,-2
25112,1,1,647,2261,1614
25113,1,1,224,1629,1405
25114,1,0,74,0,-74
25115,1,1,202,1305,1103
25116,1,0,42,0,-42
25117,1,1,1444,1301,-143
25118,1,1,676,1895,1219
25119,1,1,1057,1286,229
25120,0,0,80,0,-80
25121,1,0,55,0,-55
25122,0,0,30,0,-30
25123,0,0,30,0,-30
25124,0,0,37,0,-37
25125,1,1,284,1333,1049
25126,1,1,157,1517,1360
25127,1,0,61,0,-61
25128,0,0,210,0,-210
25129,0,0,12,0,-12
25130,1,1,608,1270,662
25131,1,1,2218,1266,-952
25132,1,0,0,0,0
25133,1,0,89,0,-89
25134,1,0,33,0,-33
25135,1,0,25,0,-25
25136,1,1,591,2170,1579
25137,1,0,20,0,-20
25138,0,0,51,0,-51
25139,1,1,238,1423,1185
25140,0,0,4,0,-4
25141,1,1,824,1393,569
25142,1,1,47,1259,1212
25143,0,0,123,0,-123
25144,0,0,43,0,-43
25145,0,0,32,0,-32
25146,0,0,156,0,-156
25147,1,0,70,0,-70
25148,1,1,410,2985,2575
25149,1,0,75,0,-75
25150,0,0,145,0,-145
25151,0,0,47,0,-47
25152,0,0,5,0,-5
25153,0,0,234,0,-234
25154,1,0,60,0,-60
25155,1,0,39,0,-39
25156,1,1,556,1296,740
25157,0,0,14,0,-14
25158,1,1,189,1824,1635
25159,1,1,613,1249,636
25160,1,1,1244,1285,41
25161,1,0,6,0,-6
25162,0,0,42,0,-42
25163,1,0,44,0,-44
25164,1,1,122,2482,2360
25165,1,0,5,0,-5
25166,0,0,87,0,-87
25167,0,0,114,0,-114
25168,0,0,15,0,-15
25169,0,0,298,0,-298
25170,1,0,30,0,-30
25171,1,0,95,0,-95
25172,1,0,79,0,-79
25173,1,0,7,0,-7
25174,1,0,42,0,-42
25175,0,0,54,0,-54
25176,1,0,80,0,-80
25177,1,1,598,1803,1205
25178,1,1,1889,1347,-542
25179,0,0,57,0,-57
25180,1,1,1903,1668,-235
25181,0,0,20,0,-20
25182,1,1,260,1430,1170
25183,0,0,38,0,-38
25184,0,0,9,0,-9
25185,1,0,3,0,-3
25186,0,0,53,0,-53
25187,0,0,82,0,-82
25188,1,1,120,1252,1132
25189,0,0,1,0,-1
25190,0,0,173,0,-173
25191,1,0,5,0,-5
25192,1,1,686,2234,1548
25193,1,1,781,1560,779
25194,0,0,48,0,-48
25195,1,1,420,1486,1066
25196,1,0,87,0,-87
25197,1,1,234,1893,1659
25198,1,1,323,1320,997
25199,0,0,5,0,-5
25200,1,0,14,0,-14
25201,0,0,39,0,-39
25202,0,0,95,0,-95
25203,0,0,80,0,-80
25204,0,0,5,0,-5
25205,1,1,105,1674,1569
25206,0,0,10,0,-10
25207,0,0,53,0,-53
25208,1,0,14,0,-14
25209,1,0,161,0,-161
25210,0,0,82,0,-82
25211,1,1,408,1254,846
25212,1,1,1295,2112,817
25213,1,1,133,1382,1249
25214,1,0,2,0,-2
25215,1,1,481,2025,1544
25216,1,1,34,1456,1422
25217,1,1,668,1619,951
25218,0,0,104,0,-104
25219,0,0,41,0,-41
25220,1,1,848,1242,394
25221,0,0,69,0,-69
25222,1,0,32,0,-32
25223,1,0,103,0,-103
25224,1,1,270,1326,1056
25225,1,1,785,1261,476
25226,1,0,23,0,-23
25227,0,0,5,0,-5
25228,0,0,38,0,-38
25229,0,0,0,0,0
25230,1,0,0,0,0
25231,1,1,236,1471,1235
25232,1,0,43,0,-43
25233,1,1,588,1559,971
25234,1,1,193,1496,1303
25235,1,1,509,1406,897
25236,0,0,65,0,-65
25237,1,0,31,0,-31
25238,0,0,12,0,-12
25239,1,1,107,1403,1296
25240,0,0,72,0,-72
25241,0,0,85,0,-85
25242,0,0,11,0,-11
25243,1,1,120,1328,1208
25244,1,1,1383,1348,-35
25245,0,0,12,0,-12
25246,1,0,12,0,-12
25247,0,0,40,0,-40
25248,0,0,43,0,-43
25249,1,1,676,1396,720
25250,0,0,65,0,-65
25251,1,0,107,0,-107
25252,0,0,18,0,-18
25253,1,1,348,1275,927
25254,1,0,12,0,-12
25255,1,0,7,0,-7
25256,1,0,45,0,-45
25257,1,0,18,0,-18
25258,1,0,76,0,-76
25259,1,0,7,0,-7
25260,1,0,20,0,-20
25261,1,1,647,2045,1398
25262,1,1,425,1276,851
25263,0,0,30,0,-30
25264,1,1,243,1320,1077
25265,0,0,13,0,-13
25266,1,1,934,1235,301
25267,1,0,35,0,-35
25268,1,1,11,2649,2638
25269,1,0,64,0,-64
25270,0,0,38,0,-38
25271,1,0,161,0,-161
25272,0,0,52,0,-52
25273,1,0,48,0,-48
25274,0,0,9,0,-9
25275,0,0,32,0,-32
25276,0,0,5,0,-5
25277,1,0,19,0,-19
25278,1,1,1258,1497,239
25279,0,0,44,0,-44
25280,1,1,207,1251,1044
25281,1,0,157,0,-157
25282,1,0,9,0,-9
25283,1,1,287,1337,1050
25284,0,0,72,0,-72
25285,0,0,71,0,-71
25286,1,0,29,0,-29
25287,0,0,154,0,-154
25288,1,0,106,0,-106
25289,1,1,353,1403,1050
25290,0,0,42,0,-42
25291,0,0,4,0,-4
25292,1,1,1428,1418,-10
25293,1,1,24,1418,1394
25294,0,0,16,0,-16
25295,1,0,29,0,-29
25296,1,0,0,0,0
25297,1,1,311,1322,1011
25298,0,0,59,0,-59
25299,1,1,623,1336,713
25300,1,0,63,0,-63
25301,1,1,527,1549,1022
25302,1,1,400,2039,1639
25303,1,0,44,0,-44
25304,0,0,5,0,-5
25305,1,1,473,3105,2632
25306,0,0,2,0,-2
25307,1,1,694,1825,1131
25308,0,0,0,0,0
25309,0,0,1,0,-1
25310,1,0,15,0,-15
25311,1,1,1433,1844,411
25312,0,0,59,0,-59
25313,1,0,134,0,-134
25314,0,0,54,0,-54
25315,0,0,1,0,-1
25316,1,1,429,1467,1038
25317,1,0,75,0,-75
25318,1,0,103,0,-103
25319,0,0,39,0,-39
25320,1,1,864,1882,1018
25321,1,1,169,1728,1559
25322,1,0,29,0,-29
25323,1,1,57,1308,1251
25324,1,0,136,0,-136
25325,0,0,52,0,-52
25326,1,0,37,0,-37
25327,1,0,24,0,-24
25328,1,1,2102,1253,-849
25329,0,0,128,0,-128
25330,1,0,32,0,-32
25331,1,0,41,0,-41
25332,1,1,511,1780,1269
25333,1,1,677,1444,767
25334,0,0,4,0,-4
25335,0,0,134,0,-134
25336,1,0,45,0,-45
25337,0,0,68,0,-68
25338,1,0,251,0,-251
25339,1,0,279,0,-279
25340,0,0,24,0,-24
25341,0,0,122,0,-122
25342,0,0,8,0,-8
25343,0,0,53,0,-53
25344,1,1,198,1557,1359
25345,1,0,4,0,-4
25346,1,1,341,1236,895
25347,1,0,134,0,-134
25348,1,1,46,2414,2368
25349,0,0,5,0,-5
25350,0,0,10,0,-10
25351,0,0,43,0,-43
25352,0,0,14,0,-14
25353,0,0,18,0,-18
25354,1,1,359,1390,1031
25355,1,0,33,0,-33
25356,1,1,1033,1348,315
25357,0,0,15,0,-15
25358,1,1,291,2016,1725
25359,0,0,7,0,-7
25360,1,1,325,1816,1491
25361,1,1,74,2121,2047
25362,1,1,1118,1266,148
25363,1,0,46,0,-46
25364,0,0,114,0,-114
25365,0,0,133,0,-133
25366,0,0,23,0,-23
25367,0,0,24,0,-24
25368,1,0,22,0,-22
25369,1,0,1,0,-1
25370,0,0,2,0,-2
25371,1,1,131,1528,1397
25372,1,0,2,0,-2
25373,1,0,122,0,-122
25374,0,0,33,0,-33
25375,0,0,6,0,-6
25376,1,1,823,1636,813
25377,0,0,82,0,-82
25378,1,0,34,0,-34
25379,0,0,33,0,-33
25380,0,0,42,0,-42
25381,0,0,56,0,-56
25382,0,0,4,0,-4
25383,0,0,13,0,-13
25384,1,0,60,0,-60
25385,0,0,4,0,-4
25386,1,1,1116,1532,416
25387,1,1,391,3124,2733
25388,1,0,214,0,-214
25389,1,0,12,0,-12
25390,0,0,65,0,-65
25391,1,1,1295,1681,386
25392,0,0,100,0,-100
25393,1,0,46,0,-46
25394,1,0,67,0,-67
25395,1,0,0,0,0
25396,1,0,42,0,-42
25397,1,1,63,1295,1232
25398,1,1,675,1824,1149
25399,1,1,399,1367,968
25400,0,0,15,0,-15
25401,1,1,442,1456,1014
25402,1,1,1306,1337,31
25403,1,0,9,0,-9
25404,1,0,85,0,-85
25405,0,0,14,0,-14
25406,1,0,8,0,-8
25407,0,0,223,0,-223
25408,0,0,60,0,-60
25409,1,1,1832,2072,240
25410,0,0,79,0,-79
25411,1,1,176,1391,1215
25412,0,0,26,0,-26
25413,1,1,328,1315,987
25414,1,1,194,1334,1140
25415,1,1,469,1349,880
25416,0,0,34,0,-34
25417,0,0,10,0,-10
25418,0,0,96,0,-96
25419,0,0,21,0,-21
25420,1,0,146,0,-146
25421,1,0,11,0,-11
25422,1,1,1055,1440,385
25423,1,1,326,1488,1162
25424,0,0,39,0,-39
25425,1,1,746,1361,615
25426,0,0,34,0,-34
25427,0,0,20,0,-20
25428,1,1,1184,1291,107
25429,0,0,7,0,-7
25430,1,0,9,0,-9
25431,1,1,455,1520,1065
25432,1,0,7,0,-7
25433,1,1,258,2250,1992
25434,1,0,27,0,-27
25435,0,0,40,0,-40
25436,0,0,98,0,-98
25437,0,0,54,0,-54
25438,0,0,136,0,-136
25439,0,0,91,0,-91
25440,0,0,90,0,-90
25441,1,0,171,0,-171
25442,0,0,81,0,-81
25443,1,0,44,0,-44
25444,1,0,18,0,-18
25445,1,1,380,1496,1116
25446,1,0,14,0,-14
25447,1,1,1904,1305,-599
25448,0,0,95,0,-95
25449,0,0,35,0,-35
25450,0,0,9,0,-9
25451,1,0,70,0,-70
25452,1,1,703,1594,891
25453,1,0,65,0,-65
25454,1,0,60,0,-60
25455,1,1,1226,1581,355
25456,1,0,13,0,-13
25457,0,0,49,0,-49
25458,0,0,65,0,-65
25459,0,0,15,0,-15
25460,0,0,51,0,-51
25461,1,1,88,1690,1602
25462,1,1,124,1449,1325
25463,1,1,889,1393,504
25464,1,1,101,1291,1190
25465,1,0,18,0,-18
25466,1,0,30,0,-30
25467,0,0,33,0,-33
25468,1,1,477,2320,1843
25469,1,0,43,0,-43
25470,1,1,40,1393,1353
25471,1,0,56,0,-56
25472,1,1,1862,2218,356
25473,0,0,27,0,-27
25474,1,0,77,0,-77
25475,1,0,79,0,-79
25476,0,0,64,0,-64
25477,0,0,45,0,-45
25478,0,0,24,0,-24
25479,1,0,64,0,-64
25480,1,0,37,0,-37
25481,1,0,59,0,-59
25482,1,0,50,0,-50
25483,1,0,65,0,-65
25484,0,0,19,0,-19
25485,1,1,477,1591,1114
25486,0,0,71,0,-71
25487,1,0,28,0,-28
25488,1,1,1690,2561,871
25489,0,0,66,0,-66
25490,0,0,191,0,-191
25491,1,1,273,1242,969
25492,1,0,7,0,-7
25493,1,0,36,0,-36
25494,0,0,51,0,-51
25495,1,0,21,0,-21
25496,1,0,110,0,-110
25497,1,1,236,1646,1410
25498,1,1,443,1347,904
25499,1,1,70,1633,1563
25500,1,1,1298,1978,680
25501,0,0,10,0,-10
25502,1,1,322,1349,1027
25503,0,0,16,0,-16
25504,1,1,315,2064,1749
25505,1,1,670,1261,591
25506,1,1,62,1545,1483
25507,1,0,29,0,-29
25508,1,1,126,1302,1176
25509,0,0,10,0,-10
25510,1,0,58,0,-58
25511,1,0,66,0,-66
25512,1,0,23,0,-23
25513,0,0,0,0,0
25514,1,0,54,0,-54
25515,1,1,203,1248,1045
25516,1,1,621,1243,622
25517,1,0,58,0,-58
25518,1,1,13,1375,1362
25519,1,1,473,1293,820
25520,0,0,20,0,-20
25521,1,1,152,1276,1124
25522,0,0,0,0,0
25523,1,0,148,0,-148
25524,1,0,50,0,-50
25525,0,0,45,0,-45
25526,0,0,107,0,-107
25527,1,1,97,1268,1171
25528,0,0,61,0,-61
25529,1,0,55,0,-55
25530,1,1,164,1291,1127
25531,1,1,107,1280,1173
25532,0,0,48,0,-48
25533,1,1,1173,1554,381
25534,0,0,39,0,-39
25535,0,0,54,0,-54
25536,1,0,152,0,-152
25537,1,1,1495,1393,-102
25538,0,0,128,0,-128
25539,0,0,113,0,-113
25540,0,0,29,0,-29
25541,1,0,59,0,-59
25542,1,1,587,1599,1012
25543,1,1,168,1361,1193
25544,1,1,466,1555,1089
25545,1,0,16,0,-16
25546,1,0,15,0,-15
25547,1,1,526,1388,862
25548,1,1,92,1619,1527
25549,0,0,55,0,-55
25550,0,0,13,0,-13
25551,0,0,40,0,-40
25552,1,1,341,1929,1588
25553,1,0,35,0,-35
25554,0,0,14,0,-14
25555,0,0,144,0,-144
25556,0,0,7,0,-7
25557,0,0,79,0,-79
25558,0,0,8,0,-8
25559,0,0,113,0,-113
25560,0,0,51,0,-51
25561,0,0,70,0,-70
25562,1,1,419,1447,1028
25563,0,0,84,0,-84
25564,1,1,188,2203,2015
25565,0,0,81,0,-81
25566,1,1,1541,1742,201
25567,1,0,24,0,-24
25568,1,1,446,1357,911
25569,1,0,65,0,-65
25570,1,1,593,1588,995
25571,1,0,103,0,-103
25572,1,1,584,1274,690
25573,1,0,137,0,-137
25574,0,0,47,0,-47
25575,1,1,373,2026,1653
25576,1,0,15,0,-15
25577,1,0,11,0,-11
25578,1,0,24,0,-24
25579,1,0,48,0,-48
25580,1,1,428,2641,2213
25581,1,0,103,0,-103
25582,1,1,808,1612,804
25583,0,0,18,0,-18
25584,1,0,99,0,-99
25585,0,0,24,0,-24
25586,1,0,46,0,-46
25587,0,0,2,0,-2
25588,1,1,920,1386,466
25589,0,0,85,0,-85
25590,1,0,56,0,-56
25591,1,0,33,0,-33
25592,1,1,497,1241,744
25593,1,1,165,1377,1212
25594,1,1,120,1511,1391
25595,0,0,73,0,-73
25596,0,0,18,0,-18
25597,0,0,77,0,-77
25598,1,0,4,0,-4
25599,1,1,95,1424,1329
25600,0,0,23,0,-23
25601,1,0,0,0,0
25602,1,0,2,0,-2
25603,0,0,13,0,-13
25604,1,1,190,1492,1302
25605,0,0,32,0,-32
25606,0,0,63,0,-63
25607,1,1,1158,1783,625
25608,0,0,22,0,-22
25609,0,0,20,0,-20
25610,0,0,25,0,-25
25611,0,0,19,0,-19
25612,1,0,34,0,-34
25613,1,0,11,0,-11
25614,0,0,1,0,-1
25615,1,0,9,0,-9
25616,1,1,424,1609,1185
25617,1,1,799,2334,1535
25618,1,0,12,0,-12
25619,1,0,99,0,-99
25620,1,1,2865,1312,-1553
25621,1,1,159,1950,1791
25622,1,1,2439,3185,746
25623,1,0,14,0,-14
25624,1,0,2,0,-2
25625,1,1,261,1848,1587
25626,1,0,21,0,-21
25627,1,1,309,2687,2378
25628,1,1,238,1353,1115
25629,0,0,54,0,-54
25630,1,0,22,0,-22
25631,1,1,374,2649,2275
25632,0,0,29,0,-29
25633,0,0,82,0,-82
25634,1,0,30,0,-30
25635,0,0,22,0,-22
25636,0,0,121,0,-121
25637,0,0,59,0,-59
25638,1,1,511,1556,1045
25639,1,1,95,3705,3610
25640,1,1,256,1260,1004
25641,1,1,626,1539,913
25642,0,0,7,0,-7
25643,1,1,455,1237,782
25644,1,1,535,2076,1541
25645,1,0,98,0,-98
25646,0,0,16,0,-16
25647,0,0,10,0,-10
25648,1,0,28,0,-28
25649,0,0,5,0,-5
25650,0,0,33,0,-33
25651,0,0,80,0,-80
25652,1,0,86,0,-86
25653,1,1,1807,2852,1045
25654,1,1,884,1339,455
25655,0,0,33,0,-33
25656,1,1,241,1351,1110
25657,1,0,34,0,-34
25658,0,0,14,0,-14
25659,0,0,1,0,-1
25660,0,0,123,0,-123
25661,1,1,204,1430,1226
25662,1,0,18,0,-18
25663,0,0,52,0,-52
25664,0,0,17,0,-17
25665,1,0,24,0,-24
25666,1,0,11,0,-11
25667,0,0,40,0,-40
25668,0,0,25,0,-25
25669,1,1,105,2083,1978
25670,1,1,1418,1550,132
25671,1,1,1265,1515,250
25672,0,0,53,0,-53
25673,0,0,1,0,-1
25674,0,0,75,0,-75
25675,1,1,761,1367,606
25676,0,0,31,0,-31
25677,1,1,677,1333,656
25678,1,0,18,0,-18
25679,1,1,271,1282,1011
25680,1,1,126,1779,1653
25681,0,0,37,0,-37
25682,1,1,754,1616,862
25683,0,0,51,0,-51
25684,0,0,5,0,-5
25685,1,0,29,0,-29
25686,1,1,568,1532,964
25687,1,0,25,0,-25
25688,0,0,84,0,-84
25689,0,0,52,0,-52
25690,1,0,34,0,-34
25691,1,1,1318,1668,350
25692,0,0,175,0,-175
25693,0,0,5,0,-5
25694,1,1,319,1356,1037
25695,1,1,580,1244,664
25696,1,1,466,1259,793
25697,0,0,53,0,-53
25698,1,1,246,1295,1049
25699,1,1,316,1248,932
25700,0,0,7,0,-7
25701,1,0,13,0,-13
25702,1,1,257,1255,998
25703,0,0,13,0,-13
25704,0,0,55,0,-55
25705,1,0,55,0,-55
25706,1,0,85,0,-85
25707,0,0,78,0,-78
25708,1,1,434,1287,853
25709,0,0,44,0,-44
25710,1,0,10,0,-10
25711,0,0,18,0,-18
25712,1,0,3,0,-3
25713,1,0,8,0,-8
25714,0,0,67,0,-67
25715,1,0,43,0,-43
25716,0,0,4,0,-4
25717,1,1,1155,3659,2504
25718,0,0,60,0,-60
25719,0,0,5,0,-5
25720,0,0,36,0,-36
25721,0,0,32,0,-32
25722,1,1,526,1260,734
25723,0,0,19,0,-19
25724,1,0,43,0,-43
25725,1,1,182,1840,1658
25726,1,0,52,0,-52
25727,1,0,7,0,-7
25728,1,1,743,1590,847
25729,1,0,3,0,-3
25730,1,0,29,0,-29
25731,0,0,31,0,-31
25732,0,0,18,0,-18
25733,0,0,34,0,-34
25734,1,0,3,0,-3
25735,0,0,46,0,-46
25736,0,0,35,0,-35
25737,1,0,31,0,-31
25738,1,1,193,1372,1179
25739,1,1,383,1367,984
25740,0,0,0,0,0
25741,1,1,945,1405,460
25742,0,0,3,0,-3
25743,1,1,374,2126,1752
25744,0,0,56,0,-56
25745,1,0,1,0,-1
25746,1,0,53,0,-53
25747,1,1,294,1711,1417
25748,1,1,1418,2222,804
25749,1,1,484,1585,1101
25750,0,0,39,0,-39
25751,1,0,1,0,-1
25752,1,0,65,0,-65
25753,1,0,37,0,-37
25754,0,0,47,0,-47
25755,1,1,396,1472,1076
25756,0,0,59,0,-59
25757,0,0,35,0,-35
25758,0,0,70,0,-70
25759,1,0,51,0,-51
25760,1,0,45,0,-45
25761,1,0,30,0,-30
25762,0,0,15,0,-15
25763,0,0,157,0,-157
25764,1,1,74,1291,1217
25765,1,1,408,1435,1027
25766,1,1,658,1260,602
25767,0,0,37,0,-37
25768,1,0,20,0,-20
25769,0,0,125,0,-125
25770,0,0,88,0,-88
25771,0,0,63,0,-63
25772,0,0,7,0,-7
25773,1,1,61,1495,1434
25774,1,1,302,2051,1749
25775,1,1,64,1922,1858
25776,1,1,199,2682,2483
25777,1,1,1112,1376,264
25778,0,0,170,0,-170
25779,1,1,514,1262,748
25780,1,0,177,0,-177
25781,1,0,11,0,-11
25782,1,0,15,0,-15
25783,1,0,127,0,-127
25784,1,1,517,2185,1668
25785,1,0,69,0,-69
25786,0,0,22,0,-22
25787,1,1,544,1306,762
25788,1,1,142,2066,1924
25789,1,0,3,0,-3
25790,0,0,24,0,-24
25791,0,0,7,0,-7
25792,1,1,282,1240,958
25793,1,1,24,1862,1838
25794,1,1,90,1307,1217
25795,1,1,100,1612,1512
25796,1,1,377,1317,940
25797,1,0,156,0,-156
25798,1,1,167,1467,1300
25799,0,0,158,0,-158
25800,0,0,54,0,-54
25801,0,0,33,0,-33
25802,1,1,699,2843,2144
25803,1,0,40,0,-40
25804,1,0,52,0,-52
25805,1,0,14,0,-14
25806,1,1,164,2303,2139
25807,0,0,40,0,-40
25808,0,0,27,0,-27
25809,1,0,95,0,-95
25810,1,0,13,0,-13
25811,1,1,302,2188,1886
25812,1,0,71,0,-71
25813,1,0,42,0,-42
25814,1,1,149,1447,1298
25815,0,0,17,0,-17
25816,1,0,53,0,-53
25817,0,0,164,0,-164
25818,1,1,378,1853,1475
25819,0,0,52,0,-52
25820,1,0,18,0,-18
25821,0,0,163,0,-163
25822,0,0,78,0,-78
25823,1,1,910,1680,770
25824,1,1,115,1466,1351
25825,1,1,586,1376,790
25826,1,0,136,0,-136
25827,0,0,26,0,-26
25828,0,0,74,0,-74
25829,1,1,112,1777,1665
25830,0,0,18,0,-18
25831,1,0,248,0,-248
25832,1,0,28,0,-28
25833,0,0,20,0,-20
25834,1,1,800,1995,1195
25835,1,1,346,1378,1032
25836,0,0,42,0,-42
25837,0,0,16,0,-16
25838,1,1,978,1441,463
25839,1,0,96,0,-96
25840,0,0,200,0,-200
25841,1,0,10,0,-10
25842,1,0,1,0,-1
25843,1,1,846,1389,543
25844,0,0,33,0,-33
25845,1,1,1447,1473,26
25846,1,0,162,0,-162
25847,0,0,19,0,-19
25848,1,0,45,0,-45
25849,1,0,8,0,-8
25850,0,0,15,0,-15
25851,1,1,318,1413,1095
25852,0,0,30,0,-30
25853,1,0,8,0,-8
25854,1,1,249,1536,1287
25855,1,1,160,1300,1140
25856,0,0,33,0,-33
25857,1,0,85,0,-85
25858,1,0,75,0,-75
25859,1,0,26,0,-26
25860,0,0,38,0,-38
25861,0,0,128,0,-128
25862,0,0,51,0,-51
25863,0,0,24,0,-24
25864,1,0,121,0,-121
25865,0,0,48,0,-48
25866,0,0,91,0,-91
25867,1,0,81,0,-81
25868,1,1,421,2771,2350
25869,1,0,55,0,-55
25870,0,0,3,0,-3
25871,1,1,111,1721,1610
25872,0,0,0,0,0
25873,0,0,82,0,-82
25874,0,0,4,0,-4
25875,0,0,86,0,-86
25876,1,0,94,0,-94
25877,1,0,5,0,-5
25878,1,0,15,0,-15
25879,0,0,27,0,-27
25880,0,0,0,0,0
25881,0,0,9,0,-9
25882,0,0,7,0,-7
25883,0,0,183,0,-183
25884,1,1,319,1797,1478
25885,1,0,24,0,-24
25886,1,0,64,0,-64
25887,0,0,20,0,-20
25888,1,1,4163,1451,-2712
25889,0,0,15,0,-15
25890,1,1,70,1365,1295
25891,0,0,5,0,-5
25892,0,0,28,0,-28
25893,1,0,54,0,-54
25894,0,0,83,0,-83
25895,0,0,197,0,-197
25896,1,1,1456,1855,399
25897,1,0,24,0,-24
25898,1,0,2,0,-2
25899,1,0,40,0,-40
25900,1,1,736,2204,1468
25901,1,1,1068,1362,294
25902,0,0,31,0,-31
25903,1,0,83,0,-83
25904,1,0,25,0,-25
25905,1,1,135,1338,1203
25906,0,0,62,0,-62
25907,1,1,164,1594,1430
25908,1,1,549,1355,806
25909,1,1,191,1254,1063
25910,0,0,16,0,-16
25911,1,0,8,0,-8
25912,1,1,501,1328,827
25913,1,1,230,1472,1242
25914,1,1,598,1516,918
25915,1,1,573,1290,717
25916,0,0,12,0,-12
25917,1,1,482,3650,3168
25918,0,0,178,0,-178
25919,1,1,222,1577,1355
25920,1,1,207,1493,1286
25921,1,0,122,0,-122
25922,1,1,523,1265,742
25923,1,0,89,0,-89
25924,1,1,431,1338,907
25925,1,0,32,0,-32
25926,1,0,211,0,-211
25927,1,1,342,1582,1240
25928,0,0,61,0,-61
25929,1,1,333,1268,935
25930,1,1,1579,1367,-212
25931,1,0,13,0,-13
25932,1,0,51,0,-51
25933,0,0,116,0,-116
25934,1,0,21,0,-21
25935,1,0,39,0,-39
25936,1,1,224,1309,1085
25937,1,0,37,0,-37
25938,0,0,9,0,-9
25939,1,1,638,1483,845
25940,1,0,123,0,-123
25941,0,0,89,0,-89
25942,0,0,19,0,-19
25943,1,0,2,0,-2
25944,1,0,86,0,-86
25945,0,0,27,0,-27
25946,1,1,244,1275,1031
25947,1,0,30,0,-30
25948,1,0,36,0,-36
25949,0,0,19,0,-19
25950,1,0,20,0,-20
25951,0,0,33,0,-33
25952,0,0,58,0,-58
25953,1,0,93,0,-93
25954,0,0,7,0,-7
25955,1,1,1098,1453,355
25956,1,0,28,0,-28
25957,0,0,58,0,-58
25958,0,0,35,0,-35
25959,0,0,26,0,-26
25960,1,1,204,3490,3286
25961,0,0,13,0,-13
25962,0,0,61,0,-61
25963,1,0,21,0,-21
25964,0,0,37,0,-37
25965,1,0,159,0,-159
25966,0,0,89,0,-89
25967,1,0,26,0,-26
25968,0,0,91,0,-91
25969,0,0,67,0,-67
25970,1,0,99,0,-99
25971,0,0,61,0,-61
25972,1,0,2,0,-2
25973,1,0,57,0,-57
25974,1,0,159,0,-159
25975,0,0,26,0,-26
25976,1,1,193,1482,1289
25977,1,1,273,1260,987
25978,1,0,13,0,-13
25979,0,0,41,0,-41
25980,0,0,99,0,-99
25981,0,0,27,0,-27
25982,1,1,300,1658,1358
25983,1,0,145,0,-145
25984,0,0,25,0,-25
25985,1,0,16,0,-16
25986,1,0,88,0,-88
25987,0,0,38,0,-38
25988,1,0,55,0,-55
25989,1,0,52,0,-52
25990,1,0,1,0,-1
25991,0,0,13,0,-13
25992,0,0,6,0,-6
25993,0,0,35,0,-35
25994,1,1,282,2085,1803
25995,1,0,36,0,-36
25996,1,1,1102,2170,1068
25997,0,0,60,0,-60
25998,1,1,388,1249,861
25999,1,1,114,1747,1633
26000,1,0,12,0,-12
26001,1,1,226,1474,1248
26002,0,0,140,0,-140
26003,1,0,5,0,-5
26004,0,0,37,0,-37
26005,0,0,9,0,-9
26006,1,0,15,0,-15
26007,1,0,0,0,0
26008,1,0,28,0,-28
26009,1,0,70,0,-70
26010,0,0,144,0,-144
26011,0,0,62,0,-62
26012,1,1,47,1780,1733
26013,1,1,170,1517,1347
26014,1,1,1380,2178,798
26015,0,0,33,0,-33
26016,1,1,187,1331,1144
26017,0,0,3,0,-3
26018,1,0,24,0,-24
26019,0,0,32,0,-32
26020,0,0,2,0,-2
26021,1,1,669,1727,1058
26022,1,0,25,0,-25
26023,0,0,148,0,-148
26024,1,0,49,0,-49
26025,0,0,17,0,-17
26026,1,1,113,1357,1244
26027,1,1,1203,1520,317
26028,0,0,68,0,-68
26029,0,0,61,0,-61
26030,1,0,11,0,-11
26031,1,1,365,1765,1400
26032,1,1,2665,1949,-716
26033,1,1,482,1302,820
26034,1,0,9,0,-9
26035,0,0,38,0,-38
26036,1,0,52,0,-52
26037,1,0,58,0,-58
26038,1,0,18,0,-18
26039,1,0,6,0,-6
26040,1,1,667,1251,584
26041,1,0,43,0,-43
26042,1,1,222,1780,1558
26043,1,1,105,1501,1396
26044,1,0,10,0,-10
26045,1,0,23,0,-23
26046,0,0,75,0,-75
26047,1,1,479,1854,1375
26048,0,0,26,0,-26
26049,0,0,1,0,-1
26050,1,0,1,0,-1
26051,1,0,7,0,-7
26052,1,0,96,0,-96
26053,1,1,2602,1395,-1207
26054,0,0,36,0,-36
26055,1,0,10,0,-10
26056,1,0,20,0,-20
26057,0,0,36,0,-36
26058,0,0,23,0,-23
26059,0,0,8,0,-8
26060,1,1,908,1239,331
26061,1,1,191,1644,1453
26062,0,0,24,0,-24
26063,1,0,0,0,0
26064,0,0,49,0,-49
26065,1,1,69,2350,2281
26066,1,0,22,0,-22
26067,0,0,10,0,-10
26068,0,0,49,0,-49
26069,1,0,16,0,-16
26070,0,0,9,0,-9
26071,0,0,15,0,-15
26072,0,0,7,0,-7
26073,1,1,470,1400,930
26074,0,0,33,0,-33
26075,1,0,39,0,-39
26076,0,0,35,0,-35
26077,1,0,33,0,-33
26078,0,0,44,0,-44
26079,1,0,5,0,-5
26080,1,0,59,0,-59
26081,0,0,3,0,-3
26082,0,0,223,0,-223
26083,1,1,749,1540,791
26084,1,1,249,1700,1451
26085,1,0,8,0,-8
26086,0,0,1,0,-1
26087,1,0,33,0,-33
26088,1,1,23,1525,1502
26089,1,0,10,0,-10
26090,0,0,22,0,-22
26091,0,0,37,0,-37
26092,0,0,14,0,-14
26093,0,0,29,0,-29
26094,1,0,22,0,-22
26095,1,0,111,0,-111
26096,1,0,27,0,-27
26097,1,0,97,0,-97
26098,1,1,599,1276,677
26099,1,0,51,0,-51
26100,0,0,71,0,-71
26101,1,1,498,2288,1790
26102,1,0,3,0,-3
26103,0,0,69,0,-69
26104,1,1,33,2727,2694
26105,0,0,18,0,-18
26106,0,0,48,0,-48
26107,1,0,66,0,-66
26108,1,1,1044,1346,302
26109,0,0,44,0,-44
26110,0,0,14,0,-14
26111,0,0,24,0,-24
26112,0,0,7,0,-7
26113,0,0,13,0,-13
26114,1,0,125,0,-125
26115,0,0,12,0,-12
26116,0,0,9,0,-9
26117,1,0,14,0,-14
26118,1,1,1008,1673,665
26119,1,0,39,0,-39
26120,0,0,10,0,-10
26121,1,1,912,1526,614
26122,0,0,75,0,-75
26123,0,0,49,0,-49
26124,0,0,40,0,-40
26125,1,0,124,0,-124
26126,1,1,410,2929,2519
26127,1,0,1,0,-1
26128,0,0,124,0,-124
26129,1,0,24,0,-24
26130,1,0,73,0,-73
26131,1,0,6,0,-6
26132,1,1,1163,1261,98
26133,1,1,76,1440,1364
26134,1,0,29,0,-29
26135,1,1,104,1384,1280
26136,0,0,11,0,-11
26137,0,0,22,0,-22
26138,0,0,46,0,-46
26139,1,0,158,0,-158
26140,1,1,88,1383,1295
26141,1,0,18,0,-18
26142,1,0,94,0,-94
26143,1,0,17,0,-17
26144,1,1,818,1281,463
26145,1,1,475,1258,783
26146,0,0,28,0,-28
26147,1,0,86,0,-86
26148,1,0,106,0,-106
26149,1,0,33,0,-33
26150,1,0,86,0,-86
26151,1,0,45,0,-45
26152,1,1,201,1361,1160
26153,1,0,28,0,-28
26154,0,0,44,0,-44
26155,1,1,280,1820,1540
26156,1,1,993,1356,363
26157,0,0,8,0,-8
26158,0,0,69,0,-69
26159,1,0,15,0,-15
26160,1,0,26,0,-26
26161,0,0,27,0,-27
26162,1,0,12,0,-12
26163,1,1,1481,2800,1319
26164,0,0,8,0,-8
26165,1,1,593,2573,1980
26166,1,0,2,0,-2
26167,1,0,90,0,-90
26168,1,1,120,1540,1420
26169,1,0,36,0,-36
26170,1,0,43,0,-43
26171,0,0,46,0,-46
26172,1,0,0,0,0
26173,0,0,68,0,-68
26174,0,0,11,0,-11
26175,1,0,49,0,-49
26176,0,0,51,0,-51
26177,0,0,155,0,-155
26178,1,0,33,0,-33
26179,0,0,34,0,-34
26180,1,1,974,1444,470
26181,0,0,43,0,-43
26182,1,0,86,0,-86
26183,1,0,29,0,-29
26184,1,1,121,1538,1417
26185,0,0,1,0,-1
26186,1,0,6,0,-6
26187,1,0,26,0,-26
26188,1,1,59,1254,1195
26189,0,0,30,0,-30
26190,1,0,11,0,-11
26191,0,0,44,0,-44
26192,0,0,76,0,-76
26193,1,1,504,1399,895
26194,0,0,16,0,-16
26195,1,0,35,0,-35
26196,0,0,182,0,-182
26197,0,0,33,0,-33
26198,1,1,894,2540,1646
26199,1,0,11,0,-11
26200,0,0,14,0,-14
26201,1,0,62,0,-62
26202,1,1,601,1333,732
26203,1,0,85,0,-85
26204,1,0,33,0,-33
26205,0,0,94,0,-94
26206,1,0,15,0,-15
26207,0,0,144,0,-144
26208,1,0,40,0,-40
26209,1,0,27,0,-27
26210,1,1,188,1545,1357
26211,1,0,148,0,-148
26212,1,1,97,1369,1272
26213,1,1,587,1524,937
26214,1,1,394,1253,859
26215,1,1,2242,1308,-934
26216,1,0,76,0,-76
26217,1,0,12,0,-12
26218,0,0,203,0,-203
26219,0,0,12,0,-12
26220,0,0,39,0,-39
26221,1,0,19,0,-19
26222,1,0,11,0,-11
26223,1,0,179,0,-179
26224,1,0,51,0,-51
26225,0,0,13,0,-13
26226,0,0,33,0,-33
26227,0,0,4,0,-4
26228,1,1,622,2503,1881
26229,0,0,28,0,-28
26230,1,1,659,2466,1807
26231,0,0,47,0,-47
26232,1,0,19,0,-19
26233,0,0,1,0,-1
26234,1,1,1165,2085,920
26235,1,1,234,1584,1350
26236,0,0,10,0,-10
26237,0,0,90,0,-90
26238,1,1,356,1925,1569
26239,1,0,18,0,-18
26240,0,0,80,0,-80
26241,1,0,18,0,-18
26242,0,0,191,0,-191
26243,1,1,815,1332,517
26244,1,1,149,2089,1940
26245,1,0,53,0,-53
26246,1,1,626,1426,800
26247,1,0,40,0,-40
26248,1,0,8,0,-8
26249,1,1,733,3397,2664
26250,0,0,7,0,-7
26251,1,0,27,0,-27
26252,0,0,5,0,-5
26253,1,1,374,1414,1040
26254,1,0,121,0,-121
26255,0,0,114,0,-114
26256,0,0,33,0,-33
26257,1,0,50,0,-50
26258,1,1,51,1386,1335
26259,1,0,29,0,-29
26260,1,0,38,0,-38
26261,0,0,36,0,-36
26262,0,0,0,0,0
26263,0,0,46,0,-46
26264,1,1,408,1251,843
26265,0,0,42,0,-42
26266,1,1,273,2071,1798
26267,1,1,550,2104,1554
26268,0,0,89,0,-89
26269,1,0,50,0,-50
26270,1,1,151,1308,1157
26271,1,0,73,0,-73
26272,1,0,87,0,-87
26273,1,1,699,1239,540
26274,1,1,1952,1524,-428
26275,1,1,398,1385,987
26276,0,0,135,0,-135
26277,0,0,39,0,-39
26278,1,1,212,1273,1061
26279,1,1,2258,1235,-1023
26280,0,0,54,0,-54
26281,0,0,4,0,-4
26282,1,0,20,0,-20
26283,1,0,109,0,-109
26284,1,0,118,0,-118
26285,1,0,124,0,-124
26286,0,0,9,0,-9
26287,1,1,378,1547,1169
26288,1,1,496,1360,864
26289,0,0,122,0,-122
26290,1,0,212,0,-212
26291,0,0,25,0,-25
26292,1,1,552,1246,694
26293,0,0,10,0,-10
26294,0,0,6,0,-6
26295,0,0,21,0,-21
26296,1,1,311,1556,1245
26297,1,0,51,0,-51
26298,1,0,27,0,-27
26299,1,0,3,0,-3
26300,1,1,389,1250,861
26301,1,0,134,0,-134
26302,1,1,204,1770,1566
26303,0,0,46,0,-46
26304,1,0,36,0,-36
26305,0,0,50,0,-50
26306,0,0,15,0,-15
26307,1,1,295,1276,981
26308,0,0,13,0,-13
26309,1,1,201,1330,1129
26310,0,0,100,0,-100
26311,0,0,21,0,-21
26312,0,0,3,0,-3
26313,0,0,113,0,-113
26314,1,1,331,6215,5884
26315,1,0,239,0,-239
26316,1,0,26,0,-26
26317,1,0,13,0,-13
26318,0,0,26,0,-26
26319,1,0,82,0,-82
26320,1,0,25,0,-25
26321,0,0,43,0,-43
26322,1,1,626,1792,1166
26323,1,0,39,0,-39
26324,0,0,12,0,-12
26325,0,0,143,0,-143
26326,1,1,962,1255,293
26327,1,1,511,1485,974
26328,1,1,673,1411,738
26329,1,0,9,0,-9
26330,1,0,89,0,-89
26331,0,0,114,0,-114
26332,0,0,42,0,-42
26333,1,0,25,0,-25
26334,1,1,1083,1258,175
26335,1,0,36,0,-36
26336,1,1,595,1810,1215
26337,1,0,48,0,-48
26338,1,0,10,0,-10
26339,0,0,16,0,-16
26340,1,0,12,0,-12
26341,0,0,58,0,-58
26342,0,0,60,0,-60
26343,0,0,107,0,-107
26344,1,0,1,0,-1
26345,1,0,0,0,0
26346,0,0,171,0,-171
26347,0,0,5,0,-5
26348,1,0,23,0,-23
26349,1,1,867,1295,428
26350,1,1,50,1555,1505
26351,0,0,70,0,-70
26352,1,1,76,1752,1676
26353,1,0,56,0,-56
26354,1,0,291,0,-291
26355,0,0,19,0,-19
26356,1,1,934,1275,341
26357,1,1,498,2075,1577
26358,1,1,2550,1529,-1021
26359,1,1,1279,1431,152
26360,0,0,2,0,-2
26361,1,1,53,1689,1636
26362,1,1,180,1851,1671
26363,1,0,40,0,-40
26364,0,0,39,0,-39
26365,0,0,45,0,-45
26366,1,1,401,1258,857
26367,0,0,208,0,-208
26368,0,0,20,0,-20
26369,1,1,90,1252,1162
26370,0,0,4,0,-4
26371,1,1,1331,1645,314
26372,0,0,16,0,-16
26373,1,0,14,0,-14
26374,1,0,79,0,-79
26375,1,1,127,1857,1730
26376,1,1,176,1386,1210
26377,0,0,49,0,-49
26378,0,0,76,0,-76
26379,1,1,1055,1367,312
26380,1,1,1157,2241,1084
26381,1,0,62,0,-62
26382,0,0,42,0,-42
26383,0,0,34,0,-34
26384,1,0,81,0,-81
26385,1,0,12,0,-12
26386,0,0,62,0,-62
26387,0,0,5,0,-5
26388,1,0,72,0,-72
26389,0,0,83,0,-83
26390,1,1,515,1262,747
26391,0,0,52,0,-52
26392,1,0,134,0,-134
26393,1,1,1143,1436,293
26394,1,0,5,0,-5
26395,1,1,950,1472,522
26396,1,1,446,1289,843
26397,0,0,103,0,-103
26398,1,0,12,0,-12
26399,1,1,908,2064,1156
26400,1,0,23,0,-23
26401,1,0,166,0,-166
26402,1,0,83,0,-83
26403,0,0,26,0,-26
26404,1,0,6,0,-6
26405,0,0,64,0,-64
26406,1,1,110,1275,1165
26407,1,0,14,0,-14
26408,0,0,265,0,-265
26409,1,0,20,0,-20
26410,1,0,61,0,-61
26411,0,0,18,0,-18
26412,1,0,46,0,-46
26413,1,0,10,0,-10
26414,1,1,534,1513,979
26415,1,0,184,0,-184
26416,0,0,17,0,-17
26417,1,1,568,1640,1072
26418,1,0,15,0,-15
26419,1,1,441,1289,848
26420,0,0,117,0,-117
26421,1,1,55,1333,1278
26422,0,0,136,0,-136
26423,0,0,22,0,-22
26424,0,0,42,0,-42
26425,0,0,8,0,-8
26426,1,0,129,0,-129
26427,1,1,211,1971,1760
26428,1,1,756,1696,940
26429,1,0,7,0,-7
26430,1,0,26,0,-26
26431,0,0,2,0,-2
26432,0,0,42,0,-42
26433,0,0,87,0,-87
26434,1,1,901,1740,839
26435,0,0,43,0,-43
26436,1,0,91,0,-91
26437,0,0,65,0,-65
26438,1,0,35,0,-35
26439,0,0,26,0,-26
26440,1,1,583,1849,1266
26441,0,0,54,0,-54
26442,0,0,17,0,-17
26443,0,0,1,0,-1
26444,1,0,26,0,-26
26445,1,0,11,0,-11
26446,0,0,44,0,-44
26447,0,0,9,0,-9
26448,1,0,19,0,-19
26449,0,0,57,0,-57
26450,1,0,74,0,-74
26451,1,0,31,0,-31
26452,0,0,59,0,-59
26453,0,0,34,0,-34
26454,1,1,1806,1359,-447
26455,1,0,47,0,-47
26456,1,1,209,1250,1041
26457,0,0,71,0,-71
26458,1,1,217,2568,2351
26459,1,1,315,1465,1150
26460,1,1,39,1291,1252
26461,1,1,413,3429,3016
26462,0,0,6,0,-6
26463,1,0,4,0,-4
26464,1,0,11,0,-11
26465,0,0,4,0,-4
26466,0,0,276,0,-276
26467,0,0,54,0,-54
26468,0,0,24,0,-24
26469,1,0,28,0,-28
26470,0,0,0,0,0
26471,0,0,168,0,-168
26472,1,1,382,1731,1349
26473,1,0,37,0,-37
26474,0,0,23,0,-23
26475,0,0,43,0,-43
26476,0,0,17,0,-17
26477,1,1,371,1671,1300
26478,1,0,71,0,-71
26479,1,0,0,0,0
26480,1,0,87,0,-87
26481,1,1,121,1369,1248
26482,1,0,160,0,-160
26483,1,0,35,0,-35
26484,1,0,51,0,-51
26485,0,0,71,0,-71
26486,0,0,29,0,-29
26487,0,0,76,0,-76
26488,1,1,838,1485,647
26489,1,1,337,1289,952
26490,0,0,22,0,-22
26491,0,0,16,0,-16
26492,1,0,5,0,-5
26493,0,0,165,0,-165
26494,1,1,551,1362,811
26495,0,0,113,0,-113
26496,0,0,27,0,-27
26497,1,1,286,1373,1087
26498,0,0,78,0,-78
26499,1,0,84,0,-84
26500,0,0,118,0,-118
26501,1,1,378,3984,3606
26502,1,0,138,0,-138
26503,1,0,77,0,-77
26504,1,0,83,0,-83
26505,1,1,152,1340,1188
26506,0,0,36,0,-36
26507,1,1,1195,2237,1042
26508,1,1,129,1737,1608
26509,0,0,31,0,-31
26510,1,0,10,0,-10
26511,0,0,131,0,-131
26512,1,1,1991,1284,-707
26513,1,0,110,0,-110
26514,1,0,31,0,-31
26515,1,0,105,0,-105
26516,0,0,35,0,-35
26517,1,0,98,0,-98
26518,0,0,3,0,-3
26519,1,1,440,1405,965
26520,0,0,6,0,-6
26521,1,1,1223,1424,201
26522,0,0,3,0,-3
26523,1,1,60,2059,1999
26524,1,1,57,2047,1990
26525,1,1,500,1563,1063
26526,1,1,119,1504,1385
26527,1,0,30,0,-30
26528,1,1,858,1260,402
26529,1,1,458,1393,935
26530,0,0,11,0,-11
26531,1,1,927,1353,426
26532,1,1,2949,1300,-1649
26533,1,0,94,0,-94
26534,1,1,731,2086,1355
26535,0,0,7,0,-7
26536,1,0,5,0,-5
26537,0,0,81,0,-81
26538,0,0,10,0,-10
26539,0,0,138,0,-138
26540,1,1,477,1452,975
26541,1,0,2,0,-2
26542,0,0,41,0,-41
26543,1,0,211,0,-211
26544,0,0,9,0,-9
26545,0,0,3,0,-3
26546,1,0,17,0,-17
26547,1,1,550,1304,754
26548,1,1,1158,1349,191
26549,0,0,2,0,-2
26550,0,0,13,0,-13
26551,1,0,70,0,-70
26552,0,0,84,0,-84
26553,0,0,5,0,-5
26554,0,0,90,0,-90
26555,0,0,45,0,-45
26556,0,0,28,0,-28
26557,1,0,23,0,-23
26558,1,0,33,0,-33
26559,1,1,29,1440,1411
26560,1,0,7,0,-7
26561,1,0,1,0,-1
26562,1,0,136,0,-136
26563,1,1,1731,1562,-169
26564,1,1,1369,1398,29
26565,1,0,9,0,-9
26566,0,0,182,0,-182
26567,1,1,285,1482,1197
26568,1,0,28,0,-28
26569,1,0,241,0,-241
26570,1,0,57,0,-57
26571,1,0,17,0,-17
26572,0,0,51,0,-51
26573,1,0,13,0,-13
26574,0,0,19,0,-19
26575,1,0,93,0,-93
26576,0,0,22,0,-22
26577,1,0,9,0,-9
26578,0,0,38,0,-38
26579,0,0,32,0,-32
26580,0,0,54,0,-54
26581,1,1,138,1801,1663
26582,1,0,71,0,-71
26583,1,1,323,1331,1008
26584,0,0,42,0,-42
26585,0,0,22,0,-22
26586,0,0,3,0,-3
26587,1,0,0,0,0
26588,1,1,1537,1450,-87
26589,1,1,602,2925,2323
26590,1,0,163,0,-163
26591,0,0,97,0,-97
26592,0,0,271,0,-271
26593,0,0,20,0,-20
26594,0,0,104,0,-104
26595,1,1,216,2622,2406
26596,0,0,131,0,-131
26597,1,0,25,0,-25
26598,0,0,7,0,-7
26599,0,0,41,0,-41
26600,1,1,114,1424,1310
26601,0,0,52,0,-52
26602,0,0,76,0,-76
26603,1,0,97,0,-97
26604,1,0,9,0,-9
26605,0,0,28,0,-28
26606,0,0,13,0,-13
26607,1,0,18,0,-18
26608,1,0,13,0,-13
26609,1,0,105,0,-105
26610,1,0,18,0,-18
26611,1,0,82,0,-82
26612,1,0,14,0,-14
26613,1,0,0,0,0
26614,1,0,85,0,-85
26615,1,1,259,1390,1131
26616,1,1,308,2259,1951
26617,0,0,98,0,-98
26618,1,1,1027,1319,292
26619,1,0,43,0,-43
26620,1,0,98,0,-98
26621,0,0,30,0,-30
26622,1,1,409,2188,1779
26623,1,0,34,0,-34
26624,1,1,247,2233,1986
26625,0,0,115,0,-115
26626,1,1,676,3015,2339
26627,1,0,37,0,-37
26628,1,1,220,1829,1609
26629,1,0,45,0,-45
26630,1,1,750,1700,950
26631,1,1,543,2374,1831
26632,1,0,21,0,-21
26633,0,0,71,0,-71
26634,1,0,135,0,-135
26635,0,0,70,0,-70
26636,0,0,6,0,-6
26637,0,0,66,0,-66
26638,0,0,53,0,-53
26639,0,0,29,0,-29
26640,1,1,302,1370,1068
26641,1,1,322,1749,1427
26642,1,0,13,0,-13
26643,1,0,49,0,-49
26644,1,0,75,0,-75
26645,0,0,149,0,-149
26646,0,0,214,0,-214
26647,1,0,45,0,-45
26648,1,0,12,0,-12
26649,0,0,13,0,-13
26650,0,0,31,0,-31
26651,1,0,2,0,-2
26652,0,0,161,0,-161
26653,1,1,270,1666,1396
26654,0,0,11,0,-11
26655,1,0,23,0,-23
26656,1,0,8,0,-8
26657,0,0,119,0,-119
26658,0,0,204,0,-204
26659,0,0,39,0,-39
26660,1,0,31,0,-31
26661,1,0,21,0,-21
26662,0,0,26,0,-26
26663,1,0,14,0,-14
26664,1,0,17,0,-17
26665,1,0,82,0,-82
26666,1,1,212,1241,1029
26667,1,1,117,1362,1245
26668,1,1,1257,1247,-10
26669,1,0,2,0,-2
26670,0,0,123,0,-123
26671,0,0,47,0,-47
26672,1,1,261,1449,1188
26673,1,0,9,0,-9
26674,0,0,18,0,-18
26675,1,0,86,0,-86
26676,1,1,8,1550,1542
26677,1,1,177,1381,1204
26678,0,0,17,0,-17
26679,1,1,1040,1455,415
26680,1,1,335,1345,1010
26681,0,0,42,0,-42
26682,1,1,661,1374,713
26683,1,0,37,0,-37
26684,1,1,952,1248,296
26685,0,0,117,0,-117
26686,0,0,7,0,-7
26687,1,0,62,0,-62
26688,0,0,18,0,-18
26689,0,0,75,0,-75
26690,1,1,269,1532,1263
26691,0,0,23,0,-23
26692,0,0,74,0,-74
26693,0,0,41,0,-41
26694,1,1,307,1353,1046
26695,1,0,6,0,-6
26696,1,1,2230,1412,-818
26697,1,0,4,0,-4
26698,0,0,82,0,-82
26699,0,0,17,0,-17
26700,0,0,13,0,-13
26701,1,1,68,1393,1325
26702,0,0,49,0,-49
26703,0,0,68,0,-68
26704,1,1,365,1603,1238
26705,0,0,233,0,-233
26706,1,1,516,1338,822
26707,1,1,41,1569,1528
26708,1,1,2830,2645,-185
26709,1,1,460,1272,812
26710,1,0,61,0,-61
26711,1,1,177,1345,1168
26712,1,1,1941,1435,-506
26713,1,1,64,1471,1407
26714,1,1,231,1265,1034
26715,0,0,123,0,-123
26716,1,0,31,0,-31
26717,0,0,31,0,-31
26718,0,0,36,0,-36
26719,1,1,1643,1621,-22
26720,1,0,61,0,-61
26721,1,0,85,0,-85
26722,1,1,368,1353,985
26723,0,0,12,0,-12
26724,1,0,23,0,-23
26725,1,1,90,1334,1244
26726,1,0,228,0,-228
26727,0,0,34,0,-34
26728,0,0,24,0,-24
26729,1,1,716,1605,889
26730,0,0,8,0,-8
26731,0,0,8,0,-8
26732,1,0,42,0,-42
26733,1,1,1009,1495,486
26734,0,0,87,0,-87
26735,1,1,600,1413,813
26736,0,0,24,0,-24
26737,1,1,871,1322,451
26738,1,0,35,0,-35
26739,1,1,85,1394,1309
26740,1,1,54,1490,1436
26741,1,0,131,0,-131
26742,1,0,32,0,-32
26743,1,1,254,1925,1671
26744,1,0,15,0,-15
26745,0,0,132,0,-132
26746,0,0,43,0,-43
26747,0,0,44,0,-44
26748,1,0,70,0,-70
26749,0,0,24,0,-24
26750,0,0,96,0,-96
26751,1,0,48,0,-48
26752,0,0,14,0,-14
26753,0,0,68,0,-68
26754,1,1,663,2125,1462
26755,1,0,36,0,-36
26756,1,0,111,0,-111
26757,1,0,112,0,-112
26758,1,1,465,1446,981
26759,0,0,19,0,-19
26760,1,0,22,0,-22
26761,0,0,23,0,-23
26762,1,0,20,0,-20
26763,1,0,14,0,-14
26764,0,0,17,0,-17
26765,1,1,432,1330,898
26766,1,1,14,1290,1276
26767,0,0,18,0,-18
26768,1,1,260,1273,1013
26769,1,1,55,1503,1448
26770,1,0,45,0,-45
26771,1,1,143,1628,1485
26772,0,0,0,0,0
26773,0,0,29,0,-29
26774,0,0,40,0,-40
26775,0,0,28,0,-28
26776,0,0,6,0,-6
26777,1,0,47,0,-47
26778,0,0,29,0,-29
26779,0,0,29,0,-29
26780,0,0,50,0,-50
26781,1,1,1246,2891,1645
26782,1,0,87,0,-87
26783,0,0,10,0,-10
26784,1,0,52,0,-52
26785,1,1,766,1339,573
26786,1,1,1945,1490,-455
26787,1,1,463,3810,3347
26788,1,1,344,1401,1057
26789,1,0,63,0,-63
26790,1,1,3240,1898,-1342
26791,1,1,1257,1532,275
26792,0,0,8,0,-8
26793,1,0,154,0,-154
26794,0,0,4,0,-4
26795,1,0,79,0,-79
26796,0,0,26,0,-26
26797,1,1,394,1503,1109
26798,1,0,61,0,-61
26799,0,0,16,0,-16
26800,1,0,38,0,-38
26801,0,0,59,0,-59
26802,1,1,57,3213,3156
26803,0,0,55,0,-55
26804,0,0,135,0,-135
26805,1,0,63,0,-63
26806,1,0,126,0,-126
26807,1,0,4,0,-4
26808,1,0,214,0,-214
26809,1,1,280,3099,2819
26810,1,1,106,1320,1214
26811,1,0,33,0,-33
26812,0,0,5,0,-5
26813,0,0,27,0,-27
26814,1,1,51,1257,1206
26815,1,0,89,0,-89
26816,1,1,459,1581,1122
26817,1,0,103,0,-103
26818,1,0,5,0,-5
26819,0,0,25,0,-25
26820,1,0,16,0,-16
26821,0,0,64,0,-64
26822,0,0,41,0,-41
26823,1,0,17,0,-17
26824,0,0,18,0,-18
26825,0,0,8,0,-8
26826,1,1,1099,1528,429
26827,1,1,39,1301,1262
26828,1,1,494,1321,827
26829,1,1,209,1250,1041
26830,1,1,191,1238,1047
26831,1,1,460,1330,870
26832,1,1,568,1253,685
26833,1,1,964,1625,661
26834,1,0,16,0,-16
26835,0,0,2,0,-2
26836,0,0,106,0,-106
26837,1,1,233,1779,1546
26838,1,0,101,0,-101
26839,1,0,17,0,-17
26840,1,0,3,0,-3
26841,0,0,2,0,-2
26842,1,1,2660,1303,-1357
26843,1,0,19,0,-19
26844,1,0,77,0,-77
26845,1,1,317,1738,1421
26846,1,1,1061,1783,722
26847,0,0,22,0,-22
26848,0,0,53,0,-53
26849,1,1,437,1713,1276
26850,1,0,24,0,-24
26851,0,0,3,0,-3
26852,1,1,121,2419,2298
26853,1,1,175,1451,1276
26854,0,0,54,0,-54
26855,0,0,85,0,-85
26856,0,0,8,0,-8
26857,1,1,587,1606,1019
26858,0,0,10,0,-10
26859,0,0,43,0,-43
26860,1,1,604,1721,1117
26861,0,0,52,0,-52
26862,1,1,371,1843,1472
26863,0,0,64,0,-64
26864,0,0,19,0,-19
26865,0,0,138,0,-138
26866,0,0,68,0,-68
26867,0,0,21,0,-21
26868,0,0,67,0,-67
26869,0,0,34,0,-34
26870,1,0,24,0,-24
26871,1,1,1056,1245,189
26872,0,0,94,0,-94
26873,1,1,36,1481,1445
26874,1,0,7,0,-7
26875,1,0,137,0,-137
26876,1,1,133,2632,2499
26877,1,0,27,0,-27
26878,0,0,21,0,-21
26879,1,1,676,1290,614
26880,1,0,2,0,-2
26881,1,0,74,0,-74
26882,1,0,0,0,0
26883,1,0,5,0,-5
26884,0,0,2,0,-2
26885,0,0,18,0,-18
26886,1,0,8,0,-8
26887,1,0,64,0,-64
26888,0,0,32,0,-32
26889,1,1,376,1964,1588
26890,1,0,30,0,-30
26891,1,1,316,2946,2630
26892,1,1,111,1661,1550
26893,1,0,1,0,-1
26894,0,0,68,0,-68
26895,0,0,5,0,-5
26896,0,0,22,0,-22
26897,1,0,114,0,-114
26898,1,1,624,4980,4356
26899,1,0,2,0,-2
26900,1,0,124,0,-124
26901,0,0,93,0,-93
26902,0,0,46,0,-46
26903,1,1,1606,1573,-33
26904,1,0,4,0,-4
26905,0,0,56,0,-56
26906,1,0,41,0,-41
26907,1,1,2651,1264,-1387
26908,0,0,44,0,-44
26909,1,0,17,0,-17
26910,1,1,503,1569,1066
26911,0,0,90,0,-90
26912,0,0,46,0,-46
26913,1,1,1639,1408,-231
26914,0,0,84,0,-84
26915,0,0,55,0,-55
26916,1,0,8,0,-8
26917,0,0,33,0,-33
26918,0,0,27,0,-27
26919,1,1,523,1306,783
26920,0,0,52,0,-52
26921,1,1,411,1458,1047
26922,1,1,971,1261,290
26923,0,0,48,0,-48
26924,1,0,67,0,-67
26925,0,0,45,0,-45
26926,1,1,571,1353,782
26927,0,0,179,0,-179
26928,1,1,105,1745,1640
26929,1,0,22,0,-22
26930,1,0,16,0,-16
26931,0,0,72,0,-72
26932,0,0,182,0,-182
26933,1,0,17,0,-17
26934,0,0,20,0,-20
26935,0,0,50,0,-50
26936,1,1,924,1519,595
26937,0,0,11,0,-11
26938,1,1,677,1404,727
26939,0,0,21,0,-21
26940,0,0,178,0,-178
26941,1,0,88,0,-88
26942,1,1,185,1658,1473
26943,1,0,105,0,-105
26944,1,1,352,1478,1126
26945,0,0,4,0,-4
26946,1,1,127,2130,2003
26947,0,0,148,0,-148
26948,1,0,39,0,-39
26949,1,1,331,1494,1163
26950,0,0,45,0,-45
26951,1,0,35,0,-35
26952,1,1,530,1291,761
26953,1,1,317,1488,1171
26954,1,0,15,0,-15
26955,1,0,22,0,-22
26956,1,1,368,1310,942
26957,0,0,9,0,-9
26958,0,0,26,0,-26
26959,0,0,47,0,-47
26960,1,1,735,1434,699
26961,0,0,6,0,-6
26962,0,0,89,0,-89
26963,1,0,43,0,-43
26964,1,0,29,0,-29
26965,0,0,31,0,-31
26966,1,1,1481,1788,307
26967,1,1,585,1630,1045
26968,0,0,84,0,-84
26969,1,1,441,1244,803
26970,1,1,126,1909,1783
26971,0,0,63,0,-63
26972,0,0,9,0,-9
26973,0,0,51,0,-51
26974,0,0,11,0,-11
26975,1,1,842,1304,462
26976,1,1,681,1888,1207
26977,0,0,28,0,-28
26978,1,1,605,2061,1456
26979,1,1,1009,3063,2054
26980,0,0,18,0,-18
26981,1,0,224,0,-224
26982,0,0,4,0,-4
26983,1,1,676,1541,865
26984,1,1,599,2334,1735
26985,1,0,26,0,-26
26986,1,0,5,0,-5
26987,1,1,684,1345,661
26988,0,0,31,0,-31
26989,0,0,29,0,-29
26990,1,1,720,1603,883
26991,1,1,600,2192,1592
26992,0,0,1,0,-1
26993,1,1,1673,1606,-67
26994,1,0,12,0,-12
26995,0,0,57,0,-57
26996,1,0,36,0,-36
26997,1,1,810,1664,854
26998,0,0,50,0,-50
26999,1,0,65,0,-65
27000,0,0,66,0,-66
27001,1,0,5,0,-5
27002,1,0,17,0,-17
27003,1,1,797,1295,498
27004,1,1,56,1952,1896
27005,1,0,115,0,-115
27006,0,0,103,0,-103
27007,0,0,1,0,-1
27008,1,0,10,0,-10
27009,1,1,112,2129,2017
27010,0,0,173,0,-173
27011,1,0,106,0,-106
27012,1,1,1536,1305,-231
27013,1,1,1208,1291,83
27014,1,1,768,2468,1700
27015,1,1,1222,1596,374
27016,0,0,8,0,-8
27017,0,0,232,0,-232
27018,1,0,21,0,-21
27019,1,1,103,2386,2283
27020,1,1,402,1386,984
27021,1,1,355,1984,1629
27022,0,0,102,0,-102
27023,0,0,14,0,-14
27024,1,0,24,0,-24
27025,1,1,744,1967,1223
27026,0,0,35,0,-35
27027,0,0,15,0,-15
27028,0,0,56,0,-56
27029,1,1,328,1582,1254
27030,1,1,1112,1383,271
27031,1,0,18,0,-18
27032,0,0,30,0,-30
27033,0,0,34,0,-34
27034,0,0,27,0,-27
27035,1,0,111,0,-111
27036,1,1,261,1325,1064
27037,1,0,3,0,-3
27038,0,0,17,0,-17
27039,1,1,374,1479,1105
27040,1,0,23,0,-23
27041,1,1,294,1265,971
27042,1,1,611,1235,624
27043,0,0,41,0,-41
27044,1,1,1792,2914,1122
27045,1,1,581,1566,985
27046,1,0,1,0,-1
27047,0,0,41,0,-41
27048,0,0,48,0,-48
27049,0,0,3,0,-3
27050,1,1,122,1318,1196
27051,0,0,53,0,-53
27052,1,1,750,1332,582
27053,0,0,35,0,-35
27054,1,1,330,1366,1036
27055,1,1,291,3844,3553
27056,0,0,47,0,-47
27057,0,0,38,0,-38
27058,0,0,69,0,-69
27059,1,1,32,1289,1257
27060,1,0,12,0,-12
27061,0,0,27,0,-27
27062,0,0,3,0,-3
27063,1,0,58,0,-58
27064,0,0,58,0,-58
27065,1,0,39,0,-39
27066,0,0,60,0,-60
27067,0,0,21,0,-21
27068,1,0,15,0,-15
27069,1,1,579,1340,761
27070,1,1,839,1260,421
27071,0,0,8,0,-8
27072,0,0,12,0,-12
27073,1,1,763,1513,750
27074,1,1,576,1394,818
27075,1,1,815,1498,683
27076,1,0,31,0,-31
27077,0,0,31,0,-31
27078,1,0,35,0,-35
27079,0,0,20,0,-20
27080,1,1,675,1237,562
27081,1,1,1806,1754,-52
27082,1,0,29,0,-29
27083,1,0,80,0,-80
27084,1,1,738,1260,522
27085,0,0,17,0,-17
27086,0,0,143,0,-143
27087,1,1,1443,2304,861
27088,1,0,41,0,-41
27089,0,0,19,0,-19
27090,0,0,18,0,-18
27091,1,0,13,0,-13
27092,1,0,66,0,-66
27093,0,0,20,0,-20
27094,1,0,32,0,-32
27095,0,0,168,0,-168
27096,0,0,2,0,-2
27097,1,1,546,2085,1539
27098,0,0,130,0,-130
27099,0,0,49,0,-49
27100,1,1,491,1394,903
27101,1,0,34,0,-34
27102,0,0,35,0,-35
27103,0,0,61,0,-61
27104,1,0,50,0,-50
27105,0,0,10,0,-10
27106,1,0,76,0,-76
27107,1,0,37,0,-37
27108,0,0,18,0,-18
27109,1,0,0,0,0
27110,1,0,38,0,-38
27111,0,0,29,0,-29
27112,0,0,1,0,-1
27113,1,1,241,2418,2177
27114,0,0,43,0,-43
27115,1,1,179,1236,1057
27116,1,0,27,0,-27
27117,0,0,50,0,-50
27118,1,0,5,0,-5
27119,0,0,60,0,-60
27120,1,1,433,1520,1087
27121,0,0,24,0,-24
27122,0,0,14,0,-14
27123,1,0,3,0,-3
27124,0,0,13,0,-13
27125,1,1,1389,1368,-21
27126,0,0,2,0,-2
27127,0,0,6,0,-6
27128,1,0,61,0,-61
27129,0,0,3,0,-3
27130,1,1,318,1274,956
27131,0,0,185,0,-185
27132,1,0,3,0,-3
27133,0,0,34,0,-34
27134,0,0,6,0,-6
27135,1,1,120,1280,1160
27136,0,0,134,0,-134
27137,0,0,58,0,-58
27138,1,0,17,0,-17
27139,0,0,70,0,-70
27140,1,0,1,0,-1
27141,1,1,278,1309,1031
27142,0,0,33,0,-33
27143,1,0,35,0,-35
27144,1,1,221,1313,1092
27145,0,0,11,0,-11
27146,0,0,9,0,-9
27147,1,1,430,1681,1251
27148,1,0,26,0,-26
27149,0,0,4,0,-4
27150,1,0,38,0,-38
27151,1,0,8,0,-8
27152,1,1,70,1850,1780
27153,0,0,8,0,-8
27154,1,0,2,0,-2
27155,1,0,67,0,-67
27156,1,0,31,0,-31
27157,1,1,463,1470,1007
27158,0,0,49,0,-49
27159,1,0,18,0,-18
27160,1,0,15,0,-15
27161,1,1,99,1258,1159
27162,0,0,84,0,-84
27163,0,0,47,0,-47
27164,0,0,2,0,-2
27165,0,0,37,0,-37
27166,0,0,74,0,-74
27167,1,1,296,1436,1140
27168,1,1,1389,1304,-85
27169,1,0,5,0,-5
27170,1,0,1,0,-1
27171,1,1,261,2214,1953
27172,0,0,50,0,-50
27173,0,0,3,0,-3
27174,0,0,20,0,-20
27175,1,1,363,1856,1493
27176,1,0,42,0,-42
27177,1,1,349,1668,1319
27178,0,0,263,0,-263
27179,1,0,16,0,-16
27180,1,0,60,0,-60
27181,1,1,85,1668,1583
27182,1,0,21,0,-21
27183,0,0,85,0,-85
27184,1,0,3,0,-3
27185,0,0,139,0,-139
27186,1,0,5,0,-5
27187,1,1,159,1238,1079
27188,0,0,26,0,-26
27189,1,1,1225,1834,609
27190,1,0,122,0,-122
27191,0,0,65,0,-65
27192,1,1,334,1267,933
27193,0,0,19,0,-19
27194,1,0,41,0,-41
27195,1,0,47,0,-47
27196,1,0,68,0,-68
27197,1,0,133,0,-133
27198,0,0,71,0,-71
27199,1,1,469,5156,4687
27200,0,0,12,0,-12
27201,1,1,21,1470,1449
27202,1,1,190,1756,1566
27203,1,0,48,0,-48
27204,0,0,73,0,-73
27205,0,0,140,0,-140
27206,1,0,13,0,-13
27207,1,1,386,1412,1026
27208,1,1,754,1328,574
27209,1,1,489,1306,817
27210,0,0,2,0,-2
27211,1,0,45,0,-45
27212,0,0,11,0,-11
27213,0,0,9,0,-9
27214,1,0,77,0,-77
27215,1,0,135,0,-135
27216,1,0,10,0,-10
27217,0,0,94,0,-94
27218,1,1,109,1288,1179
27219,0,0,89,0,-89
27220,1,0,28,0,-28
27221,1,1,79,1293,1214
27222,0,0,19,0,-19
27223,0,0,105,0,-105
27224,1,0,74,0,-74
27225,1,0,109,0,-109
27226,0,0,21,0,-21
27227,1,0,16,0,-16
27228,0,0,12,0,-12
27229,1,1,959,1371,412
27230,0,0,174,0,-174
27231,0,0,0,0,0
27232,1,1,554,1386,832
27233,0,0,92,0,-92
27234,1,0,25,0,-25
27235,1,1,220,2916,2696
27236,1,0,23,0,-23
27237,0,0,92,0,-92
27238,1,0,47,0,-47
27239,0,0,2,0,-2
27240,0,0,40,0,-40
27241,1,1,153,1310,1157
27242,1,0,27,0,-27
27243,0,0,48,0,-48
27244,1,1,140,1525,1385
27245,1,0,48,0,-48
27246,0,0,7,0,-7
27247,1,1,480,1789,1309
27248,1,1,256,1381,1125
27249,1,1,419,1381,962
27250,0,0,73,0,-73
27251,0,0,41,0,-41
27252,0,0,6,0,-6
27253,0,0,78,0,-78
27254,0,0,324,0,-324
27255,1,0,6,0,-6
27256,1,0,29,0,-29
27257,0,0,15,0,-15
27258,0,0,17,0,-17
27259,1,0,0,0,0
27260,1,0,47,0,-47
27261,1,1,348,1533,1185
27262,0,0,23,0,-23
27263,0,0,44,0,-44
27264,0,0,48,0,-48
27265,0,0,50,0,-50
27266,1,0,3,0,-3
27267,0,0,15,0,-15
27268,1,1,99,1352,1253
27269,0,0,9,0,-9
27270,0,0,5,0,-5
27271,0,0,1,0,-1
27272,0,0,20,0,-20
27273,1,1,678,1762,1084
27274,1,1,1704,1779,75
27275,1,0,45,0,-45
27276,0,0,8,0,-8
27277,0,0,79,0,-79
27278,1,1,145,4161,4016
27279,0,0,23,0,-23
27280,0,0,29,0,-29
27281,0,0,68,0,-68
27282,0,0,75,0,-75
27283,1,0,38,0,-38
27284,1,1,283,1287,1004
27285,1,1,103,1636,1533
27286,1,1,1206,1549,343
27287,1,0,14,0,-14
27288,1,0,18,0,-18
27289,1,1,538,2156,1618
27290,1,1,606,1329,723
27291,0,0,25,0,-25
27292,1,0,39,0,-39
27293,0,0,5,0,-5
27294,1,0,4,0,-4
27295,1,1,201,1247,1046
27296,1,1,31,1335,1304
27297,1,0,7,0,-7
27298,1,0,108,0,-108
27299,0,0,26,0,-26
27300,1,1,166,1342,1176
27301,0,0,1,0,-1
27302,0,0,14,0,-14
27303,1,0,28,0,-28
27304,1,1,310,3082,2772
27305,1,0,4,0,-4
27306,0,0,145,0,-145
27307,0,0,1,0,-1
27308,0,0,29,0,-29
27309,1,0,60,0,-60
27310,1,0,86,0,-86
27311,1,1,347,1430,1083
27312,1,0,16,0,-16
27313,1,0,26,0,-26
27314,1,0,16,0,-16
27315,1,1,111,1728,1617
27316,0,0,19,0,-19
27317,1,0,175,0,-175
27318,0,0,28,0,-28
27319,0,0,57,0,-57
27320,0,0,11,0,-11
27321,0,0,101,0,-101
27322,1,1,228,1293,1065
27323,1,1,275,1530,1255
27324,0,0,37,0,-37
27325,1,0,38,0,-38
27326,0,0,48,0,-48
27327,1,0,107,0,-107
27328,1,1,341,1607,1266
27329,1,0,36,0,-36
27330,1,1,177,1365,1188
27331,1,1,147,2080,1933
27332,0,0,52,0,-52
27333,1,1,265,5140,4875
27334,0,0,113,0,-113
27335,0,0,61,0,-61
27336,0,0,93,0,-93
27337,0,0,1,0,-1
27338,1,1,826,1278,452
27339,1,0,69,0,-69
27340,1,1,86,1250,1164
27341,0,0,2,0,-2
27342,1,0,41,0,-41
27343,0,0,68,0,-68
27344,0,0,103,0,-103
27345,1,1,1426,3767,2341
27346,0,0,16,0,-16
27347,0,0,134,0,-134
27348,0,0,80,0,-80
27349,1,0,19,0,-19
27350,0,0,175,0,-175
27351,1,1,721,1365,644
27352,1,0,23,0,-23
27353,1,1,1142,1498,356
27354,1,0,1,0,-1
27355,1,1,384,1608,1224
27356,0,0,2,0,-2
27357,0,0,9,0,-9
27358,0,0,12,0,-12
27359,1,0,22,0,-22
27360,1,0,11,0,-11
27361,0,0,9,0,-9
27362,1,1,155,7465,7310
27363,1,0,19,0,-19
27364,1,0,2,0,-2
27365,0,0,33,0,-33
27366,1,0,48,0,-48
27367,0,0,8,0,-8
27368,0,0,61,0,-61
27369,1,0,23,0,-23
27370,1,0,174,0,-174
27371,1,1,857,1441,584
27372,1,0,67,0,-67
27373,1,1,633,1438,805
27374,1,0,147,0,-147
27375,0,0,266,0,-266
27376,0,0,4,0,-4
27377,0,0,31,0,-31
27378,1,0,22,0,-22
27379,1,1,62,2128,2066
27380,0,0,90,0,-90
27381,1,0,14,0,-14
27382,0,0,107,0,-107
27383,1,0,51,0,-51
27384,0,0,199,0,-199
27385,0,0,17,0,-17
27386,1,0,5,0,-5
27387,0,0,83,0,-83
27388,1,0,9,0,-9
27389,0,0,1,0,-1
27390,1,1,94,1887,1793
27391,0,0,43,0,-43
27392,1,0,13,0,-13
27393,1,1,116,1355,1239
27394,0,0,29,0,-29
27395,1,0,116,0,-116
27396,0,0,92,0,-92
27397,1,1,730,2595,1865
27398,0,0,48,0,-48
27399,1,0,37,0,-37
27400,0,0,1,0,-1
27401,1,1,736,1237,501
27402,1,0,6,0,-6
27403,1,0,69,0,-69
27404,0,0,4,0,-4
27405,1,1,74,1565,1491
27406,1,1,293,1369,1076
27407,0,0,85,0,-85
27408,0,0,15,0,-15
27409,0,0,26,0,-26
27410,1,0,11,0,-11
27411,0,0,65,0,-65
27412,1,0,30,0,-30
27413,1,0,0,0,0
27414,1,1,45,1409,1364
27415,1,0,9,0,-9
27416,1,1,1298,1796,498
27417,1,0,141,0,-141
27418,0,0,57,0,-57
27419,0,0,120,0,-120
27420,1,1,128,1444,1316
27421,0,0,106,0,-106
27422,1,1,914,1254,340
27423,0,0,180,0,-180
27424,1,1,594,1911,1317
27425,0,0,59,0,-59
27426,1,0,59,0,-59
27427,1,0,69,0,-69
27428,0,0,44,0,-44
27429,0,0,36,0,-36
27430,1,0,72,0,-72
27431,1,0,99,0,-99
27432,0,0,116,0,-116
27433,1,0,41,0,-41
27434,1,0,44,0,-44
27435,1,1,155,1262,1107
27436,1,0,8,0,-8
27437,1,0,62,0,-62
27438,1,0,0,0,0
27439,1,0,35,0,-35
27440,1,0,61,0,-61
27441,1,1,294,1297,1003
27442,1,1,615,1299,684
27443,0,0,53,0,-53
27444,0,0,88,0,-88
27445,0,0,6,0,-6
27446,1,1,409,1803,1394
27447,0,0,54,0,-54
27448,0,0,52,0,-52
27449,0,0,114,0,-114
27450,1,1,1669,1274,-395
27451,1,0,6,0,-6
27452,1,1,493,1586,1093
27453,1,0,37,0,-37
27454,1,1,56,1410,1354
27455,0,0,42,0,-42
27456,1,1,197,1757,1560
27457,1,0,31,0,-31
27458,1,0,17,0,-17
27459,1,1,48,1949,1901
27460,0,0,41,0,-41
27461,1,0,55,0,-55
27462,0,0,32,0,-32
27463,1,0,36,0,-36
27464,0,0,87,0,-87
27465,0,0,159,0,-159
27466,0,0,50,0,-50
27467,1,0,131,0,-131
27468,1,0,35,0,-35
27469,1,0,6,0,-6
27470,1,0,65,0,-65
27471,1,0,10,0,-10
27472,1,0,37,0,-37
27473,1,1,267,1235,968
27474,1,1,208,1771,1563
27475,1,1,1352,1263,-89
27476,1,1,357,2768,2411
27477,0,0,86,0,-86
27478,1,1,355,1337,982
27479,1,1,576,1699,1123
27480,1,0,22,0,-22
27481,0,0,121,0,-121
27482,1,1,827,1275,448
27483,0,0,8,0,-8
27484,1,1,360,1408,1048
27485,1,0,4,0,-4
27486,0,0,1,0,-1
27487,1,1,2244,1498,-746
27488,0,0,80,0,-80
27489,1,0,26,0,-26
27490,1,0,55,0,-55
27491,0,0,21,0,-21
27492,1,1,199,1425,1226
27493,1,1,210,1254,1044
27494,1,1,486,1474,988
27495,0,0,5,0,-5
27496,1,1,355,2004,1649
27497,1,0,40,0,-40
27498,1,1,131,1821,1690
27499,0,0,7,0,-7
27500,1,0,17,0,-17
27501,0,0,39,0,-39
27502,1,1,443,1532,1089
27503,1,1,484,1490,1006
27504,0,0,30,0,-30
27505,1,0,40,0,-40
27506,0,0,9,0,-9
27507,0,0,4,0,-4
27508,0,0,9,0,-9
27509,1,1,1738,1664,-74
27510,1,1,756,2003,1247
27511,1,1,430,1645,1215
27512,1,1,394,1245,851
27513,1,0,28,0,-28
27514,0,0,13,0,-13
27515,1,1,158,1580,1422
27516,1,1,551,1628,1077
27517,0,0,11,0,-11
27518,1,0,4,0,-4
27519,1,1,1769,1521,-248
27520,0,0,47,0,-47
27521,0,0,6,0,-6
27522,1,0,4,0,-4
27523,1,1,405,1367,962
27524,1,1,468,1324,856
27525,1,1,47,1659,1612
27526,1,0,9,0,-9
27527,0,0,20,0,-20
27528,1,0,50,0,-50
27529,0,0,179,0,-179
27530,0,0,0,0,0
27531,1,1,223,1489,1266
27532,1,1,1036,1342,306
27533,0,0,8,0,-8
27534,1,1,102,2126,2024
27535,1,1,57,1356,1299
27536,1,0,16,0,-16
27537,1,0,24,0,-24
27538,1,0,62,0,-62
27539,0,0,15,0,-15
27540,0,0,5,0,-5
27541,0,0,16,0,-16
27542,1,0,176,0,-176
27543,0,0,88,0,-88
27544,0,0,30,0,-30
27545,1,0,93,0,-93
27546,1,1,131,2660,2529
27547,0,0,7,0,-7
27548,0,0,84,0,-84
27549,0,0,18,0,-18
27550,1,1,757,2495,1738
27551,1,0,186,0,-186
27552,1,0,89,0,-89
27553,1,0,42,0,-42
27554,1,0,55,0,-55
27555,1,0,21,0,-21
27556,1,1,275,1861,1586
27557,1,0,20,0,-20
27558,1,0,14,0,-14
27559,0,0,25,0,-25
27560,1,1,202,1239,1037
27561,1,0,60,0,-60
27562,1,1,422,1700,1278
27563,0,0,97,0,-97
27564,1,1,309,1236,927
27565,1,1,440,1492,1052
27566,0,0,76,0,-76
27567,0,0,18,0,-18
27568,0,0,31,0,-31
27569,1,1,607,1790,1183
27570,1,0,2,0,-2
27571,0,0,45,0,-45
27572,0,0,26,0,-26
27573,0,0,14,0,-14
27574,0,0,211,0,-211
27575,0,0,57,0,-57
27576,0,0,16,0,-16
27577,1,1,493,1498,1005
27578,0,0,17,0,-17
27579,1,0,10,0,-10
27580,0,0,28,0,-28
27581,1,1,218,1327,1109
27582,0,0,2,0,-2
27583,0,0,82,0,-82
27584,1,0,122,0,-122
27585,1,1,402,1386,984
27586,0,0,13,0,-13
27587,1,0,13,0,-13
27588,1,1,260,1480,1220
27589,1,1,575,2152,1577
27590,1,0,7,0,-7
27591,1,1,88,1524,1436
27592,0,0,173,0,-173
27593,1,0,117,0,-117
27594,0,0,147,0,-147
27595,1,1,972,1332,360
27596,1,0,102,0,-102
27597,1,1,129,1419,1290
27598,1,1,311,2107,1796
27599,1,0,127,0,-127
27600,0,0,67,0,-67
27601,1,0,13,0,-13
27602,0,0,89,0,-89
27603,0,0,3,0,-3
27604,1,1,264,2320,2056
27605,1,0,15,0,-15
27606,1,1,425,1526,1101
27607,1,1,482,1876,1394
27608,0,0,98,0,-98
27609,1,1,365,1514,1149
27610,1,1,444,1677,1233
27611,1,0,70,0,-70
27612,1,1,373,1650,1277
27613,0,0,20,0,-20
27614,0,0,29,0,-29
27615,1,0,29,0,-29
27616,1,1,143,1863,1720
27617,1,0,62,0,-62
27618,0,0,153,0,-153
27619,0,0,35,0,-35
27620,0,0,24,0,-24
27621,1,0,51,0,-51
27622,1,1,116,1434,1318
27623,0,0,8,0,-8
27624,0,0,17,0,-17
27625,1,1,1315,1578,263
27626,1,1,138,1441,1303
27627,0,0,71,0,-71
27628,1,0,10,0,-10
27629,1,1,937,1269,332
27630,1,1,515,1264,749
27631,0,0,19,0,-19
27632,1,1,778,1365,587
27633,1,1,574,1354,780
27634,0,0,12,0,-12
27635,0,0,5,0,-5
27636,1,1,125,1601,1476
27637,0,0,76,0,-76
27638,1,1,506,2174,1668
27639,0,0,188,0,-188
27640,1,1,1414,1813,399
27641,1,1,1150,2116,966
27642,1,0,115,0,-115
27643,1,0,40,0,-40
27644,1,0,49,0,-49
27645,0,0,35,0,-35
27646,1,0,21,0,-21
27647,0,0,138,0,-138
27648,0,0,7,0,-7
27649,1,0,2,0,-2
27650,1,1,709,1281,572
27651,0,0,30,0,-30
27652,1,0,24,0,-24
27653,0,0,60,0,-60
27654,1,0,7,0,-7
27655,0,0,11,0,-11
27656,0,0,4,0,-4
27657,1,1,1063,1751,688
27658,0,0,2,0,-2
27659,0,0,30,0,-30
27660,0,0,100,0,-100
27661,1,1,447,1339,892
27662,0,0,92,0,-92
27663,1,0,228,0,-228
27664,0,0,27,0,-27
27665,1,0,30,0,-30
27666,1,0,20,0,-20
27667,1,0,139,0,-139
27668,0,0,36,0,-36
27669,1,0,167,0,-167
27670,1,1,1692,1552,-140
27671,1,0,27,0,-27
27672,1,0,7,0,-7
27673,0,0,67,0,-67
27674,1,1,91,1265,1174
27675,1,1,254,2468,2214
27676,1,1,267,1249,982
27677,1,1,526,1378,852
27678,1,1,943,1359,416
27679,0,0,8,0,-8
27680,1,1,269,1737,1468
27681,0,0,37,0,-37
27682,0,0,104,0,-104
27683,0,0,20,0,-20
27684,0,0,205,0,-205
27685,1,1,310,1275,965
27686,0,0,91,0,-91
27687,1,0,12,0,-12
27688,0,0,14,0,-14
27689,1,0,93,0,-93
27690,1,1,240,1342,1102
27691,0,0,9,0,-9
27692,1,1,436,1480,1044
27693,0,0,111,0,-111
27694,1,0,273,0,-273
27695,1,1,489,2163,1674
27696,1,1,446,1414,968
27697,0,0,24,0,-24
27698,0,0,157,0,-157
27699,1,0,4,0,-4
27700,1,0,20,0,-20
27701,1,1,592,1394,802
27702,0,0,59,0,-59
27703,0,0,30,0,-30
27704,1,0,26,0,-26
27705,0,0,11,0,-11
27706,0,0,57,0,-57
27707,1,0,59,0,-59
27708,1,1,185,1257,1072
27709,1,0,68,0,-68
27710,1,1,1110,1752,642
27711,0,0,0,0,0
27712,0,0,48,0,-48
27713,0,0,23,0,-23
27714,1,1,409,1565,1156
27715,1,0,92,0,-92
27716,1,1,658,1342,684
27717,0,0,57,0,-57
27718,1,0,134,0,-134
27719,0,0,21,0,-21
27720,1,0,22,0,-22
27721,1,1,503,1373,870
27722,0,0,24,0,-24
27723,1,0,25,0,-25
27724,0,0,43,0,-43
27725,1,1,517,1283,766
27726,0,0,103,0,-103
27727,0,0,39,0,-39
27728,0,0,19,0,-19
27729,0,0,10,0,-10
27730,1,0,12,0,-12
27731,0,0,41,0,-41
27732,0,0,113,0,-113
27733,1,0,169,0,-169
27734,0,0,132,0,-132
27735,1,0,83,0,-83
27736,1,1,220,1758,1538
27737,1,1,166,1251,1085
27738,1,1,844,2335,1491
27739,1,0,27,0,-27
27740,1,0,9,0,-9
27741,0,0,7,0,-7
27742,1,1,380,1291,911
27743,1,0,23,0,-23
27744,0,0,5,0,-5
27745,1,1,527,1342,815
27746,0,0,27,0,-27
27747,0,0,42,0,-42
27748,0,0,84,0,-84
27749,1,1,383,1603,1220
27750,1,1,1930,1576,-354
27751,1,1,598,2722,2124
27752,1,1,33,1292,1259
27753,1,0,73,0,-73
27754,0,0,9,0,-9
27755,0,0,34,0,-34
27756,0,0,13,0,-13
27757,1,0,26,0,-26
27758,1,0,15,0,-15
27759,0,0,21,0,-21
27760,1,1,189,1434,1245
27761,1,0,201,0,-201
27762,0,0,9,0,-9
27763,0,0,13,0,-13
27764,1,1,46,1320,1274
27765,0,0,49,0,-49
27766,1,0,78,0,-78
27767,1,0,50,0,-50
27768,0,0,75,0,-75
27769,1,0,22,0,-22
27770,0,0,187,0,-187
27771,0,0,57,0,-57
27772,0,0,32,0,-32
27773,1,0,4,0,-4
27774,1,1,61,1591,1530
27775,1,1,18,2690,2672
27776,0,0,28,0,-28
27777,1,0,18,0,-18
27778,0,0,35,0,-35
27779,0,0,30,0,-30
27780,0,0,2,0,-2
27781,1,0,17,0,-17
27782,1,1,113,1575,1462
27783,1,1,893,1315,422
27784,1,0,12,0,-12
27785,1,1,453,1516,1063
27786,1,1,499,1636,1137
27787,0,0,27,0,-27
27788,1,0,64,0,-64
27789,1,0,7,0,-7
27790,0,0,11,0,-11
27791,0,0,123,0,-123
27792,1,0,26,0,-26
27793,0,0,2,0,-2
27794,1,1,389,1697,1308
27795,1,1,219,1408,1189
27796,0,0,62,0,-62
27797,0,0,9,0,-9
27798,1,0,80,0,-80
27799,1,1,219,1365,1146
27800,0,0,37,0,-37
27801,1,0,42,0,-42
27802,1,1,1084,2363,1279
27803,1,0,108,0,-108
27804,1,1,147,3156,3009
27805,1,0,20,0,-20
27806,1,1,28,1244,1216
27807,1,0,139,0,-139
27808,0,0,35,0,-35
27809,1,0,189,0,-189
27810,0,0,0,0,0
27811,1,1,581,2259,1678
27812,1,0,29,0,-29
27813,1,0,71,0,-71
27814,1,0,32,0,-32
27815,1,1,549,1269,720
27816,1,1,614,1283,669
27817,0,0,174,0,-174
27818,0,0,21,0,-21
27819,1,1,225,1261,1036
27820,1,0,114,0,-114
27821,0,0,39,0,-39
27822,1,0,24,0,-24
27823,1,1,380,1443,1063
27824,0,0,17,0,-17
27825,1,0,31,0,-31
27826,1,0,4,0,-4
27827,1,1,181,1522,1341
27828,0,0,40,0,-40
27829,0,0,330,0,-330
27830,0,0,85,0,-85
27831,1,1,457,1311,854
27832,1,1,115,1336,1221
27833,0,0,208,0,-208
27834,1,0,104,0,-104
27835,0,0,15,0,-15
27836,0,0,58,0,-58
27837,1,1,57,1457,1400
27838,0,0,19,0,-19
27839,0,0,221,0,-221
27840,1,1,670,1326,656
27841,0,0,15,0,-15
27842,0,0,4,0,-4
27843,0,0,4,0,-4
27844,1,0,17,0,-17
27845,1,0,10,0,-10
27846,1,1,211,1294,1083
27847,0,0,54,0,-54
27848,1,1,989,2423,1434
27849,0,0,10,0,-10
27850,1,1,824,1236,412
27851,1,1,903,1480,577
27852,1,0,13,0,-13
27853,1,1,319,1295,976
27854,1,1,393,1592,1199
27855,1,1,388,1452,1064
27856,1,1,40,2037,1997
27857,1,0,1,0,-1
27858,0,0,50,0,-50
27859,0,0,4,0,-4
27860,0,0,39,0,-39
27861,1,0,30,0,-30
27862,0,0,4,0,-4
27863,0,0,31,0,-31
27864,0,0,63,0,-63
27865,1,0,63,0,-63
27866,1,0,162,0,-162
27867,0,0,46,0,-46
27868,0,0,2,0,-2
27869,1,1,103,1440,1337
27870,1,0,7,0,-7
27871,0,0,17,0,-17
27872,1,1,236,1412,1176
27873,1,0,35,0,-35
27874,1,0,246,0,-246
27875,1,0,3,0,-3
27876,1,1,679,1327,648
27877,1,1,205,1283,1078
27878,0,0,115,0,-115
27879,0,0,35,0,-35
27880,0,0,11,0,-11
27881,0,0,30,0,-30
27882,0,0,29,0,-29
27883,1,1,302,1312,1010
27884,1,0,143,0,-143
27885,1,1,374,2697,2323
27886,1,0,20,0,-20
27887,0,0,37,0,-37
27888,1,0,24,0,-24
27889,0,0,97,0,-97
27890,1,1,267,1372,1105
27891,1,0,39,0,-39
27892,0,0,7,0,-7
27893,1,1,103,1350,1247
27894,1,1,651,1283,632
27895,1,0,48,0,-48
27896,0,0,6,0,-6
27897,1,0,25,0,-25
27898,0,0,102,0,-102
27899,1,0,84,0,-84
27900,1,0,5,0,-5
27901,1,0,29,0,-29
27902,1,1,660,1346,686
27903,1,1,435,3336,2901
27904,0,0,1,0,-1
27905,0,0,32,0,-32
27906,1,0,28,0,-28
27907,1,1,1468,2231,763
27908,0,0,54,0,-54
27909,0,0,87,0,-87
27910,1,1,510,1589,1079
27911,0,0,21,0,-21
27912,1,0,10,0,-10
27913,1,1,452,1278,826
27914,1,1,180,1756,1576
27915,0,0,14,0,-14
27916,1,0,114,0,-114
27917,1,0,38,0,-38
27918,1,0,152,0,-152
27919,1,1,99,1321,1222
27920,1,0,47,0,-47
27921,1,0,48,0,-48
27922,1,1,484,1419,935
27923,1,0,31,0,-31
27924,1,1,787,1763,976
27925,1,1,524,1556,1032
27926,0,0,9,0,-9
27927,1,0,34,0,-34
27928,1,1,1369,1348,-21
27929,0,0,37,0,-37
27930,1,0,52,0,-52
27931,0,0,21,0,-21
27932,1,0,189,0,-189
27933,0,0,6,0,-6
27934,1,0,44,0,-44
27935,0,0,111,0,-111
27936,0,0,17,0,-17
27937,0,0,5,0,-5
27938,0,0,7,0,-7
27939,1,1,2989,1329,-1660
27940,0,0,22,0,-22
27941,0,0,64,0,-64
27942,1,0,18,0,-18
27943,1,0,96,0,-96
27944,1,0,0,0,0
27945,1,1,934,1293,359
27946,0,0,29,0,-29
27947,1,1,376,1602,1226
27948,1,1,191,1489,1298
27949,1,1,411,1238,827
27950,0,0,26,0,-26
27951,1,0,63,0,-63
27952,1,0,35,0,-35
27953,0,0,24,0,-24
27954,1,0,51,0,-51
27955,1,0,14,0,-14
27956,0,0,95,0,-95
27957,1,0,55,0,-55
27958,0,0,107,0,-107
27959,1,1,174,1440,1266
27960,1,0,130,0,-130
27961,1,0,252,0,-252
27962,1,0,37,0,-37
27963,0,0,198,0,-198
27964,1,1,512,1454,942
27965,0,0,9,0,-9
27966,0,0,14,0,-14
27967,0,0,15,0,-15
27968,0,0,47,0,-47
27969,0,0,85,0,-85
27970,0,0,62,0,-62
27971,0,0,36,0,-36
27972,0,0,27,0,-27
27973,1,1,218,1256,1038
27974,1,0,84,0,-84
27975,0,0,101,0,-101
27976,1,0,16,0,-16
27977,1,0,90,0,-90
27978,0,0,56,0,-56
27979,1,1,75,2571,2496
27980,1,1,1381,1393,12
27981,1,1,67,1324,1257
27982,1,1,740,1600,860
27983,1,1,243,1341,1098
27984,0,0,16,0,-16
27985,1,1,364,1642,1278
27986,1,1,321,2516,2195
27987,1,0,1,0,-1
27988,0,0,15,0,-15
27989,1,0,15,0,-15
27990,0,0,23,0,-23
27991,1,1,3157,1340,-1817
27992,0,0,22,0,-22
27993,1,0,2,0,-2
27994,1,1,532,1430,898
27995,0,0,30,0,-30
27996,1,0,24,0,-24
27997,1,0,0,0,0
27998,1,1,218,1843,1625
27999,0,0,31,0,-31
28000,0,0,22,0,-22
28001,1,0,57,0,-57
28002,0,0,94,0,-94
28003,0,0,70,0,-70
28004,0,0,5,0,-5
28005,1,1,43,1262,1219
28006,0,0,7,0,-7
28007,1,1,354,2128,1774
28008,1,1,413,2062,1649
28009,1,1,267,1376,1109
28010,0,0,147,0,-147
28011,1,0,177,0,-177
28012,1,1,487,1423,936
28013,0,0,17,0,-17
28014,1,1,27,1351,1324
28015,1,1,180,1510,1330
28016,1,0,7,0,-7
28017,1,1,860,1356,496
28018,0,0,5,0,-5
28019,1,0,46,0,-46
28020,0,0,65,0,-65
28021,1,0,11,0,-11
28022,0,0,1,0,-1
28023,0,0,19,0,-19
28024,1,0,43,0,-43
28025,1,0,108,0,-108
28026,1,0,2,0,-2
28027,0,0,18,0,-18
28028,0,0,32,0,-32
28029,1,1,231,1582,1351
28030,1,1,191,1284,1093
28031,1,0,34,0,-34
28032,0,0,34,0,-34
28033,1,1,422,1274,852
28034,0,0,48,0,-48
28035,1,0,4,0,-4
28036,1,1,447,2768,2321
28037,0,0,16,0,-16
28038,1,1,365,2267,1902
28039,1,0,31,0,-31
28040,1,0,26,0,-26
28041,0,0,11,0,-11
28042,0,0,35,0,-35
28043,1,0,47,0,-47
28044,0,0,215,0,-215
28045,0,0,126,0,-126
28046,1,0,136,0,-136
28047,1,0,65,0,-65
28048,1,1,1135,1299,164
28049,0,0,18,0,-18
28050,1,0,25,0,-25
28051,1,1,465,1717,1252
28052,1,1,487,1614,1127
28053,1,1,134,2014,1880
28054,1,1,648,1378,730
28055,1,1,148,1287,1139
28056,0,0,315,0,-315
28057,0,0,31,0,-31
28058,0,0,6,0,-6
28059,0,0,18,0,-18
28060,0,0,1,0,-1
28061,1,1,140,1593,1453
28062,0,0,12,0,-12
28063,0,0,2,0,-2
28064,1,0,196,0,-196
28065,1,0,43,0,-43
28066,1,0,91,0,-91
28067,1,1,673,2223,1550
28068,1,1,48,1268,1220
28069,1,1,408,1752,1344
28070,1,0,26,0,-26
28071,1,0,48,0,-48
28072,1,1,50,1732,1682
28073,0,0,116,0,-116
28074,1,0,107,0,-107
28075,1,1,905,1873,968
28076,1,0,144,0,-144
28077,0,0,26,0,-26
28078,1,0,16,0,-16
28079,0,0,11,0,-11
28080,1,0,132,0,-132
28081,1,0,91,0,-91
28082,1,0,140,0,-140
28083,0,0,33,0,-33
28084,1,1,357,2512,2155
28085,1,0,75,0,-75
28086,1,1,205,1750,1545
28087,1,1,1860,2056,196
28088,0,0,53,0,-53
28089,0,0,102,0,-102
28090,0,0,81,0,-81
28091,0,0,39,0,-39
28092,1,0,9,0,-9
28093,0,0,221,0,-221
28094,0,0,218,0,-218
28095,1,1,912,1794,882
28096,1,1,202,1246,1044
28097,1,1,1355,1847,492
28098,0,0,43,0,-43
28099,1,1,52,1791,1739
28100,1,0,9,0,-9
28101,0,0,5,0,-5
28102,1,1,218,1488,1270
28103,0,0,39,0,-39
28104,1,0,10,0,-10
28105,1,0,30,0,-30
28106,1,0,14,0,-14
28107,0,0,70,0,-70
28108,0,0,95,0,-95
28109,1,0,81,0,-81
28110,1,1,850,1309,459
28111,0,0,8,0,-8
28112,0,0,61,0,-61
28113,0,0,183,0,-183
28114,0,0,51,0,-51
28115,0,0,15,0,-15
28116,0,0,10,0,-10
28117,1,1,523,1278,755
28118,0,0,5,0,-5
28119,1,0,7,0,-7
28120,0,0,46,0,-46
28121,0,0,1,0,-1
28122,1,1,862,1413,551
28123,1,1,126,1776,1650
28124,0,0,7,0,-7
28125,0,0,97,0,-97
28126,0,0,254,0,-254
28127,1,0,5,0,-5
28128,0,0,17,0,-17
28129,0,0,51,0,-51
28130,0,0,40,0,-40
28131,1,0,18,0,-18
28132,1,1,528,1276,748
28133,1,0,27,0,-27
28134,0,0,138,0,-138
28135,1,0,79,0,-79
28136,0,0,31,0,-31
28137,1,1,785,1367,582
28138,1,1,188,2237,2049
28139,0,0,82,0,-82
28140,0,0,14,0,-14
28141,1,0,10,0,-10
28142,0,0,88,0,-88
28143,0,0,22,0,-22
28144,1,0,12,0,-12
28145,1,0,5,0,-5
28146,1,0,30,0,-30
28147,0,0,47,0,-47
28148,1,1,49,1457,1408
28149,0,0,82,0,-82
28150,0,0,39,0,-39
28151,1,1,154,1763,1609
28152,1,0,5,0,-5
28153,0,0,41,0,-41
28154,0,0,133,0,-133
28155,0,0,2,0,-2
28156,1,0,64,0,-64
28157,1,0,139,0,-139
28158,1,1,266,1798,1532
28159,0,0,14,0,-14
28160,0,0,2,0,-2
28161,0,0,90,0,-90
28162,1,0,91,0,-91
28163,1,0,79,0,-79
28164,1,1,712,1473,761
28165,1,0,58,0,-58
28166,0,0,96,0,-96
28167,1,0,15,0,-15
28168,0,0,231,0,-231
28169,1,0,15,0,-15
28170,1,1,199,1316,1117
28171,1,0,3,0,-3
28172,1,1,532,1944,1412
28173,1,1,488,1300,812
28174,0,0,7,0,-7
28175,1,0,30,0,-30
28176,1,1,252,1822,1570
28177,0,0,90,0,-90
28178,1,1,750,2401,1651
28179,0,0,109,0,-109
28180,1,0,11,0,-11
28181,0,0,15,0,-15
28182,1,0,23,0,-23
28183,0,0,33,0,-33
28184,1,1,1315,1311,-4
28185,1,0,1,0,-1
28186,1,0,194,0,-194
28187,0,0,149,0,-149
28188,1,1,157,3227,3070
28189,0,0,3,0,-3
28190,0,0,82,0,-82
28191,0,0,187,0,-187
28192,1,0,15,0,-15
28193,1,0,12,0,-12
28194,0,0,23,0,-23
28195,1,0,28,0,-28
28196,0,0,44,0,-44
28197,1,0,45,0,-45
28198,1,0,60,0,-60
28199,0,0,1,0,-1
28200,1,1,717,1707,990
28201,1,1,139,2309,2170
28202,0,0,180,0,-180
28203,1,0,53,0,-53
28204,1,1,993,1415,422
28205,0,0,3,0,-3
28206,1,0,121,0,-121
28207,0,0,26,0,-26
28208,0,0,4,0,-4
28209,0,0,14,0,-14
28210,1,0,14,0,-14
28211,1,0,65,0,-65
28212,1,0,42,0,-42
28213,1,0,31,0,-31
28214,1,0,72,0,-72
28215,1,0,37,0,-37
28216,1,1,131,1374,1243
28217,1,1,1065,1351,286
28218,0,0,134,0,-134
28219,1,0,32,0,-32
28220,0,0,78,0,-78
28221,1,0,0,0,0
28222,1,0,8,0,-8
28223,1,1,153,1614,1461
28224,0,0,61,0,-61
28225,1,0,18,0,-18
28226,1,1,93,1875,1782
28227,1,1,165,1449,1284
28228,0,0,2,0,-2
28229,0,0,23,0,-23
28230,1,1,29,1327,1298
28231,0,0,81,0,-81
28232,0,0,98,0,-98
28233,1,0,43,0,-43
28234,1,1,913,1593,680
28235,0,0,39,0,-39
28236,0,0,0,0,0
28237,1,1,340,1409,1069
28238,1,1,56,1896,1840
28239,1,1,206,1333,1127
28240,1,0,10,0,-10
28241,0,0,19,0,-19
28242,0,0,24,0,-24
28243,0,0,42,0,-42
28244,1,0,55,0,-55
28245,0,0,51,0,-51
28246,1,1,600,1285,685
28247,0,0,64,0,-64
28248,0,0,27,0,-27
28249,1,1,787,1290,503
28250,0,0,122,0,-122
28251,1,0,0,0,0
28252,0,0,79,0,-79
28253,0,0,5,0,-5
28254,1,0,6,0,-6
28255,1,0,192,0,-192
28256,1,0,42,0,-42
28257,0,0,68,0,-68
28258,1,0,21,0,-21
28259,1,1,398,2570,2172
28260,0,0,27,0,-27
28261,0,0,94,0,-94
28262,0,0,12,0,-12
28263,0,0,71,0,-71
28264,1,1,223,2267,2044
28265,1,1,390,1344,954
28266,0,0,45,0,-45
28267,0,0,90,0,-90
28268,0,0,17,0,-17
28269,1,0,153,0,-153
28270,0,0,62,0,-62
28271,0,0,22,0,-22
28272,0,0,2,0,-2
28273,1,1,507,1295,788
28274,0,0,1,0,-1
28275,1,1,232,1872,1640
28276,1,1,51,2056,2005
28277,1,1,688,1824,1136
28278,0,0,10,0,-10
28279,0,0,87,0,-87
28280,1,1,565,1626,1061
28281,1,0,36,0,-36
28282,1,0,38,0,-38
28283,1,1,387,2663,2276
28284,0,0,11,0,-11
28285,1,1,736,1303,567
28286,1,0,21,0,-21
28287,1,0,42,0,-42
28288,0,0,105,0,-105
28289,1,0,34,0,-34
28290,1,1,227,1262,1035
28291,1,0,9,0,-9
28292,0,0,23,0,-23
28293,1,0,45,0,-45
28294,1,0,32,0,-32
28295,0,0,17,0,-17
28296,1,1,411,1344,933
28297,1,0,24,0,-24
28298,1,0,134,0,-134
28299,0,0,62,0,-62
28300,1,0,34,0,-34
28301,1,1,581,1318,737
28302,1,0,39,0,-39
28303,1,1,95,1399,1304
28304,1,1,1065,6326,5261
28305,1,1,169,1266,1097
28306,1,1,476,1901,1425
28307,0,0,152,0,-152
28308,1,0,7,0,-7
28309,1,0,28,0,-28
28310,0,0,3,0,-3
28311,1,1,202,1495,1293
28312,1,1,1103,1253,150
28313,0,0,91,0,-91
28314,1,0,35,0,-35
28315,1,0,0,0,0
28316,0,0,5,0,-5
28317,0,0,9,0,-9
28318,1,1,252,1376,1124
28319,0,0,7,0,-7
28320,1,1,70,1276,1206
28321,1,0,23,0,-23
28322,1,0,106,0,-106
28323,0,0,40,0,-40
28324,1,0,37,0,-37
28325,1,0,12,0,-12
28326,0,0,50,0,-50
28327,0,0,118,0,-118
28328,1,0,261,0,-261
28329,0,0,100,0,-100
28330,0,0,114,0,-114
28331,1,0,120,0,-120
28332,1,0,5,0,-5
28333,0,0,51,0,-51
28334,1,0,16,0,-16
28335,1,0,149,0,-149
28336,1,1,125,1610,1485
28337,1,0,161,0,-161
28338,1,0,27,0,-27
28339,1,1,73,1511,1438
28340,0,0,17,0,-17
28341,1,1,143,1369,1226
28342,1,1,334,1399,1065
28343,0,0,32,0,-32
28344,0,0,26,0,-26
28345,1,1,2612,1247,-1365
28346,0,0,18,0,-18
28347,0,0,133,0,-133
28348,0,0,81,0,-81
28349,1,0,0,0,0
28350,0,0,32,0,-32
28351,0,0,55,0,-55
28352,0,0,161,0,-161
28353,1,0,49,0,-49
28354,1,0,48,0,-48
28355,1,0,12,0,-12
28356,1,1,517,1345,828
28357,1,1,384,1283,899
28358,1,0,111,0,-111
28359,1,0,14,0,-14
28360,1,0,44,0,-44
28361,1,1,1145,2924,1779
28362,1,1,116,1263,1147
28363,1,1,350,1262,912
28364,1,0,33,0,-33
28365,0,0,25,0,-25
28366,0,0,18,0,-18
28367,1,0,172,0,-172
28368,0,0,21,0,-21
28369,0,0,12,0,-12
28370,1,1,1707,1456,-251
28371,1,1,127,1806,1679
28372,1,1,282,1429,1147
28373,1,0,23,0,-23
28374,1,1,196,1265,1069
28375,0,0,7,0,-7
28376,1,0,30,0,-30
28377,1,0,21,0,-21
28378,1,0,9,0,-9
28379,0,0,41,0,-41
28380,1,1,435,1620,1185
28381,1,0,81,0,-81
28382,0,0,29,0,-29
28383,1,1,1276,2352,1076
28384,1,0,3,0,-3
28385,0,0,52,0,-52
28386,1,1,452,1382,930
28387,0,0,60,0,-60
28388,1,1,616,1313,697
28389,0,0,3,0,-3
28390,1,1,1577,1514,-63
28391,0,0,17,0,-17
28392,1,0,11,0,-11
28393,1,0,6,0,-6
28394,1,0,14,0,-14
28395,1,0,14,0,-14
28396,1,1,267,1340,1073
28397,1,0,64,0,-64
28398,1,1,702,1242,540
28399,0,0,7,0,-7
28400,1,0,56,0,-56
28401,1,1,255,1278,1023
28402,0,0,32,0,-32
28403,0,0,33,0,-33
28404,1,1,517,1569,1052
28405,1,1,1722,1526,-196
28406,1,1,31,2072,2041
28407,0,0,39,0,-39
28408,0,0,56,0,-56
28409,0,0,29,0,-29
28410,0,0,6,0,-6
28411,1,0,47,0,-47
28412,1,0,5,0,-5
28413,0,0,12,0,-12
28414,1,1,530,1250,720
28415,0,0,34,0,-34
28416,0,0,54,0,-54
28417,0,0,65,0,-65
28418,0,0,13,0,-13
28419,1,1,1169,1274,105
28420,0,0,71,0,-71
28421,0,0,38,0,-38
28422,0,0,22,0,-22
28423,0,0,28,0,-28
28424,0,0,91,0,-91
28425,1,1,777,1315,538
28426,0,0,31,0,-31
28427,1,1,648,1343,695
28428,1,1,296,1338,1042
28429,0,0,93,0,-93
28430,1,0,10,0,-10
28431,0,0,57,0,-57
28432,1,1,780,1332,552
28433,1,1,262,1262,1000
28434,1,1,272,1678,1406
28435,1,1,958,1238,280
28436,0,0,127,0,-127
28437,1,1,231,1337,1106
28438,1,0,41,0,-41
28439,1,1,1249,1251,2
28440,1,1,1685,1319,-366
28441,1,1,695,1265,570
28442,0,0,10,0,-10
28443,1,0,11,0,-11
28444,1,1,341,1353,1012
28445,0,0,2,0,-2
28446,0,0,37,0,-37
28447,1,1,79,1535,1456
28448,1,1,132,1385,1253
28449,0,0,70,0,-70
28450,0,0,65,0,-65
28451,1,0,46,0,-46
28452,0,0,12,0,-12
28453,0,0,18,0,-18
28454,0,0,97,0,-97
28455,1,1,718,1272,554
28456,0,0,198,0,-198
28457,1,0,32,0,-32
28458,0,0,33,0,-33
28459,1,0,14,0,-14
28460,0,0,5,0,-5
28461,0,0,51,0,-51
28462,0,0,42,0,-42
28463,1,0,32,0,-32
28464,1,0,61,0,-61
28465,1,1,300,1695,1395
28466,1,0,99,0,-99
28467,0,0,2,0,-2
28468,1,1,1198,1334,136
28469,1,0,18,0,-18
28470,0,0,22,0,-22
28471,1,0,32,0,-32
28472,0,0,18,0,-18
28473,0,0,3,0,-3
28474,0,0,47,0,-47
28475,0,0,48,0,-48
28476,1,0,15,0,-15
28477,1,0,88,0,-88
28478,1,0,28,0,-28
28479,1,0,44,0,-44
28480,1,1,356,1338,982
28481,1,0,110,0,-110
28482,1,0,37,0,-37
28483,0,0,77,0,-77
28484,1,0,40,0,-40
28485,0,0,7,0,-7
28486,1,0,6,0,-6
28487,1,0,44,0,-44
28488,1,0,19,0,-19
28489,1,1,1157,1344,187
28490,0,0,90,0,-90
28491,1,1,481,1754,1273
28492,0,0,32,0,-32
28493,0,0,59,0,-59
28494,0,0,28,0,-28
28495,0,0,72,0,-72
28496,0,0,92,0,-92
28497,1,1,714,1385,671
28498,0,0,32,0,-32
28499,1,0,0,0,0
28500,1,0,83,0,-83
28501,0,0,23,0,-23
28502,1,0,30,0,-30
28503,1,0,2,0,-2
28504,1,0,102,0,-102
28505,1,0,33,0,-33
28506,1,0,5,0,-5
28507,0,0,143,0,-143
28508,1,0,171,0,-171
28509,1,1,1421,2051,630
28510,1,0,17,0,-17
28511,1,1,397,1298,901
28512,1,1,153,1411,1258
28513,0,0,55,0,-55
28514,1,1,348,1326,978
28515,0,0,20,0,-20
28516,1,1,543,1422,879
28517,0,0,40,0,-40
28518,0,0,107,0,-107
28519,1,1,3496,1980,-1516
28520,0,0,27,0,-27
28521,0,0,62,0,-62
28522,1,1,694,1277,583
28523,1,0,66,0,-66
28524,1,0,74,0,-74
28525,1,1,278,1435,1157
28526,0,0,4,0,-4
28527,0,0,1,0,-1
28528,1,0,30,0,-30
28529,1,1,934,1794,860
28530,0,0,126,0,-126
28531,1,1,155,1807,1652
28532,1,1,141,1367,1226
28533,1,0,49,0,-49
28534,1,1,185,1271,1086
28535,0,0,27,0,-27
28536,0,0,34,0,-34
28537,1,0,19,0,-19
28538,0,0,153,0,-153
28539,1,1,322,2004,1682
28540,0,0,205,0,-205
28541,1,1,1231,1269,38
28542,0,0,21,0,-21
28543,1,0,13,0,-13
28544,1,0,8,0,-8
28545,1,1,728,1761,1033
28546,0,0,30,0,-30
28547,1,0,44,0,-44
28548,0,0,233,0,-233
28549,1,0,12,0,-12
28550,1,1,702,1427,725
28551,0,0,17,0,-17
28552,1,1,244,1551,1307
28553,1,0,77,0,-77
28554,0,0,29,0,-29
28555,1,0,60,0,-60
28556,1,0,8,0,-8
28557,1,1,609,1388,779
28558,1,0,39,0,-39
28559,1,0,8,0,-8
28560,1,0,4,0,-4
28561,1,1,1224,1457,233
28562,1,0,76,0,-76
28563,0,0,29,0,-29
28564,1,0,5,0,-5
28565,0,0,10,0,-10
28566,0,0,1,0,-1
28567,0,0,66,0,-66
28568,0,0,6,0,-6
28569,0,0,30,0,-30
28570,0,0,33,0,-33
28571,0,0,198,0,-198
28572,0,0,191,0,-191
28573,1,1,58,3079,3021
28574,0,0,0,0,0
28575,1,0,15,0,-15
28576,1,0,2,0,-2
28577,1,1,262,1272,1010
28578,0,0,32,0,-32
28579,1,0,72,0,-72
28580,1,1,801,1314,513
28581,0,0,31,0,-31
28582,1,1,1312,1503,191
28583,0,0,71,0,-71
28584,1,0,114,0,-114
28585,0,0,39,0,-39
28586,0,0,144,0,-144
28587,1,1,206,1548,1342
28588,0,0,49,0,-49
28589,0,0,22,0,-22
28590,1,1,620,1298,678
28591,1,0,36,0,-36
28592,1,1,850,1676,826
28593,1,0,53,0,-53
28594,0,0,10,0,-10
28595,1,0,107,0,-107
28596,0,0,29,0,-29
28597,0,0,62,0,-62
28598,0,0,214,0,-214
28599,0,0,160,0,-160
28600,1,0,9,0,-9
28601,1,0,96,0,-96
28602,1,1,266,1585,1319
28603,1,1,1234,1346,112
28604,0,0,21,0,-21
28605,1,0,2,0,-2
28606,0,0,83,0,-83
28607,1,0,97,0,-97
28608,1,1,92,1599,1507
28609,0,0,14,0,-14
28610,0,0,65,0,-65
28611,1,0,19,0,-19
28612,0,0,101,0,-101
28613,0,0,44,0,-44
28614,1,0,121,0,-121
28615,0,0,247,0,-247
28616,0,0,8,0,-8
28617,1,1,1186,1303,117
28618,1,0,0,0,0
28619,1,1,810,1257,447
28620,1,1,304,1968,1664
28621,0,0,13,0,-13
28622,1,1,545,1799,1254
28623,1,0,28,0,-28
28624,1,1,425,1393,968
28625,1,0,101,0,-101
28626,1,1,395,1253,858
28627,1,1,831,1379,548
28628,0,0,0,0,0
28629,0,0,46,0,-46
28630,1,1,1164,1287,123
28631,0,0,7,0,-7
28632,0,0,33,0,-33
28633,1,0,19,0,-19
28634,0,0,5,0,-5
28635,0,0,85,0,-85
28636,0,0,110,0,-110
28637,1,0,7,0,-7
28638,1,0,69,0,-69
28639,1,1,81,1294,1213
28640,1,0,15,0,-15
28641,1,1,478,1580,1102
28642,0,0,23,0,-23
28643,0,0,2,0,-2
28644,1,0,7,0,-7
28645,1,0,10,0,-10
28646,0,0,48,0,-48
28647,1,0,31,0,-31
28648,1,1,736,1562,826
28649,1,1,172,1416,1244
28650,1,1,279,1310,1031
28651,0,0,44,0,-44
28652,0,0,120,0,-120
28653,0,0,57,0,-57
28654,0,0,39,0,-39
28655,1,1,176,1300,1124
28656,1,0,2,0,-2
28657,0,0,12,0,-12
28658,0,0,52,0,-52
28659,1,0,31,0,-31
28660,1,0,31,0,-31
28661,0,0,12,0,-12
28662,0,0,64,0,-64
28663,1,0,74,0,-74
28664,0,0,28,0,-28
28665,0,0,18,0,-18
28666,1,1,1007,1415,408
28667,0,0,39,0,-39
28668,1,0,140,0,-140
28669,1,1,269,1254,985
28670,1,0,101,0,-101
